Player,Pos,Age,G,MP,FG,FGA,FG%,3P,3PA,3P%,2P,2PA,2P%,FT,FTA,FT%,ORB,DRB,TRB,AST,STL,BLK,TOV,PF,PTS,OWS,DWS,WS,Season
Quincy Acy,SF,23,63,847,66,141,0.468,4,15,0.267,62,126,0.492,35,53,0.66,72,144,216,28,23,26,30,122,171,0.6,0.9,1.5,2013
Steven Adams,C,20,81,1197,93,185,0.503,0,0,0.0,93,185,0.503,79,136,0.581,142,190,332,43,40,57,71,203,265,0.9,1.9,2.9,2013
Jeff Adrien,PF,27,53,961,143,275,0.52,0,0,0.0,143,275,0.52,76,119,0.639,102,204,306,38,24,36,39,108,362,1.6,1.1,2.7,2013
Arron Afflalo,SG,28,73,2552,464,1011,0.459,128,300,0.427,336,711,0.473,274,336,0.815,32,230,262,248,35,3,146,136,1330,4.3,1.0,5.3,2013
Alexis Ajinça,C,25,56,951,136,249,0.546,0,1,0.0,136,248,0.548,56,67,0.836,94,183,277,40,23,46,63,187,328,1.2,0.9,2.1,2013
Cole Aldrich,C,25,46,330,33,61,0.541,0,0,0.0,33,61,0.541,26,30,0.867,37,92,129,14,8,30,18,40,92,0.6,0.6,1.2,2013
LaMarcus Aldridge,PF,28,69,2498,652,1423,0.458,3,15,0.2,649,1408,0.461,296,360,0.822,166,599,765,178,63,68,123,147,1603,4.0,3.5,7.5,2013
Lavoy Allen,PF,24,65,1072,134,300,0.447,2,13,0.154,132,287,0.46,33,50,0.66,119,192,311,71,24,33,44,126,303,0.6,0.9,1.5,2013
Ray Allen*,SG,38,73,1936,240,543,0.442,116,309,0.375,124,234,0.53,105,116,0.905,23,182,205,143,54,8,84,115,701,2.5,1.5,4.1,2013
Tony Allen,SG,32,55,1278,204,413,0.494,11,47,0.234,193,366,0.527,76,121,0.628,79,129,208,94,90,19,90,121,495,0.5,2.1,2.7,2013
Al-Farouq Aminu,SF,23,80,2045,234,494,0.474,13,48,0.271,221,446,0.496,91,137,0.664,129,367,496,114,82,38,88,147,572,1.3,1.8,3.1,2013
Lou Amundson,PF,31,19,185,16,32,0.5,0,0,0.0,16,32,0.5,6,24,0.25,28,27,55,6,9,11,14,49,38,-0.1,0.2,0.1,2013
Chris Andersen,C,35,72,1396,177,275,0.644,3,12,0.25,174,263,0.662,120,169,0.71,129,250,379,19,32,97,53,162,477,3.8,2.2,6.0,2013
Alan Anderson,SF,31,78,1773,194,485,0.4,84,248,0.339,110,237,0.464,92,118,0.78,40,135,175,81,48,11,62,147,564,0.8,0.9,1.7,2013
James Anderson,SG,24,80,2309,309,717,0.431,115,351,0.328,194,366,0.53,77,106,0.726,59,241,300,149,74,28,106,154,810,0.9,0.9,1.9,2013
Ryan Anderson,PF,25,22,795,155,354,0.438,67,164,0.409,88,190,0.463,59,62,0.952,66,76,142,17,10,7,20,47,436,2.2,0.1,2.3,2013
Giannis Antetokounmpo,SF,19,77,1897,173,418,0.414,41,118,0.347,132,300,0.44,138,202,0.683,78,261,339,150,60,61,122,173,525,0.1,1.1,1.2,2013
Carmelo Anthony,PF,29,77,2982,743,1643,0.452,167,415,0.402,576,1228,0.469,459,541,0.848,145,477,622,242,95,51,198,224,2112,8.1,2.5,10.7,2013
Joel Anthony,C,31,33,186,12,32,0.375,0,0,0.0,12,32,0.375,4,8,0.5,15,23,38,2,3,12,3,17,28,0.0,0.2,0.2,2013
Pero Antić,C,31,50,925,123,294,0.418,56,171,0.327,67,123,0.545,50,66,0.758,57,152,209,58,19,12,55,126,352,0.5,0.9,1.4,2013
Trevor Ariza,SF,28,77,2723,389,853,0.456,180,442,0.407,209,411,0.509,149,193,0.772,99,376,475,191,126,20,132,179,1107,4.3,3.7,8.0,2013
Hilton Armstrong,C,29,15,97,9,19,0.474,0,0,0.0,9,19,0.474,7,16,0.438,19,28,47,5,4,4,6,11,25,0.1,0.2,0.3,2013
Darrell Arthur,SF,25,68,1161,162,410,0.395,24,64,0.375,138,346,0.399,53,62,0.855,52,158,210,61,39,47,58,185,401,-0.5,1.2,0.7,2013
Ömer Aşık,C,27,48,968,101,190,0.532,0,0,0.0,101,190,0.532,78,126,0.619,101,277,378,25,14,37,59,92,280,1.0,1.5,2.4,2013
D.J. Augustin,PG,26,71,1939,298,718,0.415,133,332,0.401,165,386,0.427,201,227,0.885,15,115,130,313,53,3,125,147,930,3.8,2.4,6.2,2013
Gustavo Ayón,C,28,26,429,52,102,0.51,0,0,0.0,52,102,0.51,8,20,0.4,42,83,125,28,25,10,29,47,112,0.0,0.7,0.7,2013
Jeff Ayres,PF,26,73,952,101,174,0.58,0,0,0.0,101,174,0.58,38,55,0.691,89,169,258,60,13,25,63,146,240,1.0,1.4,2.4,2013
Chris Babb,SG,23,14,132,8,30,0.267,6,27,0.222,2,3,0.667,0,0,0.0,4,13,17,3,6,0,3,13,22,-0.1,0.1,0.0,2013
Luke Babbitt,PF,24,27,473,60,154,0.39,36,95,0.379,24,59,0.407,14,18,0.778,18,70,88,29,7,11,15,52,170,0.5,0.2,0.7,2013
Leandro Barbosa,PG,31,20,368,56,131,0.427,7,25,0.28,49,106,0.462,31,39,0.795,5,32,37,32,7,4,19,30,150,0.2,0.2,0.4,2013
J.J. Barea,PG,29,79,1471,254,656,0.387,73,231,0.316,181,425,0.426,79,100,0.79,16,138,154,303,26,0,125,129,660,-0.1,0.9,0.7,2013
Andrea Bargnani,C,28,42,1257,222,502,0.442,30,108,0.278,192,394,0.487,84,102,0.824,69,153,222,45,14,52,58,100,558,0.8,0.7,1.5,2013
Harrison Barnes,SF,21,78,2204,271,679,0.399,66,190,0.347,205,489,0.419,130,181,0.718,66,245,311,116,65,20,84,158,738,0.4,2.8,3.2,2013
Matt Barnes,SF,33,63,1735,231,527,0.438,97,283,0.343,134,244,0.549,66,90,0.733,60,232,292,125,56,28,85,185,625,1.5,2.0,3.5,2013
Will Barton,SG,23,41,387,65,156,0.417,10,33,0.303,55,123,0.447,26,32,0.813,16,58,74,33,9,7,18,31,166,0.3,0.4,0.6,2013
Brandon Bass,PF,28,82,2266,352,725,0.486,2,6,0.333,350,719,0.487,205,239,0.858,161,309,470,87,36,71,102,190,911,3.2,1.9,5.1,2013
Shane Battier,SF,35,73,1468,105,275,0.382,73,210,0.348,32,65,0.492,15,23,0.652,34,104,138,63,50,39,21,124,298,1.0,1.4,2.4,2013
Nicolas Batum,SF,25,82,2956,381,819,0.465,145,402,0.361,236,417,0.566,163,203,0.803,116,495,611,420,75,57,208,156,1070,4.8,3.1,7.9,2013
Jerryd Bayless,PG,25,72,1686,248,617,0.402,76,212,0.358,172,405,0.425,94,118,0.797,22,123,145,194,60,9,82,161,666,1.1,1.3,2.4,2013
Aron Baynes,C,27,53,491,71,163,0.436,0,0,0.0,71,163,0.436,19,21,0.905,57,88,145,34,2,5,36,77,161,-0.1,0.6,0.6,2013
Kent Bazemore,SG,24,67,911,147,343,0.429,43,128,0.336,104,215,0.484,66,109,0.606,10,107,117,91,43,13,79,102,403,-0.6,0.8,0.2,2013
Bradley Beal,SG,20,73,2530,481,1149,0.419,138,343,0.402,343,806,0.426,149,189,0.788,54,219,273,243,71,18,128,153,1249,1.6,2.4,4.0,2013
Michael Beasley,SF,25,55,831,177,355,0.499,21,54,0.389,156,301,0.518,61,79,0.772,31,141,172,42,23,21,57,93,436,0.5,1.1,1.6,2013
Marco Belinelli,SF,27,80,2016,337,695,0.485,126,293,0.43,211,402,0.525,111,131,0.847,18,208,226,179,50,7,95,130,911,3.5,2.4,5.9,2013
Anthony Bennett,PF,20,52,663,80,225,0.356,13,53,0.245,67,172,0.39,44,69,0.638,49,106,155,17,21,8,47,93,217,-1.1,0.7,-0.4,2013
Patrick Beverley,PG,25,56,1751,199,481,0.414,92,255,0.361,107,226,0.473,83,102,0.814,72,124,196,151,77,23,66,174,573,2.7,1.6,4.2,2013
Andris Biedriņš,C,27,6,45,1,1,1.0,0,0,0.0,1,1,1.0,1,6,0.167,2,15,17,0,0,0,2,6,3,-0.1,0.0,0.0,2013
Chauncey Billups*,SG,37,19,309,24,79,0.304,14,48,0.292,10,31,0.323,10,12,0.833,4,24,28,42,8,1,25,25,72,-0.3,0.1,-0.3,2013
Bismack Biyombo,C,21,77,1072,88,144,0.611,0,0,0.0,88,144,0.611,46,89,0.517,105,261,366,8,7,86,40,124,222,1.1,2.1,3.2,2013
DeJuan Blair,PF,24,78,1214,210,393,0.534,0,2,0.0,210,391,0.537,77,121,0.636,139,229,368,70,60,21,77,192,497,1.8,1.5,3.4,2013
Steve Blake,PG,33,55,1498,133,353,0.377,79,210,0.376,54,143,0.378,33,43,0.767,13,146,159,307,54,8,102,85,378,0.7,1.1,1.8,2013
Andray Blatche,PF,27,73,1618,321,674,0.476,15,54,0.278,306,620,0.494,164,221,0.742,120,270,390,112,75,38,110,166,821,1.6,2.1,3.7,2013
Eric Bledsoe,PG,24,43,1416,265,556,0.477,50,140,0.357,215,416,0.517,183,237,0.772,27,175,202,235,69,14,143,99,763,2.6,1.6,4.1,2013
Vander Blue,SG,21,3,15,2,4,0.5,0,1,0.0,2,3,0.667,1,5,0.2,0,3,3,1,0,0,2,1,5,-0.1,0.0,-0.1,2013
Keith Bogans,SG,33,6,55,3,6,0.5,3,6,0.5,0,0,0.0,3,3,1.0,0,3,3,3,1,0,1,2,12,0.1,0.0,0.1,2013
Andrew Bogut,C,29,67,1769,235,375,0.627,0,0,0.0,235,375,0.627,22,64,0.344,182,489,671,112,47,121,97,210,492,2.4,4.0,6.5,2013
Matt Bonner,PF,33,61,690,73,164,0.445,42,98,0.429,31,66,0.47,9,12,0.75,16,114,130,31,15,11,16,49,197,0.8,1.0,1.8,2013
Trevor Booker,PF,26,72,1553,222,403,0.551,0,2,0.0,222,401,0.554,47,76,0.618,149,230,379,64,41,45,58,131,491,2.3,2.0,4.3,2013
Carlos Boozer,PF,32,76,2141,447,980,0.456,0,2,0.0,447,978,0.457,148,193,0.767,137,495,632,118,53,22,154,216,1042,-0.9,4.3,3.4,2013
Chris Bosh*,C,29,79,2531,492,953,0.516,74,218,0.339,418,735,0.569,223,272,0.82,98,424,522,87,80,78,125,192,1281,4.6,3.4,8.0,2013
Avery Bradley,SG,23,60,1855,361,825,0.438,79,200,0.395,282,625,0.451,90,112,0.804,48,178,226,85,63,11,96,145,891,0.4,1.4,1.8,2013
Elton Brand,C,34,73,1414,179,332,0.539,0,2,0.0,179,330,0.542,61,94,0.649,97,264,361,74,40,88,60,192,419,1.4,2.1,3.6,2013
Corey Brewer,SF,27,81,2609,388,807,0.481,59,211,0.28,329,596,0.552,163,227,0.718,63,144,207,135,151,30,105,210,998,2.4,2.7,5.2,2013
Ronnie Brewer,SF,28,24,160,3,15,0.2,1,8,0.125,2,7,0.286,0,2,0.0,2,12,14,10,6,1,2,4,7,-0.1,0.1,0.0,2013
Aaron Brooks,PG,29,72,1557,233,581,0.401,96,248,0.387,137,333,0.411,83,95,0.874,43,97,140,233,52,13,117,146,645,1.3,0.9,2.2,2013
MarShon Brooks,SG,25,35,316,57,125,0.456,13,25,0.52,44,100,0.44,32,44,0.727,10,44,54,25,14,4,24,21,159,0.1,0.3,0.4,2013
Lorenzo Brown,PG,23,26,224,26,86,0.302,3,30,0.1,23,56,0.411,9,13,0.692,8,20,28,41,13,3,16,19,64,-0.5,0.2,-0.3,2013
Shannon Brown,SG,28,29,251,24,66,0.364,0,2,0.0,24,64,0.375,15,21,0.714,7,21,28,9,13,0,18,24,63,-0.5,0.3,-0.3,2013
Kobe Bryant*,SG,35,6,177,31,73,0.425,3,16,0.188,28,57,0.491,18,21,0.857,2,24,26,38,7,1,34,9,83,-0.5,0.1,-0.4,2013
Chase Budinger,SF,25,41,751,100,254,0.394,42,120,0.35,58,134,0.433,32,39,0.821,19,84,103,31,19,2,24,58,274,0.3,0.6,0.9,2013
Reggie Bullock,SF,22,43,395,43,121,0.355,22,73,0.301,21,48,0.438,7,9,0.778,11,43,54,12,9,1,13,26,115,-0.2,0.3,0.2,2013
Trey Burke,PG,21,70,2262,341,897,0.38,111,336,0.33,230,561,0.41,102,113,0.903,37,171,208,396,42,6,131,145,895,1.0,0.0,0.9,2013
Alec Burks,SG,22,78,2193,380,831,0.457,50,143,0.35,330,688,0.48,279,373,0.748,59,198,257,212,69,14,149,190,1089,2.6,0.6,3.2,2013
Caron Butler,SF,33,56,1419,213,540,0.394,98,249,0.394,115,291,0.395,63,75,0.84,21,208,229,82,47,17,60,120,587,0.6,1.2,1.8,2013
Jimmy Butler,SG,24,67,2591,275,693,0.397,68,240,0.283,207,453,0.457,260,338,0.769,87,243,330,175,127,36,102,106,878,2.4,4.6,7.1,2013
Rasual Butler,SG,34,50,378,51,110,0.464,26,62,0.419,25,48,0.521,8,14,0.571,6,35,41,17,7,9,11,30,136,0.5,0.6,1.1,2013
Dwight Buycks,PG,24,14,146,15,48,0.313,5,17,0.294,10,31,0.323,8,9,0.889,4,19,23,10,8,0,10,11,43,-0.2,0.2,0.0,2013
Andrew Bynum,C,26,26,516,94,225,0.418,0,0,0.0,94,225,0.418,37,49,0.755,53,92,145,29,6,29,34,31,225,-0.2,0.6,0.4,2013
Will Bynum,PG,31,56,1054,184,430,0.428,20,62,0.323,164,368,0.446,97,121,0.802,24,75,99,216,39,7,103,121,485,0.6,0.4,1.0,2013
Nick Calathes,SG,24,71,1173,142,311,0.457,19,61,0.311,123,250,0.492,44,72,0.611,23,114,137,207,66,8,101,117,347,-0.1,1.6,1.5,2013
José Calderón,PG,32,81,2468,341,748,0.456,191,425,0.449,150,323,0.464,52,63,0.825,29,163,192,377,69,11,103,136,925,5.4,0.8,6.3,2013
Kentavious Caldwell-Pope,SG,20,80,1583,182,460,0.396,59,185,0.319,123,275,0.447,47,61,0.77,38,118,156,55,75,12,28,145,470,1.0,0.8,1.8,2013
Isaiah Canaan,PG,22,22,252,31,87,0.356,18,55,0.327,13,32,0.406,21,29,0.724,7,17,24,22,8,4,21,25,101,0.0,0.2,0.2,2013
DeMarre Carroll,SF,27,73,2341,302,642,0.47,97,268,0.362,205,374,0.548,109,141,0.773,107,296,403,134,108,21,79,188,810,3.2,2.6,5.8,2013
Vince Carter*,SG,37,81,1973,330,811,0.407,146,371,0.394,184,440,0.418,161,196,0.821,67,217,284,212,61,35,108,209,967,3.0,1.3,4.3,2013
Michael Carter-Williams,PG,22,70,2414,427,1054,0.405,55,208,0.264,372,846,0.44,258,367,0.703,101,336,437,441,130,43,247,213,1167,-0.8,2.1,1.3,2013
Omri Casspi,PF,25,71,1283,173,410,0.422,61,176,0.347,112,234,0.479,83,122,0.68,55,205,260,88,44,14,72,100,490,1.0,1.4,2.4,2013
Mario Chalmers,PG,27,73,2178,254,560,0.454,87,226,0.385,167,334,0.5,121,163,0.742,41,173,214,357,119,16,162,210,716,2.4,2.5,4.8,2013
Tyson Chandler,C,31,55,1662,191,322,0.593,0,1,0.0,191,321,0.595,98,155,0.632,159,370,529,59,36,63,71,145,480,3.1,1.9,4.9,2013
Wilson Chandler,SF,26,62,1927,307,738,0.416,122,351,0.348,185,387,0.478,110,152,0.724,58,236,294,114,46,31,79,193,846,1.8,1.2,3.1,2013
Josh Childress,SF,30,4,24,0,0,0.0,0,0,0.0,0,0,0.0,0,0,0.0,0,3,3,2,1,0,1,1,0,0.0,0.0,0.0,2013
Dionte Christmas,SF,27,31,198,22,62,0.355,9,31,0.29,13,31,0.419,18,24,0.75,13,25,38,8,2,3,6,19,71,0.2,0.1,0.3,2013
Earl Clark,PF,26,54,768,97,261,0.372,41,122,0.336,56,139,0.403,22,34,0.647,22,121,143,18,17,25,31,67,257,-0.4,0.8,0.3,2013
Ian Clark,SG,22,23,172,26,67,0.388,11,31,0.355,15,36,0.417,5,7,0.714,3,16,19,15,8,2,14,24,68,-0.2,0.1,-0.1,2013
Victor Claver,SF,25,21,184,17,42,0.405,3,18,0.167,14,24,0.583,10,11,0.909,9,30,39,12,3,3,11,16,47,0.0,0.2,0.2,2013
Norris Cole,PG,25,82,2014,207,500,0.414,60,174,0.345,147,326,0.451,53,68,0.779,17,143,160,248,77,5,127,156,527,-0.5,1.7,1.2,2013
Jason Collins,C,35,22,172,11,24,0.458,0,3,0.0,11,21,0.524,3,4,0.75,7,12,19,4,8,1,7,30,25,-0.1,0.1,0.1,2013
Darren Collison,PG,26,80,2069,324,694,0.467,71,189,0.376,253,505,0.501,192,224,0.857,47,141,188,297,93,15,132,150,911,3.8,2.0,5.9,2013
Nick Collison,PF,33,81,1353,134,241,0.556,4,17,0.235,130,224,0.58,66,93,0.71,116,177,293,104,30,28,71,187,338,2.0,1.6,3.6,2013
Mike Conley,PG,26,73,2446,463,1030,0.45,105,291,0.361,358,739,0.484,225,276,0.815,41,172,213,441,110,13,150,141,1256,5.5,2.7,8.2,2013
Chris Copeland,SF,29,41,265,55,117,0.47,33,79,0.418,22,38,0.579,10,14,0.714,7,25,32,18,3,7,14,38,153,0.6,0.4,1.0,2013
DeMarcus Cousins,C,23,71,2298,591,1191,0.496,0,7,0.0,591,1184,0.499,432,595,0.726,218,613,831,207,109,91,251,270,1614,4.1,3.8,7.9,2013
Robert Covington,SF,23,7,34,6,14,0.429,4,11,0.364,2,3,0.667,0,0,0.0,2,3,5,0,2,0,1,3,16,0.1,0.0,0.1,2013
Allen Crabbe,SG,21,15,100,12,33,0.364,6,14,0.429,6,19,0.316,3,4,0.75,1,8,9,6,2,1,3,10,33,0.0,0.1,0.1,2013
Jamal Crawford,SG,33,69,2094,421,1011,0.416,161,446,0.361,260,565,0.46,279,322,0.866,34,124,158,223,59,12,135,120,1282,3.8,1.5,5.3,2013
Jordan Crawford,SG,25,81,1859,327,788,0.415,90,285,0.316,237,503,0.471,146,169,0.864,28,155,183,281,47,5,134,120,890,1.5,1.4,2.8,2013
Jae Crowder,SF,23,78,1254,130,296,0.439,50,151,0.331,80,145,0.552,46,61,0.754,46,148,194,60,59,21,41,100,356,1.2,1.1,2.3,2013
Dante Cunningham,PF,26,81,1635,236,509,0.464,0,5,0.0,236,504,0.468,38,67,0.567,112,218,330,83,62,58,42,146,510,0.9,2.0,2.9,2013
Jared Cunningham,SG,22,13,80,6,21,0.286,1,7,0.143,5,14,0.357,13,16,0.813,1,5,6,8,3,0,2,16,26,0.1,0.0,0.1,2013
Seth Curry,PG,23,2,13,1,3,0.333,1,1,1.0,0,2,0.0,0,0,0.0,0,1,1,0,2,0,0,0,3,0.0,0.0,0.0,2013
Stephen Curry,PG,25,78,2846,652,1383,0.471,261,615,0.424,391,768,0.509,308,348,0.885,46,288,334,666,128,14,294,194,1873,9.3,4.0,13.4,2013
Samuel Dalembert,C,32,80,1614,214,377,0.568,0,1,0.0,214,376,0.569,101,137,0.737,200,341,541,38,41,94,90,210,529,2.9,2.1,4.9,2013
Troy Daniels,SG,22,5,75,15,31,0.484,12,25,0.48,3,6,0.5,0,0,0.0,0,4,4,5,0,0,3,6,42,0.2,0.0,0.2,2013
Gigi Datome,SF,26,34,238,34,97,0.351,7,39,0.179,27,58,0.466,8,10,0.8,14,32,46,11,6,1,11,20,83,-0.2,0.1,-0.1,2013
Brandon Davies,PF,22,51,575,54,128,0.422,2,10,0.2,52,118,0.441,34,53,0.642,38,71,109,28,24,8,35,92,144,-0.3,0.4,0.1,2013
Anthony Davis,PF,20,67,2358,522,1005,0.519,2,9,0.222,520,996,0.522,348,440,0.791,207,466,673,105,89,189,109,200,1394,7.2,3.2,10.4,2013
Ed Davis,PF,24,63,956,155,290,0.534,0,0,0.0,155,290,0.534,47,89,0.528,92,168,260,27,17,43,40,114,357,1.2,1.4,2.6,2013
Glen Davis,PF,28,68,1662,271,593,0.457,4,11,0.364,267,582,0.459,95,137,0.693,108,243,351,77,58,29,76,159,641,0.2,1.8,2.0,2013
Austin Daye,SF,25,22,148,24,68,0.353,12,37,0.324,12,31,0.387,6,10,0.6,5,22,27,8,4,4,5,18,66,-0.1,0.2,0.1,2013
Nando De Colo,SF,26,47,494,64,153,0.418,18,53,0.34,46,100,0.46,31,35,0.886,14,59,73,65,22,6,35,48,177,0.3,0.7,1.0,2013
Dewayne Dedmon,C,24,31,390,38,83,0.458,0,0,0.0,38,83,0.458,21,32,0.656,38,89,127,5,7,22,18,66,97,0.1,0.5,0.6,2013
Matthew Dellavedova,SG,23,72,1271,122,296,0.412,57,155,0.368,65,141,0.461,38,48,0.792,29,94,123,187,33,5,60,121,339,1.4,0.7,2.1,2013
Luol Deng,SF,28,63,2213,371,860,0.431,57,189,0.302,314,671,0.468,212,268,0.791,99,262,361,183,62,9,114,111,1011,2.2,2.3,4.5,2013
DeMar DeRozan,SG,24,79,3017,604,1407,0.429,64,210,0.305,540,1197,0.451,519,630,0.824,51,292,343,313,86,28,176,197,1791,5.8,3.0,8.8,2013
Boris Diaw,PF,31,79,1974,302,580,0.521,45,112,0.402,257,468,0.549,68,92,0.739,74,252,326,222,44,32,121,140,717,2.3,2.6,4.9,2013
Gorgui Dieng,C,24,60,818,113,227,0.498,1,1,1.0,112,226,0.496,59,93,0.634,103,197,300,39,30,50,54,108,286,0.7,1.5,2.2,2013
Toney Douglas,PG,27,51,675,73,190,0.384,31,102,0.304,42,88,0.477,25,34,0.735,18,69,87,68,19,5,34,81,202,0.2,0.7,0.9,2013
Chris Douglas-Roberts,SF,27,49,1016,111,252,0.44,51,132,0.386,60,120,0.5,66,82,0.805,16,103,119,51,29,16,36,61,339,1.1,1.2,2.4,2013
Goran Dragić,SG,27,76,2668,552,1093,0.505,122,299,0.408,430,794,0.542,316,416,0.76,69,176,245,447,104,22,213,206,1542,8.4,2.0,10.3,2013
Andre Drummond,C,20,81,2619,479,769,0.623,0,2,0.0,479,767,0.625,137,328,0.418,440,631,1071,35,101,131,110,273,1095,6.4,3.5,9.9,2013
Jared Dudley,SF,28,74,1729,196,447,0.438,81,225,0.36,115,222,0.518,38,58,0.655,36,124,160,104,41,10,56,146,511,1.2,1.2,2.4,2013
Tim Duncan*,C,37,74,2158,444,906,0.49,0,5,0.0,444,901,0.493,231,316,0.731,158,563,721,220,43,139,159,134,1119,2.8,4.6,7.4,2013
Mike Dunleavy,SF,33,82,2584,333,774,0.43,123,324,0.38,210,450,0.467,140,164,0.854,46,299,345,186,64,46,108,163,929,2.4,4.1,6.5,2013
Kevin Durant,SF,25,81,3122,849,1688,0.503,192,491,0.391,657,1197,0.549,703,805,0.873,58,540,598,445,103,59,285,174,2593,14.8,4.4,19.2,2013
Shane Edwards,SF,26,2,12,1,3,0.333,0,0,0.0,1,3,0.333,0,0,0.0,1,1,2,0,0,0,1,1,2,0.0,0.0,0.0,2013
Wayne Ellington,SG,26,45,393,55,126,0.437,25,59,0.424,30,67,0.448,10,11,0.909,8,35,43,19,16,2,11,33,145,0.4,0.2,0.7,2013
Monta Ellis,SG,28,82,3023,576,1278,0.451,69,209,0.33,507,1069,0.474,339,430,0.788,38,257,295,471,141,23,264,197,1560,2.8,2.1,4.9,2013
Melvin Ely,C,35,2,27,3,6,0.5,0,0,0.0,3,6,0.5,0,0,0.0,0,1,1,0,0,1,0,5,6,0.0,0.0,0.0,2013
Jeremy Evans,SF,26,66,1209,175,332,0.527,0,2,0.0,175,330,0.53,51,75,0.68,120,190,310,44,42,46,40,139,401,1.9,1.0,2.8,2013
Reggie Evans,PF,33,54,899,71,150,0.473,0,0,0.0,71,150,0.473,72,130,0.554,115,219,334,21,37,3,58,119,214,0.3,1.2,1.5,2013
Tyreke Evans,SF,24,72,2028,391,897,0.436,21,95,0.221,370,802,0.461,239,310,0.771,76,265,341,363,84,21,175,155,1042,1.8,1.3,3.1,2013
Kenneth Faried,PF,24,80,2178,447,820,0.545,0,3,0.0,447,817,0.547,202,311,0.65,238,446,684,96,70,69,135,193,1096,4.0,2.5,6.5,2013
Jordan Farmar,PG,27,41,912,151,364,0.415,70,160,0.438,81,204,0.397,44,59,0.746,20,84,104,199,38,8,95,65,416,0.4,0.4,0.7,2013
Vítor Luiz Faverani,C,25,37,488,64,147,0.435,12,40,0.3,52,107,0.486,24,37,0.649,42,86,128,16,14,27,41,74,164,-0.3,0.7,0.3,2013
Derrick Favors,PF,22,73,2201,390,747,0.522,0,1,0.0,390,746,0.523,190,284,0.669,199,438,637,91,75,108,129,236,970,2.9,2.3,5.1,2013
Carrick Felix,SG,23,7,38,7,14,0.5,2,5,0.4,5,9,0.556,3,4,0.75,1,5,6,4,0,0,4,4,19,0.0,0.0,0.0,2013
Raymond Felton,PG,29,65,2017,240,608,0.395,62,195,0.318,178,413,0.431,88,122,0.721,54,143,197,365,78,27,129,157,630,1.1,1.1,2.2,2013
Landry Fields,SF,25,30,322,27,67,0.403,0,5,0.0,27,62,0.435,14,22,0.636,15,44,59,20,10,3,11,25,68,0.0,0.4,0.4,2013
Derek Fisher,SG,39,81,1428,141,361,0.391,88,229,0.384,53,132,0.402,55,71,0.775,12,110,122,117,70,3,49,157,425,1.4,1.7,3.1,2013
Evan Fournier,SG,21,76,1503,228,544,0.419,89,237,0.376,139,307,0.453,93,123,0.756,34,168,202,112,34,7,100,179,638,0.6,0.8,1.4,2013
Randy Foye,SG,30,81,2485,361,875,0.413,189,498,0.38,172,377,0.456,157,185,0.849,36,196,232,287,67,39,145,205,1068,3.3,1.3,4.6,2013
Jamaal Franklin,SG,22,21,161,16,39,0.41,5,11,0.455,11,28,0.393,2,2,1.0,4,19,23,6,4,2,11,23,39,-0.2,0.2,0.0,2013
Jimmer Fredette,SG,24,49,519,107,227,0.471,40,84,0.476,67,143,0.469,19,21,0.905,8,44,52,64,14,3,48,35,273,0.5,0.3,0.8,2013
Enes Freedom,C,21,80,2138,419,853,0.491,0,1,0.0,419,852,0.492,149,204,0.73,222,376,598,75,28,42,144,230,987,1.3,0.9,2.2,2013
Joel Freeland,C,26,52,727,77,162,0.475,0,2,0.0,77,160,0.481,20,29,0.69,88,120,208,36,10,22,32,95,174,0.7,0.7,1.4,2013
Channing Frye,PF,30,82,2312,336,778,0.432,160,432,0.37,176,346,0.509,78,95,0.821,73,343,416,98,60,63,89,245,910,2.9,2.4,5.3,2013
Francisco García,SF,32,55,1083,118,294,0.401,69,193,0.358,49,101,0.485,10,19,0.526,21,101,122,63,27,33,30,120,315,0.8,0.9,1.8,2013
Kevin Garnett*,C,37,54,1109,157,356,0.441,0,3,0.0,157,353,0.445,38,47,0.809,60,298,358,82,43,40,69,123,352,-0.7,1.9,1.2,2013
Diante Garrett,PG,25,71,1048,101,265,0.381,36,96,0.375,65,169,0.385,10,12,0.833,11,86,97,120,41,5,75,75,248,-1.1,0.3,-0.8,2013
Marc Gasol,C,29,59,1970,336,711,0.473,2,11,0.182,334,700,0.477,185,241,0.768,84,340,424,215,59,76,111,150,859,2.6,3.1,5.6,2013
Pau Gasol*,C,33,60,1884,425,885,0.48,4,14,0.286,421,871,0.483,187,254,0.736,124,456,580,201,27,92,141,124,1041,1.3,1.7,3.0,2013
Rudy Gay,SF,27,73,2531,537,1179,0.455,65,197,0.33,472,982,0.481,318,387,0.822,113,324,437,209,95,56,224,171,1457,2.3,2.5,4.8,2013
Alonzo Gee,SF,26,65,1020,98,236,0.415,19,58,0.328,79,178,0.444,43,61,0.705,35,114,149,47,39,15,44,96,258,-0.1,1.0,0.9,2013
Paul George,SF,23,80,2898,577,1362,0.424,182,500,0.364,395,862,0.458,401,464,0.864,64,478,542,283,151,22,224,198,1737,4.4,6.4,10.8,2013
Taj Gibson,PF,28,82,2351,429,896,0.479,0,7,0.0,429,889,0.483,211,281,0.751,200,358,558,91,41,112,150,207,1069,1.4,4.4,5.7,2013
Manu Ginóbili*,SG,36,68,1550,294,627,0.469,90,258,0.349,204,369,0.553,160,188,0.851,30,172,202,293,70,17,139,128,838,3.3,2.4,5.7,2013
Rudy Gobert,C,21,45,434,36,74,0.486,0,0,0.0,36,74,0.486,32,65,0.492,51,104,155,7,8,41,32,57,104,-0.2,0.6,0.4,2013
Ryan Gomes,SF,31,5,34,3,8,0.375,0,2,0.0,3,6,0.5,0,0,0.0,0,4,4,1,0,0,1,5,6,-0.1,0.0,0.0,2013
Drew Gooden,C,32,22,395,76,143,0.531,7,17,0.412,69,126,0.548,24,27,0.889,37,77,114,15,10,7,17,53,183,0.9,0.6,1.4,2013
Archie Goodwin,SG,19,52,533,76,167,0.455,5,36,0.139,71,131,0.542,37,55,0.673,25,62,87,20,20,11,44,45,194,-0.3,0.5,0.2,2013
Ben Gordon,SG,30,19,279,37,108,0.343,8,29,0.276,29,79,0.367,17,21,0.81,3,24,27,21,10,2,21,18,99,-0.7,0.3,-0.3,2013
Eric Gordon,SG,25,64,2057,356,817,0.436,101,258,0.391,255,559,0.456,175,223,0.785,30,135,165,208,74,12,134,114,988,2.0,0.5,2.5,2013
Marcin Gortat,C,29,81,2655,455,840,0.542,1,1,1.0,454,839,0.541,157,229,0.686,202,565,767,138,41,121,126,201,1068,4.1,4.0,8.1,2013
Danny Granger,SF,30,41,847,116,307,0.378,43,128,0.336,73,179,0.408,63,67,0.94,31,102,133,41,12,17,46,62,338,0.1,1.2,1.3,2013
Aaron Gray,C,29,37,355,27,61,0.443,0,1,0.0,27,60,0.45,11,20,0.55,42,69,111,22,10,8,31,64,65,-0.3,0.4,0.1,2013
Danny Green,SG,26,68,1651,218,505,0.432,132,318,0.415,86,187,0.46,50,63,0.794,25,204,229,104,65,61,76,107,618,1.4,2.8,4.2,2013
Draymond Green,SF,23,82,1797,187,459,0.407,55,165,0.333,132,294,0.449,82,123,0.667,86,323,409,152,102,72,91,231,511,0.7,3.8,4.5,2013
Gerald Green,SG,28,82,2330,448,1006,0.445,204,510,0.4,244,496,0.492,195,230,0.848,48,227,275,122,70,42,145,220,1295,4.2,1.9,6.1,2013
Jeff Green,SF,27,82,2805,482,1171,0.412,135,396,0.341,347,775,0.448,283,356,0.795,54,326,380,138,57,47,165,180,1382,1.3,2.0,3.3,2013
Willie Green,SG,32,55,869,102,271,0.376,41,121,0.339,61,150,0.407,28,34,0.824,12,66,78,50,22,11,34,96,273,-0.2,0.7,0.5,2013
Blake Griffin,PF,24,80,2863,718,1359,0.528,12,44,0.273,706,1315,0.537,482,674,0.715,192,565,757,309,92,51,224,265,1930,8.1,4.1,12.2,2013
Jorge Gutiérrez,PG,25,15,244,25,54,0.463,3,12,0.25,22,42,0.524,9,12,0.75,3,19,22,30,10,1,14,37,62,0.1,0.2,0.2,2013
Jordan Hamilton,SF,23,60,1019,147,376,0.391,70,198,0.354,77,178,0.433,40,51,0.784,32,162,194,52,44,20,46,67,404,0.4,1.1,1.6,2013
Justin Hamilton,C,23,8,72,9,20,0.45,3,9,0.333,6,11,0.545,5,5,1.0,4,3,7,0,5,0,4,8,26,0.1,0.1,0.1,2013
Tyler Hansbrough,PF,28,64,978,93,196,0.474,0,2,0.0,93,194,0.479,126,185,0.681,120,167,287,17,28,19,47,132,312,1.7,1.4,3.0,2013
Tim Hardaway Jr.,SG,21,81,1875,294,687,0.428,130,358,0.363,164,329,0.498,106,128,0.828,19,102,121,66,44,7,47,144,824,2.7,0.4,3.1,2013
James Harden,SG,24,73,2777,549,1205,0.456,177,483,0.366,372,722,0.515,576,665,0.866,61,283,344,446,115,29,265,177,1851,10.1,2.7,12.8,2013
Maurice Harkless,SF,20,80,1950,224,483,0.464,59,154,0.383,165,329,0.502,85,143,0.594,69,195,264,80,97,50,86,140,592,0.6,2.1,2.8,2013
Josh Harrellson,C,24,32,317,38,82,0.463,12,31,0.387,26,51,0.51,5,7,0.714,30,46,76,15,6,15,10,44,93,0.5,0.2,0.7,2013
Al Harrington,PF,33,34,511,82,207,0.396,34,100,0.34,48,107,0.449,27,35,0.771,15,65,80,28,14,0,34,72,225,-0.2,0.5,0.4,2013
Devin Harris,PG,30,40,818,96,254,0.378,31,101,0.307,65,153,0.425,92,115,0.8,8,77,85,178,28,2,59,72,315,1.2,0.4,1.6,2013
Elias Harris,SF,24,2,11,0,1,0.0,0,0,0.0,0,1,0.0,0,0,0.0,1,0,1,1,1,0,0,0,0,0.0,0.0,0.0,2013
Manny Harris,SG,24,9,180,28,70,0.4,7,20,0.35,21,50,0.42,10,12,0.833,7,27,34,11,4,1,9,10,73,-0.1,0.1,0.0,2013
Mike Harris,PF,30,20,225,29,61,0.475,0,2,0.0,29,59,0.492,26,27,0.963,15,18,33,5,16,7,11,36,84,0.3,0.2,0.5,2013
Tobias Harris,PF,21,61,1850,332,716,0.464,32,126,0.254,300,590,0.508,197,244,0.807,88,336,424,82,41,24,78,143,893,2.4,1.7,4.1,2013
Udonis Haslem,PF,33,46,653,74,146,0.507,0,0,0.0,74,146,0.507,25,44,0.568,42,133,175,13,11,15,24,79,173,0.3,0.8,1.1,2013
Spencer Hawes,C,25,80,2470,403,883,0.456,128,308,0.416,275,575,0.478,119,152,0.783,131,529,660,240,44,94,173,237,1053,2.2,2.3,4.5,2013
Chuck Hayes,C,30,61,754,56,130,0.431,0,1,0.0,56,129,0.434,20,25,0.8,69,141,210,35,34,12,33,95,132,0.2,1.2,1.4,2013
Gordon Hayward,SF,23,77,2800,426,1032,0.413,85,280,0.304,341,752,0.453,311,381,0.816,62,329,391,400,110,40,212,155,1248,2.2,1.5,3.6,2013
Gerald Henderson,SG,26,77,2461,403,930,0.433,40,115,0.348,363,815,0.445,235,309,0.761,31,279,310,199,51,32,113,159,1081,0.8,2.8,3.6,2013
Xavier Henry,SF,22,43,908,144,345,0.417,28,81,0.346,116,264,0.439,116,177,0.655,25,89,114,51,44,7,57,79,432,-0.1,0.5,0.3,2013
John Henson,PF,23,70,1856,344,639,0.538,0,1,0.0,344,638,0.539,91,177,0.514,171,326,497,113,41,116,114,185,779,1.7,1.5,3.3,2013
Roy Hibbert,C,27,81,2409,331,754,0.439,2,5,0.4,329,749,0.439,207,269,0.77,202,336,538,91,29,182,148,269,871,0.5,5.0,5.4,2013
J.J. Hickson,PF,25,69,1859,332,654,0.508,0,8,0.0,332,646,0.514,150,290,0.517,206,426,632,96,47,51,128,177,814,1.3,2.1,3.3,2013
Nenê,PF,31,53,1560,299,594,0.503,1,5,0.2,298,589,0.506,155,266,0.583,65,229,294,153,64,47,117,164,754,0.8,2.4,3.2,2013
George Hill,PG,27,76,2434,272,616,0.442,95,260,0.365,177,356,0.497,142,176,0.807,53,230,283,265,75,23,92,158,781,3.8,4.0,7.8,2013
Jordan Hill,PF,26,72,1500,286,521,0.549,0,1,0.0,286,520,0.55,124,181,0.685,194,341,535,54,29,64,75,172,696,3.1,1.3,4.4,2013
Solomon Hill,SF,22,28,226,17,40,0.425,7,23,0.304,10,17,0.588,6,7,0.857,9,32,41,12,5,2,13,19,47,0.0,0.4,0.4,2013
Kirk Hinrich,PG,33,73,2116,243,619,0.393,85,242,0.351,158,377,0.419,95,125,0.76,31,161,192,286,80,26,120,203,666,0.4,3.3,3.8,2013
Jrue Holiday,PG,23,34,1143,203,454,0.447,30,77,0.39,173,377,0.459,51,63,0.81,28,114,142,268,56,12,105,92,487,0.8,0.7,1.5,2013
Ryan Hollins,PF,29,61,482,53,72,0.736,0,0,0.0,53,72,0.736,35,56,0.625,31,59,90,8,9,31,29,87,141,0.7,0.6,1.3,2013
Scotty Hopson,SG,24,2,7,0,4,0.0,0,2,0.0,0,2,0.0,1,2,0.5,0,0,0,1,1,0,0,0,1,-0.1,0.0,-0.1,2013
Al Horford,C,27,29,958,238,420,0.567,4,11,0.364,234,409,0.572,58,85,0.682,66,178,244,76,27,44,64,56,538,1.5,1.3,2.8,2013
Dwight Howard,C,28,71,2396,473,800,0.591,2,7,0.286,471,793,0.594,349,638,0.547,231,635,866,131,60,128,229,240,1297,4.0,4.1,8.0,2013
Robbie Hummel,SF,24,53,655,67,177,0.379,32,89,0.36,35,88,0.398,15,16,0.938,35,97,132,23,16,2,10,57,181,0.6,0.6,1.1,2013
Kris Humphries,PF,28,69,1376,231,461,0.501,0,2,0.0,231,459,0.503,117,144,0.813,127,282,409,67,31,61,64,136,579,2.3,1.8,4.1,2013
Serge Ibaka,PF,24,81,2666,524,978,0.536,23,60,0.383,501,918,0.546,156,199,0.784,224,485,709,85,39,219,123,233,1227,5.2,4.4,9.6,2013
Andre Iguodala,SF,30,63,2040,220,458,0.48,62,175,0.354,158,283,0.558,86,132,0.652,53,240,293,263,95,18,100,103,588,2.7,3.1,5.8,2013
Ersan İlyasova,PF,26,55,1478,237,579,0.409,37,131,0.282,200,448,0.446,107,130,0.823,107,235,342,72,46,8,61,135,618,0.9,0.8,1.6,2013
Kyrie Irving,PG,21,71,2496,532,1237,0.43,123,344,0.358,409,893,0.458,291,338,0.861,52,207,259,433,108,23,190,163,1478,4.6,2.1,6.7,2013
Royal Ivey,SG,32,2,5,0,2,0.0,0,1,0.0,0,1,0.0,0,0,0.0,0,1,1,0,0,0,0,1,0,0.0,0.0,0.0,2013
Jarrett Jack,PG,30,80,2252,286,698,0.41,63,185,0.341,223,513,0.435,125,149,0.839,22,201,223,324,56,22,133,133,760,0.9,1.4,2.3,2013
Reggie Jackson,PG,23,80,2277,403,916,0.44,83,245,0.339,320,671,0.477,158,177,0.893,43,270,313,331,85,9,168,142,1047,2.3,2.6,4.9,2013
Stephen Jackson,SF,35,9,107,6,26,0.231,1,14,0.071,5,12,0.417,2,4,0.5,2,8,10,5,6,1,6,11,15,-0.3,0.1,-0.2,2013
Bernard James,C,28,30,146,11,23,0.478,0,1,0.0,11,22,0.5,6,11,0.545,15,27,42,3,3,8,10,24,28,0.0,0.2,0.1,2013
Damion James,SF,26,5,50,2,9,0.222,0,2,0.0,2,7,0.286,2,2,1.0,1,11,12,3,0,1,1,3,6,-0.1,0.1,0.0,2013
LeBron James,PF,29,77,2902,767,1353,0.567,116,306,0.379,651,1047,0.622,439,585,0.75,81,452,533,488,121,26,270,126,2089,12.3,3.7,15.9,2013
Mike James,PG,38,11,77,5,21,0.238,1,5,0.2,4,16,0.25,0,2,0.0,0,7,7,17,2,0,5,11,11,-0.2,0.1,-0.1,2013
Antawn Jamison,PF,37,22,248,29,92,0.315,8,41,0.195,21,51,0.412,18,25,0.72,9,46,55,7,9,3,7,29,84,-0.3,0.4,0.1,2013
Othyus Jeffers,SG,28,6,47,3,6,0.5,0,2,0.0,3,4,0.75,3,4,0.75,1,8,9,1,0,0,1,3,9,0.0,0.0,0.1,2013
Al Jefferson,C,29,73,2553,700,1376,0.509,3,15,0.2,697,1361,0.512,191,277,0.69,156,636,792,155,67,79,124,176,1594,3.1,4.7,7.8,2013
Richard Jefferson,SF,33,82,2213,294,654,0.45,123,301,0.409,171,353,0.484,120,162,0.741,18,201,219,130,56,14,94,168,831,2.3,0.4,2.7,2013
John Jenkins,SG,22,13,158,16,42,0.381,4,18,0.222,12,24,0.5,4,4,1.0,3,19,22,11,1,1,11,11,40,-0.2,0.1,-0.1,2013
Brandon Jennings,PG,24,80,2728,423,1135,0.373,154,457,0.337,269,678,0.397,241,321,0.751,59,185,244,609,101,8,215,157,1241,3.0,0.9,3.9,2013
Jonas Jerebko,PF,26,64,741,98,208,0.471,31,74,0.419,67,134,0.5,43,59,0.729,51,124,175,39,21,6,43,85,270,1.0,0.5,1.4,2013
Amir Johnson,PF,26,77,2214,344,612,0.562,20,66,0.303,324,546,0.593,91,143,0.636,172,333,505,115,56,88,123,271,799,3.2,3.1,6.3,2013
Chris Johnson,SF,23,40,789,85,214,0.397,43,127,0.339,42,87,0.483,37,43,0.86,31,66,97,31,27,4,22,63,250,0.9,0.5,1.4,2013
James Johnson,SF,26,52,956,143,308,0.464,22,87,0.253,121,221,0.548,76,90,0.844,60,106,166,111,42,57,66,102,384,1.4,1.6,3.0,2013
Joe Johnson,SG,32,79,2575,462,1018,0.454,162,404,0.401,300,614,0.489,159,195,0.815,48,222,270,216,47,10,120,129,1245,3.9,1.0,4.9,2013
Orlando Johnson,SG,24,45,392,36,113,0.319,9,47,0.191,27,66,0.409,19,26,0.731,9,46,55,20,6,2,15,26,100,-0.5,0.5,0.1,2013
Wesley Johnson,SF,26,79,2240,277,651,0.425,100,271,0.369,177,380,0.466,61,77,0.792,70,278,348,124,86,77,90,207,715,0.4,1.5,1.9,2013
Darius Johnson-Odom,SG,24,3,15,0,7,0.0,0,3,0.0,0,4,0.0,0,2,0.0,0,2,2,1,1,0,2,3,0,-0.2,0.0,-0.2,2013
James Jones,SF,33,20,236,31,68,0.456,28,54,0.519,3,14,0.214,7,11,0.636,2,21,23,9,3,4,4,6,97,0.6,0.1,0.7,2013
Perry Jones,PF,22,62,764,83,181,0.459,22,61,0.361,61,120,0.508,28,42,0.667,28,86,114,26,14,19,21,62,216,0.7,0.8,1.5,2013
Solomon Jones,PF,29,11,85,6,17,0.353,0,0,0.0,6,17,0.353,2,4,0.5,8,8,16,2,2,2,2,12,14,0.0,0.1,0.0,2013
Terrence Jones,PF,22,76,2078,386,712,0.542,31,101,0.307,355,611,0.581,118,195,0.605,162,366,528,87,53,99,71,139,921,4.6,2.7,7.3,2013
DeAndre Jordan,C,25,82,2870,348,515,0.676,0,0,0.0,348,515,0.676,160,374,0.428,331,783,1114,74,80,203,123,264,856,5.3,5.8,11.1,2013
Cory Joseph,SG,22,68,936,126,265,0.475,12,38,0.316,114,227,0.502,79,96,0.823,32,75,107,114,35,14,43,84,343,1.6,1.3,2.9,2013
Chris Kaman,C,31,39,736,176,346,0.509,0,3,0.0,176,343,0.513,52,68,0.765,54,175,229,58,11,40,74,93,404,-0.2,0.7,0.5,2013
Sergey Karasev,SF,20,22,156,12,35,0.343,4,19,0.211,8,16,0.5,9,10,0.9,0,16,16,6,3,1,11,22,37,-0.2,0.1,-0.1,2013
Ryan Kelly,PF,22,59,1312,157,371,0.423,48,142,0.338,109,229,0.476,110,135,0.815,42,177,219,95,32,45,47,147,472,1.5,0.7,2.2,2013
Michael Kidd-Gilchrist,SF,20,62,1502,167,353,0.473,1,9,0.111,166,344,0.483,113,184,0.614,109,215,324,52,43,39,60,145,448,0.9,2.2,3.1,2013
Andrei Kirilenko,PF,32,45,857,82,160,0.513,1,5,0.2,81,155,0.523,61,119,0.513,55,91,146,72,40,19,54,65,226,0.4,0.9,1.3,2013
Brandon Knight,PG,22,72,2400,461,1092,0.422,110,338,0.325,351,754,0.466,259,323,0.802,46,209,255,352,69,17,188,146,1291,2.4,0.4,2.8,2013
Kyle Korver,SG,32,71,2408,289,609,0.475,185,392,0.472,104,217,0.479,87,94,0.926,22,260,282,208,70,24,102,147,850,3.9,2.0,5.9,2013
Kosta Koufos,C,24,80,1349,227,459,0.495,0,0,0.0,227,459,0.495,60,93,0.645,160,258,418,39,32,71,67,182,514,1.3,2.2,3.5,2013
Viacheslav Kravtsov,C,26,20,59,8,15,0.533,0,0,0.0,8,15,0.533,4,8,0.5,9,8,17,1,0,1,6,7,20,0.0,0.0,0.0,2013
Ognjen Kuzmić,C,23,21,92,5,13,0.385,0,0,0.0,5,13,0.385,5,11,0.455,10,11,21,2,3,4,10,17,15,-0.2,0.1,0.0,2013
Doron Lamb,SG,22,53,695,63,160,0.394,36,90,0.4,27,70,0.386,29,36,0.806,8,41,49,43,11,1,27,54,191,0.3,0.2,0.5,2013
Jeremy Lamb,SG,21,78,1538,263,609,0.432,88,247,0.356,175,362,0.483,51,64,0.797,27,162,189,115,56,26,61,143,665,1.4,1.8,3.3,2013
Carl Landry,PF,30,18,233,31,60,0.517,0,0,0.0,31,60,0.517,14,17,0.824,15,42,57,5,3,1,9,34,76,0.3,0.1,0.4,2013
Shane Larkin,PG,21,48,489,52,137,0.38,12,38,0.316,40,99,0.404,16,25,0.64,11,31,42,71,26,1,39,46,132,-0.4,0.3,-0.1,2013
Ty Lawson,PG,26,62,2222,347,806,0.431,72,202,0.356,275,604,0.455,324,406,0.798,40,175,215,543,100,10,200,113,1090,4.8,1.5,6.3,2013
Ricky Ledo,SG,21,11,33,6,17,0.353,3,8,0.375,3,9,0.333,4,4,1.0,0,2,2,2,1,0,2,2,19,0.0,0.0,0.0,2013
Courtney Lee,SG,28,79,1973,295,614,0.48,72,194,0.371,223,420,0.531,99,112,0.884,29,158,187,115,65,28,73,127,761,2.8,1.9,4.7,2013
David Lee,PF,30,69,2288,513,981,0.523,0,1,0.0,513,980,0.523,231,296,0.78,182,461,643,147,48,26,152,206,1257,4.1,3.5,7.6,2013
Alex Len,C,20,42,362,33,78,0.423,0,0,0.0,33,78,0.423,20,31,0.645,39,60,99,4,4,18,26,68,86,-0.2,0.4,0.2,2013
Kawhi Leonard,SF,22,66,1923,337,645,0.522,69,182,0.379,268,463,0.579,101,126,0.802,76,336,412,133,114,50,80,127,844,3.8,3.9,7.7,2013
Meyers Leonard,C,21,40,355,41,91,0.451,0,6,0.0,41,85,0.482,16,21,0.762,26,85,111,18,7,5,15,76,98,0.2,0.5,0.6,2013
Jon Leuer,PF,24,49,642,121,246,0.492,23,49,0.469,98,197,0.497,37,47,0.787,37,121,158,20,18,13,27,63,302,1.1,0.9,2.0,2013
Rashard Lewis,SF,34,60,971,98,236,0.415,46,134,0.343,52,102,0.51,26,33,0.788,24,86,110,57,53,8,35,90,268,0.5,1.1,1.7,2013
DeAndre Liggins,SG,25,1,1,1,1,1.0,0,0,0.0,1,1,1.0,0,0,0.0,1,0,1,0,0,0,0,0,2,0.0,0.0,0.0,2013
Damian Lillard,PG,23,82,2937,553,1304,0.424,218,554,0.394,335,750,0.447,371,426,0.871,35,253,288,457,64,22,193,197,1695,7.8,1.8,9.6,2013
Jeremy Lin,PG,25,71,2054,295,662,0.446,82,229,0.358,213,433,0.492,218,265,0.823,34,153,187,294,68,27,176,166,890,2.8,1.6,4.4,2013
Shaun Livingston,PG,28,76,1974,235,487,0.483,1,6,0.167,234,481,0.486,158,191,0.827,67,179,246,245,93,31,105,172,629,2.6,1.8,4.4,2013
Brook Lopez,C,25,17,533,129,229,0.563,0,1,0.0,129,228,0.566,94,115,0.817,39,63,102,16,9,30,28,52,352,1.9,0.5,2.3,2013
Robin Lopez,C,25,82,2603,355,644,0.551,0,1,0.0,355,643,0.552,198,242,0.818,326,374,700,73,25,139,84,196,908,7.0,2.6,9.5,2013
Kevin Love,PF,25,77,2797,650,1421,0.457,190,505,0.376,460,916,0.502,520,633,0.821,224,739,963,341,59,35,196,136,2010,10.6,3.7,14.3,2013
Kyle Lowry,PG,27,79,2862,457,1080,0.423,190,500,0.38,267,580,0.46,313,385,0.813,88,281,369,586,121,15,194,267,1417,8.4,3.3,11.7,2013
John Lucas III,PG,31,42,591,62,190,0.326,25,84,0.298,37,106,0.349,10,16,0.625,12,27,39,42,14,0,22,41,159,-0.7,0.0,-0.7,2013
Shelvin Mack,PG,23,73,1490,209,501,0.417,62,184,0.337,147,317,0.464,64,74,0.865,21,139,160,271,50,2,89,100,544,1.2,1.2,2.3,2013
Ian Mahinmi,C,27,77,1248,91,189,0.481,0,1,0.0,91,188,0.484,90,145,0.621,107,150,257,24,41,72,58,207,272,0.7,2.7,3.3,2013
Shawn Marion,SF,35,76,2409,341,708,0.482,58,162,0.358,283,546,0.518,51,65,0.785,132,365,497,124,90,37,95,125,791,2.2,2.1,4.3,2013
Kendall Marshall,PG,22,54,1564,170,419,0.406,71,178,0.399,99,241,0.411,19,36,0.528,15,140,155,477,48,4,150,76,430,0.6,0.3,0.9,2013
Cartier Martin,SF,29,59,870,111,264,0.42,59,151,0.391,52,113,0.46,48,65,0.738,13,97,110,33,27,7,34,71,329,0.5,0.8,1.3,2013
Kenyon Martin,PF,36,32,633,63,123,0.512,0,1,0.0,63,122,0.516,11,19,0.579,36,98,134,50,25,27,26,85,137,0.5,0.7,1.2,2013
Kevin Martin,SG,30,68,2177,440,1023,0.43,115,297,0.387,325,726,0.448,303,340,0.891,34,169,203,121,66,6,106,123,1298,3.8,1.5,5.3,2013
Roger Mason,SG,33,25,260,25,67,0.373,17,48,0.354,8,19,0.421,7,7,1.0,1,21,22,19,6,1,9,26,74,0.1,0.2,0.3,2013
Wesley Matthews,SG,27,82,2780,445,1009,0.441,201,511,0.393,244,498,0.49,252,301,0.837,51,238,289,197,76,14,110,176,1343,6.3,1.9,8.2,2013
Jason Maxiell,PF,30,34,488,47,105,0.448,0,0,0.0,47,105,0.448,15,31,0.484,28,58,86,9,8,20,14,47,109,-0.1,0.4,0.3,2013
Eric Maynor,PG,26,31,327,32,101,0.317,12,37,0.324,20,64,0.313,6,11,0.545,9,30,39,52,9,3,29,17,82,-0.6,0.2,-0.4,2013
O.J. Mayo,SG,26,52,1346,224,550,0.407,84,227,0.37,140,323,0.433,76,88,0.864,24,100,124,113,28,13,95,111,608,0.0,0.0,0.1,2013
Luc Mbah a Moute,PF,27,64,1003,87,193,0.451,4,17,0.235,83,176,0.472,46,67,0.687,56,90,146,36,30,14,40,68,224,0.2,0.8,1.0,2013
Ray McCallum,PG,22,45,897,113,300,0.377,22,59,0.373,91,241,0.378,32,43,0.744,18,61,79,120,22,9,39,69,280,0.0,0.4,0.4,2013
CJ McCollum,SG,22,38,476,74,178,0.416,30,80,0.375,44,98,0.449,23,34,0.676,7,41,48,27,14,2,35,53,201,-0.2,0.3,0.2,2013
JaVale McGee,C,26,5,79,17,38,0.447,0,0,0.0,17,38,0.447,1,1,1.0,10,7,17,2,1,7,8,16,35,-0.1,0.1,-0.1,2013
Ben McLemore,SG,20,82,2187,255,679,0.376,95,297,0.32,160,382,0.419,115,143,0.804,53,182,235,82,45,18,96,201,720,-0.1,0.9,0.8,2013
Josh McRoberts,PF,26,78,2360,247,566,0.436,105,291,0.361,142,275,0.516,62,85,0.729,85,288,373,333,58,46,83,189,661,3.5,3.0,6.5,2013
Jodie Meeks,SG,26,77,2556,413,892,0.463,162,404,0.401,251,488,0.514,221,258,0.857,30,164,194,138,111,4,111,119,1209,3.8,0.7,4.5,2013
Gal Mekel,PG,25,31,292,30,86,0.349,5,20,0.25,25,66,0.379,8,12,0.667,5,22,27,63,4,1,31,31,73,-0.5,0.1,-0.4,2013
Khris Middleton,SF,22,82,2460,376,854,0.44,120,290,0.414,256,564,0.454,118,137,0.861,60,250,310,169,83,20,123,243,990,1.9,0.8,2.7,2013
C.J. Miles,SG,26,51,984,178,409,0.435,83,211,0.393,95,198,0.48,64,75,0.853,18,85,103,52,46,15,44,103,503,1.5,0.9,2.5,2013
Andre Miller,SG,37,58,982,106,231,0.459,11,21,0.524,95,210,0.452,60,77,0.779,28,102,130,197,34,9,61,75,283,1.4,0.8,2.2,2013
Darius Miller,SF,23,45,723,73,166,0.44,25,77,0.325,48,89,0.539,29,36,0.806,9,43,52,43,24,9,22,88,200,0.6,0.2,0.8,2013
Mike Miller,SF,33,82,1707,213,443,0.481,107,233,0.459,106,210,0.505,46,56,0.821,30,177,207,130,26,5,77,95,579,2.6,1.4,3.9,2013
Quincy Miller,PF,21,52,789,94,256,0.367,30,94,0.319,64,162,0.395,39,55,0.709,36,111,147,26,22,32,48,70,257,-0.7,0.7,0.0,2013
Patty Mills,PG,25,81,1527,309,666,0.464,135,318,0.425,174,348,0.5,73,82,0.89,34,135,169,149,68,9,63,114,826,3.4,2.1,5.6,2013
Paul Millsap,PF,28,74,2482,483,1047,0.461,76,212,0.358,407,835,0.487,286,391,0.731,154,473,627,232,129,78,185,210,1328,2.7,4.0,6.7,2013
Tony Mitchell,PF,21,21,79,5,12,0.417,1,1,1.0,4,11,0.364,11,19,0.579,15,11,26,2,6,3,4,9,22,0.1,0.1,0.2,2013
Tony Mitchell,SF,24,3,10,3,5,0.6,0,1,0.0,3,4,0.75,0,0,0.0,1,0,1,1,1,0,0,0,6,0.0,0.0,0.1,2013
Nazr Mohammed,C,36,80,562,54,126,0.429,0,0,0.0,54,126,0.429,16,30,0.533,66,109,175,20,14,30,37,77,124,-0.4,1.2,0.8,2013
Greg Monroe,PF,23,82,2690,504,1015,0.497,0,1,0.0,504,1014,0.497,241,367,0.657,256,504,760,171,91,47,166,205,1249,3.7,2.3,5.9,2013
E'Twaun Moore,SG,24,79,1506,195,456,0.428,57,161,0.354,138,295,0.468,52,68,0.765,29,107,136,112,60,13,55,106,499,0.6,1.1,1.7,2013
Darius Morris,PG,23,27,313,39,96,0.406,12,38,0.316,27,58,0.466,17,26,0.654,7,19,26,44,13,0,27,33,107,-0.1,0.2,0.0,2013
Marcus Morris,SF,24,82,1800,288,651,0.442,99,260,0.381,189,391,0.483,121,159,0.761,84,235,319,88,72,18,95,157,796,2.3,1.8,4.2,2013
Markieff Morris,PF,24,81,2153,411,845,0.486,34,108,0.315,377,737,0.512,259,327,0.792,139,346,485,144,68,51,147,232,1115,4.0,2.4,6.4,2013
Anthony Morrow,SG,28,76,1426,238,520,0.458,88,195,0.451,150,325,0.462,72,87,0.828,29,111,140,59,38,12,51,102,636,2.1,0.3,2.4,2013
Donatas Motiejūnas,PF,23,62,952,131,296,0.443,21,84,0.25,110,212,0.519,58,96,0.604,60,165,225,34,20,21,49,132,341,0.3,1.0,1.4,2013
Arnett Moultrie,PF,23,12,187,16,38,0.421,0,0,0.0,16,38,0.421,4,5,0.8,11,24,35,2,8,4,7,22,36,-0.1,0.1,0.0,2013
Timofey Mozgov,C,27,82,1770,285,545,0.523,4,24,0.167,281,521,0.539,196,260,0.754,171,357,528,62,27,100,122,213,770,2.6,1.9,4.5,2013
Shabazz Muhammad,SG,21,37,290,57,124,0.46,3,11,0.273,54,113,0.478,26,40,0.65,24,29,53,6,8,1,16,24,143,0.1,0.2,0.3,2013
Byron Mullens,C,24,45,414,73,165,0.442,33,89,0.371,40,76,0.526,10,20,0.5,24,68,92,14,15,11,27,64,189,0.1,0.4,0.5,2013
Erik Murphy,C,23,24,62,3,13,0.231,0,3,0.0,3,10,0.3,0,0,0.0,2,6,8,2,0,4,2,7,6,-0.2,0.1,-0.1,2013
Toure' Murry,PG,24,51,373,56,129,0.434,5,12,0.417,51,117,0.436,23,39,0.59,13,31,44,49,19,1,34,46,140,-0.3,0.3,0.0,2013
Mike Muscala,PF,22,20,215,31,73,0.425,0,3,0.0,31,70,0.443,14,14,1.0,17,35,52,7,3,10,12,29,76,-0.1,0.2,0.2,2013
Hamady N'Diaye,C,27,14,74,3,9,0.333,0,0,0.0,3,9,0.333,0,1,0.0,5,13,18,3,0,4,3,15,6,-0.1,0.1,0.0,2013
Steve Nash*,PG,39,15,313,36,94,0.383,8,24,0.333,28,70,0.4,22,24,0.917,4,25,29,86,7,2,31,18,102,0.1,0.0,0.1,2013
Gary Neal,SG,29,52,1114,193,471,0.41,68,180,0.378,125,291,0.43,94,105,0.895,10,80,90,83,18,0,64,65,548,0.6,0.3,1.0,2013
Nemanja Nedović,SG,22,24,142,8,39,0.205,3,18,0.167,5,21,0.238,7,8,0.875,3,12,15,13,0,1,13,13,26,-0.5,0.1,-0.4,2013
Jameer Nelson,PG,31,68,2179,294,747,0.394,136,391,0.348,158,356,0.444,96,112,0.857,29,202,231,476,52,5,166,146,820,1.6,1.2,2.8,2013
Andrew Nicholson,PF,24,76,1174,180,420,0.429,28,89,0.315,152,331,0.459,47,57,0.825,53,202,255,25,18,23,51,150,435,-0.4,1.0,0.6,2013
Joakim Noah,C,28,80,2820,380,800,0.475,0,2,0.0,380,798,0.476,247,335,0.737,282,618,900,431,99,121,194,245,1007,4.5,6.6,11.2,2013
Steve Novak,PF,30,54,540,60,146,0.411,52,122,0.426,8,24,0.333,6,6,1.0,8,50,58,13,12,4,5,44,178,1.0,0.5,1.4,2013
Dirk Nowitzki*,PF,35,80,2628,633,1273,0.497,131,329,0.398,502,944,0.532,338,376,0.899,40,458,498,216,73,45,117,165,1735,8.6,2.3,10.9,2013
James Nunnally,SF,23,13,165,15,46,0.326,8,25,0.32,7,21,0.333,6,9,0.667,1,18,19,8,6,2,7,11,44,-0.2,0.1,-0.1,2013
Jermaine O'Neal,PF,35,44,883,125,248,0.504,0,0,0.0,125,248,0.504,99,132,0.75,85,157,242,25,14,40,52,102,349,1.3,1.4,2.7,2013
Kyle O'Quinn,C,23,69,1188,186,371,0.501,0,3,0.0,186,368,0.505,57,83,0.687,100,264,364,78,39,88,78,165,429,0.5,2.0,2.5,2013
Greg Oden,C,26,23,212,27,49,0.551,0,0,0.0,27,49,0.551,13,23,0.565,23,31,54,1,7,13,12,52,67,0.2,0.3,0.5,2013
Victor Oladipo,PG,21,80,2487,392,936,0.419,74,226,0.327,318,710,0.448,248,318,0.78,43,286,329,327,129,37,256,210,1106,-1.4,2.8,1.3,2013
Kelly Olynyk,C,22,70,1400,234,502,0.466,40,114,0.351,194,388,0.5,99,122,0.811,140,225,365,109,35,27,106,227,607,1.5,1.4,2.9,2013
Arinze Onuaku,PF,26,5,30,1,5,0.2,0,0,0.0,1,5,0.2,1,2,0.5,2,6,8,3,0,0,1,3,3,0.0,0.0,0.0,2013
Daniel Orton,C,23,22,251,21,47,0.447,0,0,0.0,21,47,0.447,23,30,0.767,16,45,61,15,6,16,18,38,65,0.0,0.2,0.3,2013
Travis Outlaw,SF,29,63,1065,130,326,0.399,41,117,0.35,89,209,0.426,42,52,0.808,36,132,168,48,20,19,26,94,343,0.8,0.6,1.4,2013
Zaza Pachulia,C,29,53,1325,149,349,0.427,0,1,0.0,149,348,0.428,110,130,0.846,141,192,333,136,45,14,92,124,408,1.0,0.7,1.7,2013
Jannero Pargo,PG,34,29,242,52,118,0.441,24,60,0.4,28,58,0.483,8,11,0.727,1,19,20,52,14,1,26,17,136,0.2,0.4,0.5,2013
Tony Parker*,PG,31,68,1997,456,914,0.499,25,67,0.373,431,847,0.509,197,243,0.811,17,138,155,388,36,9,151,86,1134,3.9,1.9,5.9,2013
Chandler Parsons,SF,25,74,2783,466,987,0.472,130,351,0.37,336,636,0.528,164,221,0.742,69,340,409,298,88,29,144,168,1226,5.1,2.5,7.6,2013
Patrick Patterson,PF,24,65,1533,225,489,0.46,55,151,0.364,170,338,0.503,50,71,0.704,117,225,342,78,55,37,65,159,555,1.8,2.0,3.8,2013
Chris Paul,PG,28,62,2171,406,870,0.467,78,212,0.368,328,658,0.498,295,345,0.855,38,230,268,663,154,4,145,157,1185,9.0,3.2,12.2,2013
Nikola Peković,C,28,54,1663,379,701,0.541,0,0,0.0,379,701,0.541,186,249,0.747,206,262,468,50,30,23,84,129,944,4.3,1.5,5.9,2013
Kendrick Perkins,C,29,62,1207,87,193,0.451,0,1,0.0,87,192,0.453,37,67,0.552,82,223,305,67,26,32,90,177,211,-0.9,1.7,0.8,2013
Paul Pierce*,SF,36,75,2098,321,712,0.451,112,300,0.373,209,412,0.507,256,310,0.826,26,322,348,178,86,31,153,190,1010,2.9,2.3,5.2,2013
Dexter Pittman,C,25,2,3,0,1,0.0,0,0,0.0,0,1,0.0,0,2,0.0,3,0,3,0,0,0,0,0,0,0.0,0.0,0.0,2013
Mason Plumlee,C,23,70,1275,199,302,0.659,0,3,0.0,199,299,0.666,122,195,0.626,99,209,308,60,49,55,77,171,520,3.0,1.7,4.7,2013
Miles Plumlee,C,25,80,1964,286,553,0.517,0,0,0.0,286,553,0.517,74,132,0.561,198,428,626,43,50,90,111,185,646,1.2,2.8,4.0,2013
Quincy Pondexter,SG,25,15,270,31,79,0.392,11,34,0.324,20,45,0.444,21,26,0.808,10,16,26,20,5,1,15,18,94,0.2,0.2,0.4,2013
Otto Porter Jr.,SF,20,37,319,33,91,0.363,4,21,0.19,29,70,0.414,8,12,0.667,21,36,57,10,8,1,14,26,78,-0.4,0.3,0.0,2013
Josh Powell,PF,31,1,19,2,6,0.333,0,0,0.0,2,6,0.333,0,0,0.0,0,5,5,0,0,1,1,1,4,-0.1,0.0,0.0,2013
Phil Pressey,PG,22,75,1132,78,253,0.308,28,106,0.264,50,147,0.34,29,45,0.644,20,85,105,241,68,5,87,97,213,-1.0,1.1,0.1,2013
A.J. Price,SG,27,28,99,19,46,0.413,6,22,0.273,13,24,0.542,0,2,0.0,1,9,10,13,1,0,7,5,44,-0.1,0.0,0.0,2013
Ronnie Price,SG,30,31,377,28,92,0.304,9,43,0.209,19,49,0.388,9,13,0.692,8,35,43,66,25,2,26,50,74,-0.5,0.4,-0.1,2013
Pablo Prigioni,PG,36,66,1283,88,191,0.461,65,140,0.464,23,51,0.451,11,12,0.917,36,93,129,228,67,2,60,132,252,2.5,0.9,3.4,2013
Tayshaun Prince,SF,33,76,1948,200,492,0.407,20,69,0.29,180,423,0.426,34,60,0.567,32,202,234,119,39,19,41,63,454,-0.2,1.8,1.5,2013
Miroslav Raduljica,C,26,48,465,68,126,0.54,0,0,0.0,68,126,0.54,45,55,0.818,54,54,108,23,7,13,28,84,181,1.0,0.1,1.1,2013
Anthony Randolph,PF,24,43,527,68,176,0.386,18,61,0.295,50,115,0.435,52,69,0.754,20,102,122,32,26,19,39,64,206,-0.1,0.7,0.6,2013
Shavlik Randolph,PF,30,14,95,7,14,0.5,0,0,0.0,7,14,0.5,6,11,0.545,7,18,25,1,3,1,5,15,20,0.0,0.1,0.1,2013
Zach Randolph,PF,32,79,2705,560,1198,0.467,2,20,0.1,558,1178,0.474,250,337,0.742,265,530,795,200,54,23,183,210,1372,2.9,3.5,6.4,2013
JJ Redick,SG,29,35,987,181,398,0.455,73,185,0.395,108,213,0.507,97,106,0.915,9,65,74,78,28,3,42,65,532,2.3,0.7,3.0,2013
Glen Rice Jr.,SG,23,11,109,11,37,0.297,5,17,0.294,6,20,0.3,5,7,0.714,4,16,20,7,6,1,9,7,32,-0.3,0.2,-0.1,2013
Luke Ridnour,PG,32,61,1141,126,327,0.385,37,108,0.343,89,219,0.406,17,26,0.654,23,74,97,176,32,8,66,92,306,-0.3,0.4,0.1,2013
Austin Rivers,PG,21,69,1339,192,474,0.405,36,99,0.364,156,375,0.416,110,173,0.636,26,103,129,160,45,9,77,134,530,0.2,0.4,0.6,2013
Andre Roberson,SG,22,40,399,33,68,0.485,2,13,0.154,31,55,0.564,7,10,0.7,36,58,94,15,19,10,19,74,75,0.2,0.6,0.8,2013
Brian Roberts,PG,28,72,1667,244,581,0.42,64,178,0.36,180,403,0.447,125,133,0.94,17,119,136,234,43,7,95,132,677,2.0,0.2,2.2,2013
Nate Robinson,PG,29,44,866,164,383,0.428,58,154,0.377,106,229,0.463,71,85,0.835,21,60,81,112,36,4,58,92,457,1.3,0.5,1.8,2013
Thomas Robinson,PF,22,70,873,141,293,0.481,0,1,0.0,141,292,0.483,57,101,0.564,105,202,307,34,23,20,57,131,339,0.4,1.2,1.6,2013
Rajon Rondo,PG,27,30,998,141,350,0.403,26,90,0.289,115,260,0.442,42,67,0.627,22,142,164,294,40,2,99,65,350,0.2,1.0,1.1,2013
Derrick Rose,PG,25,10,311,58,164,0.354,16,47,0.34,42,117,0.359,27,32,0.844,9,23,32,43,5,1,34,15,159,-0.6,0.4,-0.2,2013
Terrence Ross,SG,22,81,2159,318,751,0.423,161,408,0.395,157,343,0.458,82,98,0.837,43,209,252,79,64,27,88,183,879,2.0,2.2,4.2,2013
Ricky Rubio,PG,23,82,2638,255,670,0.381,44,133,0.331,211,537,0.393,227,283,0.802,61,281,342,704,191,11,221,218,781,2.2,3.6,5.9,2013
Brandon Rush,SG,28,38,418,30,90,0.333,16,47,0.34,14,43,0.326,3,5,0.6,5,39,44,24,5,9,20,31,79,-0.5,0.0,-0.4,2013
Robert Sacre,C,24,65,1089,143,300,0.477,0,0,0.0,143,300,0.477,64,94,0.681,82,172,254,51,24,47,44,134,350,0.7,0.7,1.4,2013
John Salmons,SG,34,78,1726,150,413,0.363,63,163,0.387,87,250,0.348,40,52,0.769,20,143,163,147,47,19,54,124,403,0.2,1.4,1.7,2013
Larry Sanders,C,25,23,584,76,162,0.469,0,1,0.0,76,161,0.472,26,55,0.473,60,105,165,19,18,40,26,74,178,0.1,0.6,0.7,2013
Dennis Schröder,PG,20,49,641,72,188,0.383,10,42,0.238,62,146,0.425,29,43,0.674,5,55,60,93,17,0,61,54,183,-1.1,0.4,-0.7,2013
Luis Scola,PF,33,82,1399,263,560,0.47,1,7,0.143,262,553,0.474,99,136,0.728,86,305,391,81,26,16,108,164,626,-0.4,2.8,2.5,2013
Mike Scott,PF,25,80,1482,301,628,0.479,62,200,0.31,239,428,0.558,103,132,0.78,62,222,284,75,30,7,79,121,767,1.3,1.2,2.6,2013
Thabo Sefolosha,SG,29,61,1584,141,340,0.415,48,152,0.316,93,188,0.495,53,69,0.768,50,170,220,94,79,17,55,90,383,0.9,2.1,3.0,2013
Kevin Séraphin,C,24,53,578,111,220,0.505,0,0,0.0,111,220,0.505,27,31,0.871,53,75,128,17,3,26,41,103,249,0.2,0.6,0.8,2013
Ramon Sessions,PG,27,83,2214,330,769,0.429,35,124,0.282,295,645,0.457,326,404,0.807,38,165,203,340,49,9,148,90,1021,3.1,1.2,4.3,2013
Mustafa Shakur,PG,29,3,11,0,3,0.0,0,1,0.0,0,2,0.0,1,2,0.5,0,0,0,4,0,0,2,2,1,-0.1,0.0,-0.1,2013
Tornike Shengelia,SF,22,26,154,13,28,0.464,0,6,0.0,13,22,0.591,3,8,0.375,4,12,16,14,3,1,12,18,29,-0.2,0.1,-0.1,2013
Iman Shumpert,SG,23,74,1962,183,484,0.378,76,228,0.333,107,256,0.418,53,71,0.746,81,227,308,129,92,13,79,209,495,0.4,1.6,2.0,2013
Alexey Shved,SG,25,63,664,76,237,0.321,30,102,0.294,46,135,0.341,68,90,0.756,21,60,81,68,26,16,48,36,250,-0.4,0.7,0.2,2013
Henry Sims,C,23,46,875,130,274,0.474,0,1,0.0,130,273,0.476,90,121,0.744,104,133,237,52,28,20,41,116,350,1.4,0.7,2.1,2013
Kyle Singler,SF,25,82,2337,269,602,0.447,94,246,0.382,175,356,0.492,152,184,0.826,116,187,303,75,61,38,79,211,784,3.6,0.7,4.4,2013
Chris Singleton,SF,24,25,250,25,67,0.373,7,19,0.368,18,48,0.375,18,25,0.72,18,37,55,6,9,3,17,25,75,-0.2,0.3,0.2,2013
Peyton Siva,SG,23,24,224,18,57,0.316,7,25,0.28,11,32,0.344,11,15,0.733,2,12,14,34,9,1,18,27,54,-0.2,0.1,-0.2,2013
Donald Sloan,SG,26,48,392,44,117,0.376,10,42,0.238,34,75,0.453,12,20,0.6,4,40,44,50,10,1,22,19,110,-0.3,0.6,0.3,2013
Chris Smith,PG,26,2,2,0,0,0.0,0,0,0.0,0,0,0.0,0,0,0.0,0,0,0,0,0,0,0,0,0,0.0,0.0,0.0,2013
Greg Smith,C,23,11,100,18,28,0.643,0,0,0.0,18,28,0.643,2,5,0.4,11,16,27,0,1,2,5,17,38,0.2,0.1,0.2,2013
Ish Smith,PG,25,70,1006,119,281,0.423,1,23,0.043,118,258,0.457,22,39,0.564,31,98,129,179,49,13,65,66,261,0.0,1.0,1.0,2013
J.R. Smith,SF,28,74,2421,396,955,0.415,189,480,0.394,207,475,0.436,90,138,0.652,35,261,296,219,65,20,108,196,1071,2.5,1.2,3.7,2013
Jason Smith,PF,27,31,830,131,282,0.465,0,0,0.0,131,282,0.465,39,50,0.78,51,130,181,29,11,29,28,100,301,0.5,0.4,0.9,2013
Josh Smith,SF,28,77,2730,517,1233,0.419,70,265,0.264,447,968,0.462,160,301,0.532,102,418,520,252,105,110,199,197,1264,-1.4,2.5,1.1,2013
Tony Snell,SG,22,77,1231,129,336,0.384,57,178,0.32,72,158,0.456,31,41,0.756,19,105,124,68,29,15,44,84,346,-0.1,1.7,1.6,2013
James Southerland,SF,23,4,30,5,15,0.333,3,6,0.5,2,9,0.222,1,2,0.5,0,8,8,0,1,2,1,3,14,-0.1,0.0,0.0,2013
Marreese Speights,C,26,79,982,195,442,0.441,8,31,0.258,187,411,0.455,110,134,0.821,101,189,290,32,10,34,66,148,508,0.6,1.5,2.1,2013
Tiago Splitter,C,29,59,1271,181,346,0.523,0,3,0.0,181,343,0.528,121,173,0.699,123,240,363,90,29,31,75,117,483,2.3,2.1,4.3,2013
D.J. Stephens,SG,23,3,15,3,7,0.429,0,0,0.0,3,7,0.429,1,1,1.0,1,4,5,0,0,0,0,0,7,0.0,0.0,0.0,2013
Lance Stephenson,SG,23,78,2752,427,870,0.491,86,244,0.352,341,626,0.545,140,197,0.711,95,463,558,359,54,7,210,195,1080,2.6,4.8,7.4,2013
Greg Stiemsma,C,28,55,1007,70,122,0.574,0,1,0.0,70,121,0.579,19,32,0.594,72,154,226,36,35,57,44,169,159,0.5,1.0,1.5,2013
Julyan Stone,SG,25,21,120,7,17,0.412,2,8,0.25,5,9,0.556,2,3,0.667,2,18,20,12,3,0,5,13,18,0.0,0.1,0.2,2013
Amar'e Stoudemire,C,31,65,1466,311,558,0.557,0,0,0.0,311,558,0.557,150,203,0.739,112,208,320,34,23,37,91,159,772,2.9,0.9,3.8,2013
Rodney Stuckey,SG,27,73,1950,372,853,0.436,24,88,0.273,348,765,0.455,244,292,0.836,39,130,169,152,54,10,125,131,1012,1.8,0.4,2.2,2013
Jared Sullinger,PF,21,74,2041,384,899,0.427,56,208,0.269,328,691,0.475,158,203,0.778,241,360,601,118,35,49,119,251,982,1.9,2.0,3.9,2013
Jeff Taylor,SF,24,26,629,82,218,0.376,18,67,0.269,64,151,0.424,26,47,0.553,15,45,60,22,13,5,25,62,208,-0.8,0.6,-0.2,2013
Tyshawn Taylor,PG,23,23,270,31,91,0.341,3,12,0.25,28,79,0.354,24,30,0.8,3,12,15,36,12,1,31,29,89,-0.7,0.2,-0.6,2013
Jeff Teague,PG,25,79,2542,456,1040,0.438,74,225,0.329,382,815,0.469,318,376,0.846,34,174,208,528,89,17,232,158,1304,3.3,1.9,5.2,2013
Marquis Teague,SG,20,40,443,38,119,0.319,5,18,0.278,33,101,0.327,26,35,0.743,1,39,40,58,10,5,39,46,107,-1.0,0.4,-0.5,2013
Mirza Teletović,SF,28,72,1396,221,529,0.418,136,349,0.39,85,180,0.472,44,62,0.71,60,206,266,57,29,23,54,143,622,1.6,1.1,2.7,2013
Garrett Temple,SG,27,75,638,51,141,0.362,6,29,0.207,45,112,0.402,30,43,0.698,21,47,68,72,35,11,42,72,138,-0.5,0.9,0.3,2013
Jason Terry,PG,36,35,570,55,152,0.362,39,103,0.379,16,49,0.327,10,15,0.667,4,33,37,56,13,0,27,48,159,0.0,0.2,0.2,2013
Hasheem Thabeet,C,26,23,192,13,23,0.565,0,0,0.0,13,23,0.565,1,5,0.2,9,31,40,1,4,9,14,47,27,-0.2,0.3,0.0,2013
Adonis Thomas,SF,20,6,37,6,14,0.429,1,5,0.2,5,9,0.556,1,1,1.0,0,3,3,3,0,0,1,6,14,0.0,0.0,0.0,2013
Isaiah Thomas,PG,24,72,2497,496,1096,0.453,127,364,0.349,369,732,0.504,346,407,0.85,47,163,210,454,93,8,213,185,1465,6.4,1.3,7.7,2013
Lance Thomas,SF,25,5,42,2,9,0.222,0,0,0.0,2,9,0.222,2,4,0.5,2,5,7,3,0,0,2,4,6,-0.1,0.0,-0.1,2013
Malcolm Thomas,PF,25,8,63,7,16,0.438,1,4,0.25,6,12,0.5,0,2,0.0,5,16,21,2,0,3,9,5,15,-0.2,0.1,-0.2,2013
Hollis Thompson,SF,22,77,1742,171,372,0.46,67,167,0.401,104,205,0.507,52,73,0.712,73,174,247,73,53,12,60,144,461,1.4,0.6,2.0,2013
Jason Thompson,PF,27,82,2007,251,496,0.506,0,0,0.0,251,496,0.506,84,145,0.579,153,374,527,53,32,56,95,251,586,0.9,1.7,2.7,2013
Klay Thompson,SG,23,81,2868,559,1259,0.444,223,535,0.417,336,724,0.464,147,185,0.795,38,211,249,181,74,37,135,234,1488,3.5,3.2,6.7,2013
Tristan Thompson,PF,22,82,2594,363,761,0.477,0,1,0.0,363,760,0.478,235,339,0.693,269,485,754,72,42,35,108,188,961,3.4,2.3,5.7,2013
Marcus Thornton,SG,26,72,1741,252,639,0.394,109,316,0.345,143,323,0.443,90,112,0.804,57,141,198,77,58,11,67,110,703,1.0,1.0,2.0,2013
Jamaal Tinsley,PG,35,8,110,4,20,0.2,1,15,0.067,3,5,0.6,0,0,0.0,2,9,11,23,2,0,9,10,9,-0.3,0.0,-0.3,2013
Anthony Tolliver,PF,28,64,1298,129,307,0.42,102,247,0.413,27,60,0.45,33,41,0.805,33,135,168,42,19,15,23,82,393,1.9,1.3,3.2,2013
P.J. Tucker,SF,28,81,2490,265,615,0.431,74,191,0.387,191,424,0.45,156,201,0.776,161,368,529,141,110,23,102,204,760,3.3,2.8,6.1,2013
Ronny Turiaf,C,31,31,606,64,107,0.598,0,0,0.0,64,107,0.598,21,50,0.42,55,119,174,24,8,50,24,65,149,0.6,0.9,1.5,2013
Hedo Türkoğlu,SF,34,38,392,42,109,0.385,22,50,0.44,20,59,0.339,9,18,0.5,11,78,89,33,19,10,16,50,115,0.1,0.7,0.8,2013
Evan Turner,SF,25,81,2457,434,1021,0.425,50,156,0.321,384,865,0.444,213,262,0.813,62,346,408,262,67,7,189,195,1131,-0.5,1.8,1.4,2013
Jeremy Tyler,C,22,41,398,60,116,0.517,0,0,0.0,60,116,0.517,26,48,0.542,38,71,109,8,6,20,26,70,146,0.1,0.4,0.5,2013
Ekpe Udoh,PF,26,42,804,57,143,0.399,0,0,0.0,57,143,0.399,30,47,0.638,61,87,148,31,15,44,38,96,144,-0.4,0.4,0.0,2013
Beno Udrih,SG,31,41,643,78,178,0.438,19,42,0.452,59,136,0.434,25,30,0.833,10,49,59,116,23,4,47,50,200,0.5,0.3,0.8,2013
Jonas Valančiūnas,C,21,81,2282,359,676,0.531,0,1,0.0,359,675,0.532,198,260,0.762,226,488,714,57,24,71,136,249,916,3.5,3.2,6.7,2013
Anderson Varejão,C,31,65,1800,227,459,0.495,0,7,0.0,227,452,0.502,92,135,0.681,187,442,629,140,69,39,72,164,546,2.7,2.7,5.4,2013
Jarvis Varnado,PF,25,24,339,36,60,0.6,0,0,0.0,36,60,0.6,27,52,0.519,19,44,63,13,10,29,10,62,99,0.5,0.3,0.8,2013
Greivis Vásquez,PG,27,79,1779,277,658,0.421,109,289,0.377,168,369,0.455,95,108,0.88,20,153,173,323,31,5,128,143,758,2.4,1.2,3.6,2013
Jan Veselý,PF,23,54,776,89,173,0.514,0,0,0.0,89,173,0.514,19,56,0.339,81,110,191,21,53,35,36,121,197,0.2,1.4,1.6,2013
Charlie Villanueva,PF,29,20,180,35,92,0.38,14,56,0.25,21,36,0.583,8,14,0.571,6,28,34,6,4,5,7,16,92,0.0,0.1,0.1,2013
Nikola Vučević,C,23,57,1812,353,696,0.507,0,0,0.0,353,696,0.507,105,137,0.766,185,441,626,104,60,47,112,169,811,1.8,2.6,4.4,2013
Sasha Vujačić,SG,29,2,10,2,5,0.4,1,2,0.5,1,3,0.333,0,0,0.0,0,3,3,0,1,0,3,1,5,-0.1,0.0,-0.1,2013
Dwyane Wade*,SG,32,54,1775,415,761,0.545,9,32,0.281,406,729,0.557,189,258,0.733,60,181,241,252,79,29,161,106,1028,3.5,2.0,5.5,2013
Dion Waiters,SG,22,70,2072,430,993,0.433,92,250,0.368,338,743,0.455,161,235,0.685,32,163,195,209,63,17,154,153,1113,0.3,1.3,1.6,2013
Kemba Walker,PG,23,73,2614,449,1143,0.393,109,327,0.333,340,816,0.417,282,337,0.837,39,267,306,447,86,32,169,128,1289,1.8,3.3,5.1,2013
John Wall,PG,23,82,2980,579,1337,0.433,108,308,0.351,471,1029,0.458,317,394,0.805,38,295,333,721,149,40,295,219,1583,4.0,4.0,7.9,2013
Gerald Wallace,SF,31,58,1416,116,230,0.504,19,64,0.297,97,166,0.584,47,101,0.465,36,176,212,143,73,14,97,79,298,-0.3,1.6,1.3,2013
Casper Ware,PG,24,9,116,18,42,0.429,7,21,0.333,11,21,0.524,5,6,0.833,0,9,9,10,8,0,5,11,48,0.1,0.1,0.2,2013
C.J. Watson,PG,29,63,1193,146,334,0.437,53,145,0.366,93,189,0.492,69,88,0.784,19,82,101,107,60,8,60,66,414,1.1,2.1,3.2,2013
Earl Watson,PG,34,24,161,3,11,0.273,2,7,0.286,1,4,0.25,4,4,1.0,5,10,15,28,5,1,17,33,12,-0.2,0.1,-0.1,2013
Maalik Wayns,PG,22,2,9,1,2,0.5,0,0,0.0,1,2,0.5,0,0,0.0,0,2,2,2,2,0,0,4,2,0.0,0.0,0.1,2013
Martell Webster,SF,27,78,2157,254,587,0.433,146,372,0.392,108,215,0.502,105,125,0.84,38,184,222,97,41,15,58,150,759,3.3,1.7,5.0,2013
David West,PF,33,80,2472,458,939,0.488,4,15,0.267,454,924,0.491,198,251,0.789,120,422,542,223,61,74,133,186,1118,3.1,5.0,8.1,2013
Russell Westbrook,PG,25,46,1412,346,791,0.437,68,214,0.318,278,577,0.482,242,293,0.826,55,208,263,319,88,7,177,104,1002,3.0,2.3,5.2,2013
D.J. White,PF,27,2,10,0,1,0.0,0,0,0.0,0,1,0.0,0,0,0.0,0,2,2,0,1,0,0,1,0,0.0,0.0,0.0,2013
Royce White,PF,22,3,9,0,1,0.0,0,0,0.0,0,1,0.0,0,0,0.0,0,0,0,0,0,0,0,2,0,0.0,0.0,0.0,2013
Deron Williams,PG,29,64,2059,322,716,0.45,98,268,0.366,224,448,0.5,173,216,0.801,15,153,168,392,93,13,143,148,915,3.8,1.5,5.4,2013
Derrick Williams,SF,22,78,1820,206,482,0.427,26,99,0.263,180,383,0.47,186,259,0.718,71,252,323,56,48,20,76,114,624,1.3,1.3,2.6,2013
Elliot Williams,SG,24,67,1157,140,337,0.415,37,125,0.296,103,212,0.486,87,119,0.731,30,100,130,72,35,3,68,126,404,0.0,0.3,0.3,2013
Lou Williams,PG,27,60,1445,197,493,0.4,79,231,0.342,118,262,0.45,152,179,0.849,10,114,124,210,45,4,92,65,625,1.6,1.0,2.6,2013
Marvin Williams,PF,27,66,1674,231,526,0.439,84,234,0.359,147,292,0.503,57,73,0.781,82,252,334,78,54,31,53,151,603,1.9,1.0,2.9,2013
Mo Williams,PG,31,74,1834,280,672,0.417,83,225,0.369,197,447,0.441,78,89,0.876,42,111,153,321,55,10,149,197,721,1.0,1.2,2.2,2013
Reggie Williams,SF,27,3,17,5,9,0.556,1,3,0.333,4,6,0.667,0,0,0.0,0,0,0,1,1,0,2,1,11,0.0,0.0,0.0,2013
Shawne Williams,PF,27,36,751,73,192,0.38,42,129,0.326,31,63,0.492,14,20,0.7,25,142,167,30,19,30,21,93,202,0.1,0.6,0.7,2013
Jeff Withey,C,23,58,684,69,129,0.535,0,1,0.0,69,128,0.539,52,73,0.712,49,101,150,26,15,50,20,73,190,1.2,0.6,1.8,2013
Nate Wolters,PG,22,58,1309,170,389,0.437,18,62,0.29,152,327,0.465,59,90,0.656,33,116,149,187,35,15,57,67,417,0.9,0.2,1.2,2013
Metta World Peace,SF,34,29,388,56,141,0.397,17,54,0.315,39,87,0.448,10,16,0.625,18,41,59,17,24,8,19,44,139,-0.2,0.4,0.3,2013
Brandan Wright,C,26,58,1077,224,331,0.677,0,0,0.0,224,331,0.677,77,106,0.726,102,142,244,31,32,55,35,94,525,4.1,1.0,5.1,2013
Chris Wright,SF,25,8,126,21,35,0.6,0,1,0.0,21,34,0.618,6,15,0.4,10,10,20,5,7,5,5,17,48,0.2,0.1,0.3,2013
Dorell Wright,SF,28,68,984,111,297,0.374,69,202,0.342,42,95,0.442,52,69,0.754,29,162,191,64,23,16,39,62,343,0.9,1.0,1.9,2013
Tony Wroten,PG,20,72,1765,345,808,0.427,40,188,0.213,305,620,0.492,209,326,0.641,69,159,228,217,78,16,204,151,939,-1.8,0.9,-0.9,2013
Nick Young,SG,28,64,1810,387,889,0.435,135,350,0.386,252,539,0.468,235,285,0.825,29,137,166,95,46,12,95,156,1144,2.3,0.3,2.5,2013
Thaddeus Young,PF,25,79,2718,582,1283,0.454,90,292,0.308,492,991,0.496,163,229,0.712,166,310,476,182,167,36,165,213,1417,1.2,2.3,3.5,2013
Cody Zeller,C,21,82,1416,172,404,0.426,0,1,0.0,172,403,0.427,146,200,0.73,118,235,353,92,40,41,87,170,490,0.4,2.2,2.6,2013
Tyler Zeller,C,24,70,1049,156,290,0.538,0,1,0.0,156,289,0.54,87,121,0.719,103,179,282,36,18,38,60,137,399,1.5,1.1,2.6,2013
Quincy Acy,PF,24,68,1287,152,331,0.459,18,60,0.3,134,271,0.494,76,97,0.784,79,222,301,68,27,22,60,147,398,1.0,0.7,1.7,2014
Jordan Adams,SG,20,30,248,35,86,0.407,10,25,0.4,25,61,0.41,14,23,0.609,9,19,28,16,16,7,14,24,94,0.0,0.4,0.4,2014
Steven Adams,C,21,70,1771,217,399,0.544,0,2,0.0,217,397,0.547,103,205,0.502,199,324,523,66,38,86,99,222,537,1.9,2.2,4.1,2014
Jeff Adrien,PF,28,17,215,19,44,0.432,0,0,0.0,19,44,0.432,22,38,0.579,23,54,77,15,4,9,9,30,60,0.2,0.2,0.4,2014
Arron Afflalo,SG,29,78,2502,375,884,0.424,118,333,0.354,257,551,0.466,167,198,0.843,27,220,247,129,41,7,116,167,1035,1.6,1.0,2.6,2014
Alexis Ajinça,C,26,68,957,181,329,0.55,0,0,0.0,181,329,0.55,81,99,0.818,104,211,315,47,21,51,69,151,443,1.9,1.2,3.2,2014
Furkan Aldemir,PF,23,41,540,40,78,0.513,0,5,0.0,40,73,0.548,13,27,0.481,78,98,176,28,17,16,17,96,93,0.7,0.7,1.4,2014
Cole Aldrich,C,26,61,976,144,301,0.478,0,0,0.0,144,301,0.478,50,64,0.781,101,237,338,75,37,65,59,122,338,0.8,1.4,2.2,2014
LaMarcus Aldridge,PF,29,71,2512,659,1415,0.466,37,105,0.352,622,1310,0.475,306,362,0.845,177,549,726,124,48,68,122,125,1661,4.9,3.7,8.6,2014
Lavoy Allen,C,25,63,1070,141,299,0.472,0,0,0.0,141,299,0.472,33,47,0.702,123,200,323,73,15,42,40,102,315,1.3,1.6,2.8,2014
Tony Allen,SG,33,63,1648,225,455,0.495,10,29,0.345,215,426,0.505,79,126,0.627,103,177,280,86,129,30,86,166,539,0.9,3.2,4.1,2014
Al-Farouq Aminu,SF,24,74,1366,147,357,0.412,34,124,0.274,113,233,0.485,84,118,0.712,114,228,342,59,70,62,55,137,412,1.2,2.0,3.3,2014
Lou Amundson,PF,32,53,937,109,255,0.427,0,1,0.0,109,254,0.429,41,87,0.471,94,174,268,70,22,52,62,126,259,-0.6,0.9,0.3,2014
Chris Andersen,C,36,60,1132,120,207,0.58,4,13,0.308,116,194,0.598,76,114,0.667,76,223,299,43,26,61,40,88,320,2.1,1.5,3.6,2014
Alan Anderson,SG,32,74,1744,195,440,0.443,73,210,0.348,122,230,0.53,82,101,0.812,31,173,204,83,56,5,60,148,545,1.7,1.1,2.7,2014
Kyle Anderson,SF,21,33,358,31,89,0.348,3,11,0.273,28,78,0.359,9,14,0.643,5,67,72,28,15,7,10,28,74,-0.3,0.6,0.3,2014
Ryan Anderson,PF,26,61,1675,291,729,0.399,122,359,0.34,169,370,0.457,129,151,0.854,108,187,295,55,33,20,62,113,833,2.6,0.9,3.5,2014
Giannis Antetokounmpo,SG,20,81,2541,383,780,0.491,7,44,0.159,376,736,0.511,257,347,0.741,100,442,542,207,73,85,173,254,1030,2.2,4.0,6.2,2014
Carmelo Anthony,SF,30,40,1428,358,806,0.444,61,179,0.341,297,627,0.474,189,237,0.797,72,192,264,122,40,17,89,87,966,2.2,0.6,2.9,2014
Joel Anthony,C,32,49,406,36,62,0.581,0,0,0.0,36,62,0.581,15,22,0.682,32,61,93,5,12,49,12,55,87,0.5,0.7,1.2,2014
Pero Antić,C,32,63,1037,108,296,0.365,52,173,0.301,56,123,0.455,88,123,0.715,58,131,189,49,18,14,49,132,356,0.5,1.0,1.5,2014
Trevor Ariza,SF,29,82,2930,366,910,0.402,194,555,0.35,172,355,0.485,122,143,0.853,77,382,459,209,152,17,141,186,1048,2.7,3.9,6.6,2014
Darrell Arthur,PF,26,58,988,155,384,0.404,26,110,0.236,129,274,0.471,46,59,0.78,53,118,171,57,48,26,47,146,382,-0.1,0.9,0.9,2014
Ömer Aşık,C,28,76,1982,213,412,0.517,0,0,0.0,213,412,0.517,131,225,0.582,244,504,748,72,29,54,95,144,557,2.8,2.2,5.0,2014
D.J. Augustin,PG,27,82,1964,258,647,0.399,83,246,0.337,175,401,0.436,178,205,0.868,20,141,161,353,49,3,145,93,777,2.5,0.9,3.4,2014
Jeff Ayres,PF,27,51,383,55,95,0.579,0,0,0.0,55,95,0.579,27,36,0.75,37,80,117,14,8,8,26,60,137,0.6,0.6,1.2,2014
Luke Babbitt,SF,25,63,830,92,192,0.479,59,115,0.513,33,77,0.429,13,19,0.684,12,99,111,24,17,11,26,63,256,1.1,0.5,1.6,2014
Cameron Bairstow,PF,24,18,64,3,14,0.214,0,0,0.0,3,14,0.214,4,5,0.8,6,2,8,1,2,1,3,8,10,-0.1,0.0,-0.1,2014
Leandro Barbosa,SG,32,66,982,183,386,0.474,43,112,0.384,140,274,0.511,58,74,0.784,23,68,91,99,41,8,44,87,467,1.6,1.2,2.8,2014
J.J. Barea,PG,30,77,1362,225,536,0.42,54,167,0.323,171,369,0.463,76,94,0.809,23,111,134,263,33,1,70,104,580,2.1,0.6,2.7,2014
Andrea Bargnani,C,29,29,785,164,361,0.454,15,41,0.366,149,320,0.466,87,107,0.813,32,95,127,46,2,27,42,53,430,0.8,0.2,0.9,2014
Harrison Barnes,SF,22,82,2318,316,656,0.482,87,215,0.405,229,441,0.519,108,150,0.72,117,336,453,116,61,19,71,146,827,3.7,3.0,6.7,2014
Matt Barnes,SF,34,76,2271,277,624,0.444,136,376,0.362,141,248,0.569,74,95,0.779,51,251,302,114,67,50,87,240,764,2.2,2.1,4.3,2014
Earl Barron,C,33,16,143,12,39,0.308,2,4,0.5,10,35,0.286,6,12,0.5,14,14,28,5,4,2,5,26,32,-0.1,0.1,0.0,2014
Will Barton,SG,24,58,983,150,353,0.425,23,85,0.271,127,268,0.474,74,94,0.787,26,136,162,81,48,19,61,70,397,0.2,1.1,1.3,2014
Brandon Bass,PF,29,82,1929,344,683,0.504,9,32,0.281,335,651,0.515,169,214,0.79,139,259,398,104,41,32,83,140,866,3.4,1.9,5.3,2014
Nicolas Batum,SF,26,71,2380,240,600,0.4,100,309,0.324,140,291,0.481,84,98,0.857,62,354,416,341,78,40,132,106,664,2.0,3.2,5.2,2014
Jerryd Bayless,PG,26,77,1717,220,516,0.426,37,120,0.308,183,396,0.462,121,137,0.883,22,189,211,233,59,12,133,163,598,0.3,2.0,2.4,2014
Aron Baynes,C,28,70,1122,185,327,0.566,1,4,0.25,184,323,0.57,90,104,0.865,109,209,318,35,16,22,65,162,461,2.3,1.6,3.9,2014
Kent Bazemore,SG,25,75,1324,141,331,0.426,48,132,0.364,93,199,0.467,60,100,0.6,21,201,222,78,52,33,73,127,390,-0.4,1.9,1.6,2014
Bradley Beal,SG,21,63,2107,363,851,0.427,106,259,0.409,257,592,0.434,130,166,0.783,57,184,241,194,76,18,123,136,962,1.3,2.4,3.7,2014
Michael Beasley,PF,26,24,505,92,212,0.434,8,34,0.235,84,178,0.472,20,26,0.769,12,77,89,32,15,13,37,66,212,-0.6,0.5,-0.1,2014
Marco Belinelli,SG,28,62,1388,199,470,0.423,86,230,0.374,113,240,0.471,84,99,0.848,26,131,157,94,31,3,61,85,568,1.5,1.4,2.9,2014
Jerrelle Benimon,PF,23,2,3,0,0,0.0,0,0,0.0,0,0,0.0,0,0,0.0,1,2,3,0,0,0,1,0,0,0.0,0.0,0.0,2014
Anthony Bennett,PF,21,57,894,125,297,0.421,7,23,0.304,118,274,0.431,41,64,0.641,52,164,216,48,27,16,36,87,298,-0.1,0.4,0.3,2014
Patrick Beverley,PG,26,56,1727,204,532,0.383,115,323,0.356,89,209,0.426,45,60,0.75,67,170,237,192,59,23,83,182,568,1.7,1.8,3.5,2014
Sim Bhullar,C,22,3,3,1,2,0.5,0,0,0.0,1,2,0.5,0,0,0.0,0,1,1,1,0,1,0,0,2,0.0,0.0,0.0,2014
Bismack Biyombo,C,22,64,1243,101,186,0.543,0,0,0.0,101,186,0.543,102,175,0.583,159,248,407,16,18,99,52,140,304,1.8,2.2,4.0,2014
Tarik Black,C,23,63,1196,157,273,0.575,0,1,0.0,157,272,0.577,65,118,0.551,142,226,368,42,19,24,48,158,379,2.2,0.9,3.1,2014
DeJuan Blair,PF,25,29,180,26,57,0.456,0,0,0.0,26,57,0.456,4,6,0.667,16,40,56,3,7,1,13,41,56,-0.2,0.3,0.1,2014
Steve Blake,PG,34,81,1529,122,327,0.373,77,219,0.352,45,108,0.417,29,41,0.707,16,121,137,288,41,5,104,118,350,0.7,1.4,2.1,2014
Eric Bledsoe,PG,25,81,2800,468,1046,0.447,88,272,0.324,380,774,0.491,353,441,0.8,72,351,423,493,127,45,274,189,1377,4.1,2.9,7.0,2014
Vander Blue,SG,22,2,74,9,30,0.3,2,10,0.2,7,20,0.35,2,5,0.4,2,7,9,8,3,0,6,4,22,-0.3,0.0,-0.2,2014
Bojan Bogdanović,SF,25,78,1854,261,576,0.453,91,256,0.355,170,320,0.531,87,106,0.821,50,163,213,68,34,9,78,104,700,1.7,0.7,2.4,2014
Andrew Bogut,C,30,67,1583,200,355,0.563,0,0,0.0,200,355,0.563,22,42,0.524,141,402,543,180,39,113,106,188,422,1.9,3.4,5.2,2014
Matt Bonner,PF,34,72,935,94,230,0.409,46,126,0.365,48,104,0.462,30,37,0.811,29,86,115,47,10,12,11,65,264,1.3,0.9,2.1,2014
Trevor Booker,PF,27,79,1564,226,464,0.487,29,84,0.345,197,380,0.518,86,148,0.581,139,258,397,83,43,41,88,144,567,1.7,1.9,3.6,2014
Carlos Boozer,PF,33,71,1692,371,743,0.499,0,0,0.0,371,743,0.499,94,150,0.627,111,371,482,95,41,12,92,184,836,1.2,1.0,2.2,2014
Chris Bosh*,C,30,44,1556,343,745,0.46,63,168,0.375,280,577,0.485,179,232,0.772,46,264,310,95,41,25,95,69,928,2.1,1.5,3.6,2014
Avery Bradley,SG,24,77,2428,434,1012,0.429,124,352,0.352,310,660,0.47,79,100,0.79,46,195,241,135,82,15,109,177,1071,0.4,2.1,2.5,2014
Elton Brand,C,35,36,486,42,95,0.442,0,1,0.0,42,94,0.447,12,23,0.522,28,72,100,22,17,25,18,54,96,-0.1,0.8,0.7,2014
Corey Brewer,SF,28,80,2087,343,805,0.426,63,235,0.268,280,570,0.491,168,226,0.743,80,217,297,173,114,19,131,173,917,1.0,2.1,3.1,2014
Aaron Brooks,PG,30,82,1885,344,817,0.421,121,313,0.387,223,504,0.442,145,174,0.833,32,134,166,261,54,15,157,189,954,1.7,1.5,3.3,2014
Jabari Brown,SG,22,19,568,70,170,0.412,23,62,0.371,47,108,0.435,64,85,0.753,3,33,36,40,12,2,32,33,227,0.4,0.0,0.4,2014
Lorenzo Brown,PG,24,29,549,52,122,0.426,6,28,0.214,46,94,0.489,12,19,0.632,14,56,70,90,28,6,30,49,122,0.1,0.2,0.3,2014
Markel Brown,SG,23,47,781,76,210,0.362,17,64,0.266,59,146,0.404,47,57,0.825,16,91,107,39,31,12,27,57,216,-0.2,0.7,0.5,2014
Shannon Brown,SG,29,5,89,7,19,0.368,3,7,0.429,4,12,0.333,3,4,0.75,0,1,1,3,4,0,4,8,20,-0.1,0.0,0.0,2014
Kobe Bryant*,SG,36,35,1207,266,713,0.373,54,184,0.293,212,529,0.401,196,241,0.813,26,173,199,197,47,7,128,65,782,-0.4,0.6,0.2,2014
Chase Budinger,SF,26,67,1286,169,390,0.433,52,143,0.364,117,247,0.474,67,81,0.827,33,165,198,64,44,10,49,72,457,1.1,0.2,1.3,2014
Reggie Bullock,SF,23,36,338,24,70,0.343,15,46,0.326,9,24,0.375,6,9,0.667,1,49,50,8,10,4,8,19,69,-0.2,0.3,0.1,2014
Trey Burke,PG,22,76,2288,370,1005,0.368,124,390,0.318,246,615,0.4,109,145,0.752,31,173,204,328,65,15,124,119,973,0.8,1.6,2.4,2014
Alec Burks,SG,23,27,899,121,300,0.403,26,68,0.382,95,232,0.409,106,129,0.822,19,95,114,82,17,5,52,64,374,1.1,0.6,1.7,2014
Caron Butler,SF,34,78,1623,161,396,0.407,83,219,0.379,78,177,0.441,55,61,0.902,21,175,196,79,43,4,49,120,460,1.3,1.0,2.4,2014
Jimmy Butler,SG,25,65,2513,421,912,0.462,73,193,0.378,348,719,0.484,386,463,0.834,114,265,379,212,114,36,93,108,1301,8.2,3.0,11.2,2014
Rasual Butler,SF,35,75,1505,218,517,0.422,91,235,0.387,127,282,0.45,53,67,0.791,27,170,197,63,29,22,48,98,580,1.0,1.6,2.6,2014
Dwight Buycks,PG,25,6,123,18,40,0.45,7,11,0.636,11,29,0.379,9,10,0.9,2,10,12,14,3,0,12,3,52,0.1,0.0,0.1,2014
Will Bynum,SG,32,7,67,10,31,0.323,0,9,0.0,10,22,0.455,2,4,0.5,2,4,6,18,1,1,8,9,22,-0.2,0.1,-0.2,2014
Bruno Caboclo,SF,19,8,23,4,12,0.333,2,3,0.667,2,9,0.222,0,0,0.0,1,1,2,0,0,1,4,3,10,-0.1,0.0,-0.1,2014
Nick Calathes,SG,25,58,838,104,247,0.421,11,43,0.256,93,204,0.456,24,45,0.533,19,87,106,146,63,5,61,100,243,-0.4,1.5,1.1,2014
José Calderón,PG,33,42,1270,147,354,0.415,59,142,0.415,88,212,0.415,29,32,0.906,19,105,124,198,31,0,75,76,382,0.8,0.1,0.9,2014
Kentavious Caldwell-Pope,SG,21,82,2587,390,972,0.401,153,444,0.345,237,528,0.449,110,158,0.696,46,209,255,109,93,18,94,161,1043,1.1,1.8,2.8,2014
Isaiah Canaan,PG,23,47,938,146,378,0.386,91,246,0.37,55,132,0.417,49,60,0.817,18,69,87,98,29,3,62,83,432,0.8,0.7,1.4,2014
Clint Capela,C,20,12,90,14,29,0.483,0,0,0.0,14,29,0.483,4,23,0.174,10,26,36,2,1,9,5,14,32,-0.2,0.2,0.0,2014
DeMarre Carroll,SF,28,70,2189,318,653,0.487,120,304,0.395,198,349,0.567,127,181,0.702,99,273,372,118,94,17,75,154,883,4.3,2.8,7.0,2014
Vince Carter*,SG,38,66,1091,135,406,0.333,69,232,0.297,66,174,0.379,45,57,0.789,27,106,133,79,43,14,43,102,384,-0.5,1.4,1.0,2014
Michael Carter-Williams,PG,23,66,2149,364,919,0.396,36,153,0.235,328,766,0.428,202,291,0.694,64,289,353,442,111,30,253,167,966,-2.1,2.9,0.8,2014
Omri Casspi,SF,26,67,1416,209,427,0.489,35,87,0.402,174,340,0.512,140,191,0.733,54,206,260,102,31,9,88,107,593,2.0,0.6,2.7,2014
Mario Chalmers,PG,28,80,2368,267,663,0.403,73,248,0.294,194,415,0.467,206,266,0.774,24,182,206,307,122,10,173,251,813,0.8,2.0,2.8,2014
Tyson Chandler,C,32,75,2286,293,440,0.666,0,0,0.0,293,440,0.666,185,257,0.72,294,570,864,84,42,91,105,169,771,7.2,3.1,10.3,2014
Wilson Chandler,SF,27,78,2471,418,975,0.429,139,406,0.342,279,569,0.49,110,142,0.775,96,379,475,134,58,29,110,231,1085,2.1,1.5,3.6,2014
Will Cherry,PG,23,8,69,5,19,0.263,2,9,0.222,3,10,0.3,3,6,0.5,1,4,5,8,6,1,4,10,15,-0.1,0.1,0.0,2014
Patrick Christopher,SG,26,4,29,3,12,0.25,0,4,0.0,3,8,0.375,0,0,0.0,2,4,6,0,1,0,1,6,6,-0.1,0.0,-0.1,2014
Earl Clark,PF,27,10,93,11,30,0.367,4,14,0.286,7,16,0.438,1,4,0.25,1,22,23,3,3,4,6,12,27,-0.2,0.1,-0.1,2014
Ian Clark,SG,23,30,192,19,55,0.345,10,30,0.333,9,25,0.36,9,9,1.0,4,12,16,12,9,3,9,20,57,0.0,0.2,0.2,2014
Jordan Clarkson,PG,22,59,1476,267,596,0.448,38,121,0.314,229,475,0.482,131,158,0.829,56,135,191,206,51,12,96,109,703,2.0,0.4,2.4,2014
Victor Claver,SF,26,10,76,9,20,0.45,6,11,0.545,3,9,0.333,0,0,0.0,3,17,20,1,1,1,4,12,24,0.0,0.1,0.1,2014
Norris Cole,PG,26,75,1831,230,558,0.412,55,176,0.313,175,382,0.458,58,81,0.716,13,146,159,255,57,15,99,124,573,0.4,1.0,1.4,2014
Darren Collison,PG,27,45,1565,260,550,0.473,60,161,0.373,200,389,0.514,145,184,0.788,19,124,143,252,67,14,112,95,725,3.0,0.8,3.8,2014
Nick Collison,PF,34,66,1101,106,253,0.419,16,60,0.267,90,193,0.466,45,65,0.692,90,160,250,90,35,25,45,156,273,1.0,1.2,2.2,2014
Mike Conley,PG,27,70,2225,393,882,0.446,107,277,0.386,286,605,0.473,214,249,0.859,29,180,209,375,89,14,156,139,1107,4.2,2.7,6.8,2014
Jack Cooley,C,23,16,87,9,22,0.409,0,0,0.0,9,22,0.409,9,21,0.429,10,15,25,1,6,3,3,23,27,0.0,0.2,0.2,2014
Chris Copeland,SF,30,50,828,112,310,0.361,52,167,0.311,60,143,0.42,33,45,0.733,23,88,111,51,11,11,59,78,309,-0.9,0.8,-0.1,2014
Bryce Cotton,PG,22,15,159,29,69,0.42,7,20,0.35,22,49,0.449,15,18,0.833,3,15,18,15,4,0,12,6,80,0.1,0.1,0.2,2014
DeMarcus Cousins,C,24,59,2013,498,1066,0.467,2,8,0.25,496,1058,0.469,423,541,0.782,185,562,747,210,90,103,254,241,1421,2.8,3.2,6.0,2014
Robert Covington,SF,24,70,1956,299,756,0.396,167,446,0.374,132,310,0.426,178,217,0.82,65,251,316,105,97,31,128,189,943,1.6,2.3,4.0,2014
Allen Crabbe,SG,22,51,683,63,153,0.412,30,85,0.353,33,68,0.485,12,16,0.75,7,66,73,39,19,15,15,74,168,0.5,0.8,1.3,2014
Jamal Crawford,SG,34,64,1703,332,839,0.396,119,364,0.327,213,475,0.448,227,252,0.901,18,106,124,158,59,14,92,108,1010,2.5,1.2,3.6,2014
Jae Crowder,SF,24,82,1647,229,545,0.42,61,208,0.293,168,337,0.499,109,141,0.773,72,221,293,94,72,25,49,137,628,1.9,2.0,3.9,2014
Dante Cunningham,PF,27,66,1652,155,339,0.457,1,10,0.1,154,329,0.468,29,47,0.617,70,186,256,50,46,37,35,101,340,0.5,1.2,1.6,2014
Jared Cunningham,SG,23,19,89,12,33,0.364,4,13,0.308,8,20,0.4,7,13,0.538,1,8,9,10,3,0,7,12,35,-0.1,0.1,0.0,2014
Seth Curry,PG,24,2,8,0,3,0.0,0,1,0.0,0,2,0.0,0,0,0.0,0,2,2,1,0,0,0,2,0,-0.1,0.0,0.0,2014
Stephen Curry,PG,26,80,2613,653,1341,0.487,286,646,0.443,367,695,0.528,308,337,0.914,56,285,341,619,163,16,249,158,1900,11.5,4.1,15.7,2014
Samuel Dalembert,C,33,32,544,57,130,0.438,0,0,0.0,57,130,0.438,14,20,0.7,53,115,168,29,14,41,39,70,128,-0.4,0.7,0.3,2014
Troy Daniels,SG,23,47,397,61,165,0.37,43,118,0.364,18,47,0.383,11,13,0.846,8,25,33,22,6,1,20,40,176,0.1,0.1,0.2,2014
Gigi Datome,SF,27,21,209,43,89,0.483,18,40,0.45,25,49,0.51,1,1,1.0,3,26,29,9,2,7,9,15,105,0.2,0.2,0.4,2014
Brandon Davies,PF,23,27,423,55,137,0.401,8,34,0.235,47,103,0.456,24,37,0.649,38,45,83,30,18,7,29,59,142,-0.2,0.4,0.2,2014
Anthony Davis,PF,21,68,2455,642,1199,0.535,1,12,0.083,641,1187,0.54,371,461,0.805,173,523,696,149,100,200,95,141,1656,9.9,4.2,14.0,2014
Ed Davis,PF,25,79,1840,282,469,0.601,0,0,0.0,282,469,0.601,92,189,0.487,230,370,600,94,49,98,58,202,656,4.6,1.6,6.3,2014
Glen Davis,PF,29,74,904,117,255,0.459,0,4,0.0,117,251,0.466,60,95,0.632,43,126,169,39,41,21,39,132,294,0.2,1.1,1.4,2014
Andre Dawkins,SG,23,4,22,1,6,0.167,1,6,0.167,0,0,0.0,0,0,0.0,0,2,2,1,0,0,1,3,3,-0.1,0.0,-0.1,2014
Austin Daye,SF,26,34,344,50,141,0.355,24,71,0.338,26,70,0.371,5,6,0.833,10,65,75,17,12,5,23,39,129,-0.6,0.5,0.0,2014
Dewayne Dedmon,C,25,59,845,91,162,0.562,0,1,0.0,91,161,0.565,34,64,0.531,118,177,295,9,16,50,51,141,216,0.7,1.0,1.7,2014
Matthew Dellavedova,SG,24,67,1380,111,307,0.362,68,167,0.407,43,140,0.307,29,38,0.763,37,89,126,204,24,2,61,152,319,1.4,0.5,1.9,2014
Luol Deng,SF,29,72,2421,369,787,0.469,78,220,0.355,291,567,0.513,191,251,0.761,103,273,376,139,65,22,108,109,1007,3.7,1.6,5.4,2014
DeMar DeRozan,SG,25,60,2100,409,990,0.413,25,88,0.284,384,902,0.426,361,434,0.832,41,236,277,210,73,11,137,122,1204,2.6,1.4,4.0,2014
Boris Diaw,PF,32,81,1984,291,632,0.46,54,169,0.32,237,463,0.512,72,93,0.774,78,270,348,233,36,23,126,148,708,1.3,2.3,3.6,2014
Gorgui Dieng,C,25,73,2193,259,512,0.506,1,6,0.167,258,506,0.51,191,244,0.783,223,386,609,146,71,126,126,188,710,3.4,1.5,4.9,2014
Spencer Dinwiddie,PG,21,34,455,51,169,0.302,12,65,0.185,39,104,0.375,31,34,0.912,4,44,48,104,19,6,33,53,145,-0.3,0.4,0.1,2014
Joey Dorsey,PF,31,69,854,80,145,0.552,0,1,0.0,80,144,0.556,24,83,0.289,103,176,279,25,40,25,41,157,184,0.4,1.5,1.9,2014
Toney Douglas,SG,28,12,177,19,51,0.373,5,18,0.278,14,33,0.424,8,13,0.615,2,20,22,24,11,4,10,20,51,0.0,0.2,0.2,2014
Chris Douglas-Roberts,SG,28,12,103,5,21,0.238,1,7,0.143,4,14,0.286,8,8,1.0,1,11,12,4,1,0,0,14,19,0.0,0.1,0.0,2014
Goran Dragić,SG,28,78,2640,502,1002,0.501,90,259,0.347,412,743,0.555,181,234,0.774,81,193,274,350,78,15,173,195,1275,5.4,1.4,6.8,2014
Zoran Dragić,SG,25,16,75,11,30,0.367,3,14,0.214,8,16,0.5,3,5,0.6,5,3,8,5,2,0,5,6,28,-0.1,0.0,-0.1,2014
Larry Drew II,PG,24,12,219,20,58,0.345,4,26,0.154,16,32,0.5,2,3,0.667,1,14,15,45,6,0,25,13,46,-0.5,0.1,-0.4,2014
Andre Drummond,C,21,82,2502,494,961,0.514,0,2,0.0,494,959,0.515,142,365,0.389,437,667,1104,55,73,153,120,285,1130,3.4,4.3,7.7,2014
Jared Dudley,SG,29,72,1717,198,423,0.468,74,192,0.385,124,231,0.537,48,67,0.716,45,175,220,130,72,11,62,113,518,2.0,2.1,4.1,2014
Tim Duncan*,C,38,77,2227,419,819,0.512,2,7,0.286,417,812,0.514,230,311,0.74,170,534,704,230,63,151,131,165,1070,4.9,4.7,9.6,2014
Mike Dunleavy,SF,34,63,1838,209,481,0.435,107,263,0.407,102,218,0.468,70,87,0.805,28,220,248,114,39,21,60,123,595,2.4,1.7,4.1,2014
Kevin Durant,SF,26,27,913,238,467,0.51,64,159,0.403,174,308,0.565,146,171,0.854,16,162,178,110,24,25,74,40,686,3.8,1.0,4.8,2014
Cleanthony Early,SF,23,39,647,76,214,0.355,22,84,0.262,54,130,0.415,36,48,0.75,22,75,97,36,24,12,40,57,210,-0.8,0.4,-0.4,2014
Wayne Ellington,SG,27,65,1675,254,617,0.412,90,243,0.37,164,374,0.439,52,64,0.813,31,179,210,105,33,2,50,77,650,1.1,0.1,1.2,2014
Monta Ellis,SG,29,80,2699,602,1354,0.445,81,284,0.285,521,1070,0.487,228,303,0.752,34,156,190,329,148,25,198,197,1513,1.4,2.2,3.6,2014
James Ennis III,SF,24,62,1051,101,247,0.409,31,95,0.326,70,152,0.461,79,94,0.84,51,125,176,48,25,17,39,89,312,1.2,0.8,1.9,2014
Tyler Ennis,PG,20,33,411,52,144,0.361,12,43,0.279,40,101,0.396,5,7,0.714,7,28,35,73,18,5,42,36,121,-0.8,0.5,-0.3,2014
Jeremy Evans,SF,27,38,266,32,58,0.552,2,5,0.4,30,53,0.566,24,29,0.828,26,45,71,13,11,12,5,29,90,0.9,0.4,1.3,2014
Reggie Evans,PF,34,47,764,58,137,0.423,0,2,0.0,58,135,0.43,60,97,0.619,97,202,299,32,22,5,45,91,176,0.4,0.8,1.2,2014
Tyreke Evans,SG,25,79,2690,521,1165,0.447,69,227,0.304,452,938,0.482,202,291,0.694,82,334,416,521,100,37,246,198,1313,2.4,2.2,4.6,2014
Dante Exum,PG,19,82,1817,145,416,0.349,83,264,0.314,62,152,0.408,20,32,0.625,27,104,131,198,41,14,118,147,393,-1.1,1.0,-0.1,2014
Festus Ezeli,C,25,46,504,76,139,0.547,0,0,0.0,76,139,0.547,49,78,0.628,60,95,155,9,7,42,32,77,201,0.8,0.9,1.7,2014
Kenneth Faried,PF,25,75,2086,373,736,0.507,1,8,0.125,372,728,0.511,199,288,0.691,242,426,668,89,62,57,118,211,946,3.5,2.1,5.6,2014
Jordan Farmar,PG,28,36,529,61,158,0.386,35,97,0.361,26,61,0.426,10,11,0.909,8,34,42,67,20,5,32,52,167,0.2,0.4,0.6,2014
Derrick Favors,PF,23,74,2280,482,918,0.525,1,6,0.167,481,912,0.527,222,332,0.669,196,411,607,112,60,123,121,210,1187,5.0,3.3,8.3,2014
Raymond Felton,PG,30,29,281,43,106,0.406,10,34,0.294,33,72,0.458,12,15,0.8,2,24,26,41,11,4,18,17,108,0.0,0.2,0.2,2014
Landry Fields,SF,26,26,216,20,41,0.488,1,2,0.5,19,39,0.487,5,6,0.833,10,16,26,15,11,0,8,9,46,0.2,0.1,0.3,2014
Evan Fournier,SG,22,58,1661,253,575,0.44,85,225,0.378,168,350,0.48,107,147,0.728,28,125,153,120,40,2,82,116,698,1.5,0.6,2.1,2014
Randy Foye,SG,31,50,1087,148,402,0.368,94,263,0.357,54,139,0.388,45,55,0.818,9,76,85,119,34,11,60,97,435,0.6,0.4,1.0,2014
Jamaal Franklin,SG,23,3,13,1,2,0.5,1,2,0.5,0,0,0.0,0,0,0.0,1,1,2,3,0,1,3,4,3,0.0,0.0,0.0,2014
Tim Frazier,PG,24,11,239,21,61,0.344,5,17,0.294,16,44,0.364,10,21,0.476,6,22,28,60,8,0,25,26,57,-0.3,0.2,-0.1,2014
Jimmer Fredette,PG,25,50,509,63,166,0.38,9,48,0.188,54,118,0.458,43,45,0.956,8,32,40,58,15,2,33,43,178,0.0,0.2,0.2,2014
Enes Freedom,C,22,75,2135,482,928,0.519,16,45,0.356,466,883,0.528,183,234,0.782,277,394,671,55,36,29,145,189,1163,4.3,2.1,6.4,2014
Joel Freeland,C,27,48,617,74,151,0.49,0,0,0.0,74,151,0.49,21,25,0.84,62,129,191,16,9,23,23,93,169,0.6,0.9,1.6,2014
Channing Frye,PF,31,75,1870,191,487,0.392,136,346,0.393,55,141,0.39,31,35,0.886,27,266,293,94,47,39,78,191,549,0.7,1.4,2.1,2014
Danilo Gallinari,SF,26,59,1426,228,568,0.401,107,301,0.355,121,267,0.453,171,191,0.895,31,187,218,83,47,20,57,94,734,3.0,1.0,3.9,2014
Langston Galloway,PG,23,45,1457,204,511,0.399,62,176,0.352,142,335,0.424,63,78,0.808,37,153,190,150,52,12,61,129,533,0.7,0.6,1.3,2014
Francisco García,SF,33,14,200,17,63,0.27,10,45,0.222,7,18,0.389,1,4,0.25,3,14,17,15,9,5,10,20,45,-0.4,0.2,-0.2,2014
Kevin Garnett*,PF,38,47,952,143,306,0.467,1,7,0.143,142,299,0.475,36,45,0.8,48,263,311,77,46,17,46,109,323,0.4,1.5,1.9,2014
Marc Gasol,C,30,81,2687,530,1072,0.494,3,17,0.176,527,1055,0.5,350,440,0.795,115,515,630,307,70,131,176,208,1413,5.5,4.7,10.2,2014
Pau Gasol*,PF,34,78,2681,570,1153,0.494,12,26,0.462,558,1127,0.495,294,366,0.803,220,699,919,210,25,147,158,147,1446,6.0,4.4,10.4,2014
Rudy Gay,SF,28,68,2408,508,1116,0.455,79,220,0.359,429,896,0.479,337,393,0.858,98,301,399,250,71,41,183,157,1432,4.8,1.3,6.1,2014
Alonzo Gee,SF,27,54,662,87,186,0.468,13,35,0.371,74,151,0.49,54,77,0.701,37,57,94,25,35,7,33,58,241,0.6,0.6,1.2,2014
Paul George,SF,24,6,91,18,49,0.367,9,22,0.409,9,27,0.333,8,11,0.727,4,18,22,6,5,1,12,11,53,-0.2,0.2,0.0,2014
Taj Gibson,PF,29,62,1692,254,506,0.502,0,0,0.0,254,506,0.502,132,184,0.717,162,234,396,71,36,75,77,162,640,2.7,2.1,4.8,2014
Manu Ginóbili*,SG,37,70,1587,251,589,0.426,89,258,0.345,162,331,0.489,147,204,0.721,28,183,211,293,67,20,154,138,738,1.4,2.3,3.7,2014
Rudy Gobert,C,22,82,2158,258,427,0.604,0,2,0.0,258,425,0.607,170,273,0.623,265,510,775,109,64,189,111,175,686,5.0,4.3,9.3,2014
Drew Gooden,PF,33,51,864,110,276,0.399,23,59,0.39,87,217,0.401,34,44,0.773,72,151,223,49,21,9,28,91,277,0.5,1.2,1.7,2014
Archie Goodwin,SG,20,41,535,79,201,0.393,12,41,0.293,67,160,0.419,61,83,0.735,27,47,74,44,18,9,48,55,231,-0.2,0.4,0.2,2014
Aaron Gordon,PF,19,47,797,93,208,0.447,13,48,0.271,80,160,0.5,44,61,0.721,46,123,169,33,21,22,38,83,243,0.3,0.7,1.0,2014
Ben Gordon,SG,31,56,790,129,295,0.437,35,97,0.361,94,198,0.475,56,67,0.836,6,57,63,50,14,1,55,60,349,0.1,0.2,0.3,2014
Drew Gordon,PF,24,9,71,8,19,0.421,0,3,0.0,8,16,0.5,1,2,0.5,7,11,18,2,1,0,8,7,17,-0.2,0.1,-0.1,2014
Eric Gordon,SG,26,61,2018,285,694,0.411,141,315,0.448,144,379,0.38,107,133,0.805,28,131,159,229,50,14,122,145,818,2.2,0.7,2.9,2014
Marcin Gortat,C,30,82,2453,439,775,0.566,0,3,0.0,439,772,0.569,123,175,0.703,180,537,717,97,49,110,100,191,1001,4.4,4.2,8.6,2014
Danny Granger,SF,31,30,613,65,162,0.401,30,84,0.357,35,78,0.449,28,37,0.757,20,60,80,17,13,6,24,67,188,0.2,0.3,0.6,2014
Jerami Grant,SF,20,65,1377,124,352,0.352,49,156,0.314,75,196,0.383,114,193,0.591,49,149,198,79,40,68,85,144,411,-0.9,1.4,0.5,2014
Danny Green,SG,27,81,2312,322,738,0.436,191,457,0.418,131,281,0.466,111,127,0.874,54,289,343,158,101,87,93,163,946,4.0,3.9,7.8,2014
Draymond Green,PF,24,79,2490,339,765,0.443,111,329,0.337,228,436,0.523,132,200,0.66,114,533,647,291,123,99,133,253,921,3.3,5.2,8.5,2014
Erick Green,PG,23,43,410,61,162,0.377,14,47,0.298,47,115,0.409,10,12,0.833,7,24,31,39,12,0,14,26,146,-0.1,0.1,0.0,2014
Gerald Green,SG,29,74,1446,324,778,0.416,137,387,0.354,187,391,0.478,99,120,0.825,33,153,186,91,42,12,104,145,884,1.0,1.0,1.9,2014
JaMychal Green,PF,24,24,164,27,47,0.574,0,6,0.0,27,41,0.659,8,10,0.8,19,26,45,4,5,5,14,25,62,0.1,0.3,0.4,2014
Jeff Green,SF,28,78,2454,416,967,0.43,97,292,0.332,319,675,0.473,239,287,0.833,64,264,328,134,53,34,108,147,1168,2.7,2.4,5.2,2014
Willie Green,SG,33,52,951,118,306,0.386,42,121,0.347,76,185,0.411,28,34,0.824,14,65,79,68,26,5,48,81,306,-0.4,0.4,-0.1,2014
Blake Griffin,PF,25,67,2356,574,1144,0.502,10,25,0.4,564,1119,0.504,311,427,0.728,126,382,508,354,63,35,152,196,1469,6.6,2.4,9.0,2014
Jorge Gutiérrez,PG,26,20,175,22,41,0.537,0,3,0.0,22,38,0.579,9,13,0.692,5,20,25,22,6,0,12,25,53,0.1,0.2,0.3,2014
P.J. Hairston,SG,22,45,687,87,269,0.323,49,163,0.301,38,106,0.358,31,36,0.861,22,70,92,21,21,13,22,61,254,-0.5,0.8,0.3,2014
Jordan Hamilton,SF,24,14,122,14,35,0.4,10,21,0.476,4,14,0.286,0,0,0.0,2,14,16,7,2,0,4,14,38,0.1,0.1,0.1,2014
Justin Hamilton,C,24,41,712,85,178,0.478,10,31,0.323,75,147,0.51,39,47,0.83,57,77,134,36,27,30,26,70,219,1.0,0.5,1.5,2014
Tyler Hansbrough,PF,29,74,1058,86,165,0.521,1,7,0.143,85,158,0.538,97,139,0.698,106,159,265,21,30,15,20,141,270,2.6,0.9,3.4,2014
Tim Hardaway Jr.,SG,22,70,1681,279,717,0.389,121,354,0.342,158,363,0.435,125,156,0.801,12,144,156,127,20,14,82,119,804,0.8,0.0,0.8,2014
James Harden,SG,25,81,2981,647,1470,0.44,208,555,0.375,439,915,0.48,715,824,0.868,75,384,459,565,154,60,321,208,2217,12.2,4.2,16.4,2014
Maurice Harkless,SF,21,45,674,63,158,0.399,10,56,0.179,53,102,0.52,22,41,0.537,38,68,106,25,32,9,27,66,158,-0.3,0.6,0.3,2014
Devin Harris,PG,31,76,1685,219,524,0.418,95,266,0.357,124,258,0.481,132,162,0.815,13,122,135,237,78,14,85,147,665,2.9,1.3,4.2,2014
Gary Harris,SG,20,55,719,66,217,0.304,21,103,0.204,45,114,0.395,35,47,0.745,21,43,64,29,39,7,38,71,188,-1.2,0.5,-0.7,2014
Joe Harris,SG,23,51,493,48,120,0.4,31,84,0.369,17,36,0.472,9,15,0.6,7,34,41,26,7,2,27,62,136,0.0,0.2,0.2,2014
Tobias Harris,SF,22,68,2369,442,949,0.466,87,239,0.364,355,710,0.5,193,245,0.788,73,357,430,124,69,36,115,134,1164,3.0,1.8,4.8,2014
Udonis Haslem,PF,34,62,995,107,239,0.448,2,10,0.2,105,229,0.459,45,64,0.703,71,187,258,46,21,13,41,113,261,0.4,1.0,1.4,2014
Spencer Hawes,PF,26,73,1274,163,415,0.393,55,176,0.313,108,239,0.452,44,68,0.647,30,228,258,88,24,53,61,173,425,-0.3,1.5,1.2,2014
Chuck Hayes,C,31,29,255,22,46,0.478,0,0,0.0,22,46,0.478,6,11,0.545,18,33,51,20,10,4,8,37,50,0.3,0.2,0.5,2014
Gordon Hayward,SF,24,76,2618,484,1087,0.445,120,330,0.364,364,757,0.481,375,462,0.812,54,319,373,313,108,30,206,131,1463,5.8,2.9,8.7,2014
Brendan Haywood,C,35,22,119,14,30,0.467,0,0,0.0,14,30,0.467,7,13,0.538,6,23,29,2,2,10,10,17,35,-0.2,0.2,0.0,2014
Gerald Henderson,SG,27,80,2315,370,847,0.437,45,136,0.331,325,711,0.457,184,217,0.848,36,237,273,206,51,22,110,135,969,1.3,2.3,3.6,2014
Xavier Henry,SF,23,9,86,3,13,0.231,0,0,0.0,3,13,0.231,14,24,0.583,2,2,4,3,3,0,3,6,20,-0.1,0.0,-0.1,2014
John Henson,C,24,67,1228,196,346,0.566,0,0,0.0,196,346,0.566,78,137,0.569,124,188,312,59,28,135,87,152,470,1.3,2.4,3.6,2014
Roy Hibbert,C,28,76,1926,317,710,0.446,0,2,0.0,317,708,0.448,168,204,0.824,156,384,540,84,18,125,107,216,802,1.0,3.2,4.2,2014
J.J. Hickson,C,26,73,1411,218,459,0.475,0,2,0.0,218,457,0.477,116,201,0.577,150,302,452,57,36,35,96,136,552,0.5,1.4,1.8,2014
Nenê,PF,32,67,1693,307,601,0.511,1,5,0.2,306,596,0.513,122,202,0.604,84,261,345,123,66,22,124,180,737,0.5,2.5,3.0,2014
George Hill,PG,28,43,1267,255,535,0.477,69,193,0.358,186,342,0.544,113,143,0.79,25,154,179,220,44,14,69,111,692,3.7,1.6,5.4,2014
Jordan Hill,C,27,70,1874,357,777,0.459,3,11,0.273,354,766,0.462,124,168,0.738,174,382,556,103,34,52,106,164,841,1.1,1.1,2.2,2014
Solomon Hill,SF,23,82,2381,251,634,0.396,68,208,0.327,183,426,0.43,159,193,0.824,70,244,314,184,66,18,115,177,729,0.9,2.6,3.5,2014
Kirk Hinrich,SG,34,66,1610,142,381,0.373,58,168,0.345,84,213,0.394,35,50,0.7,20,101,121,148,46,14,73,144,377,-0.3,1.3,1.0,2014
Jrue Holiday,PG,24,40,1303,238,534,0.446,51,135,0.378,187,399,0.469,65,76,0.855,32,103,135,274,63,23,91,110,592,2.3,1.1,3.4,2014
Justin Holiday,SG,25,59,657,91,235,0.387,35,109,0.321,56,126,0.444,37,45,0.822,12,61,73,48,40,12,29,54,254,0.2,1.0,1.3,2014
Ryan Hollins,C,30,46,441,53,82,0.646,0,0,0.0,53,82,0.646,31,54,0.574,36,67,103,14,6,19,25,65,137,0.7,0.3,1.0,2014
Rodney Hood,SG,22,50,1064,155,374,0.414,62,170,0.365,93,204,0.456,61,80,0.763,9,108,117,83,30,12,45,119,433,1.3,0.9,2.2,2014
Al Horford,C,28,76,2318,519,965,0.538,11,36,0.306,508,929,0.547,107,141,0.759,131,413,544,244,68,98,100,121,1156,5.1,3.6,8.7,2014
Dwight Howard,C,29,41,1223,251,423,0.593,1,2,0.5,250,421,0.594,143,271,0.528,110,321,431,50,28,53,115,137,646,1.4,2.2,3.6,2014
Lester Hudson,SG,30,5,56,6,14,0.429,3,6,0.5,3,8,0.375,3,4,0.75,1,7,8,5,6,1,3,4,18,0.1,0.1,0.2,2014
Robbie Hummel,SF,25,45,742,79,172,0.459,16,51,0.314,63,121,0.521,24,29,0.828,31,103,134,27,16,9,18,86,198,0.7,0.1,0.8,2014
Kris Humphries,PF,29,64,1345,211,446,0.473,0,7,0.0,211,439,0.481,87,117,0.744,118,298,416,57,34,25,46,130,509,1.6,2.1,3.8,2014
Serge Ibaka,PF,25,64,2116,374,786,0.476,77,205,0.376,297,581,0.511,92,110,0.836,135,364,499,55,30,155,97,194,917,2.9,2.7,5.6,2014
Andre Iguodala,SF,31,77,2069,231,496,0.466,74,212,0.349,157,284,0.553,68,114,0.596,44,213,257,228,89,25,88,100,604,2.3,2.8,5.1,2014
Ersan İlyasova,PF,27,58,1319,263,557,0.472,74,190,0.389,189,367,0.515,69,107,0.645,80,197,277,56,36,19,45,149,669,2.3,1.7,4.0,2014
Joe Ingles,SF,27,79,1673,147,354,0.415,72,202,0.356,75,152,0.493,30,40,0.75,22,153,175,182,72,10,98,124,396,0.5,1.6,2.2,2014
Kyrie Irving,PG,22,75,2730,578,1235,0.468,157,378,0.415,421,857,0.491,315,365,0.863,55,182,237,389,114,20,186,146,1628,8.4,2.0,10.4,2014
Jarrett Jack,PG,31,80,2241,359,817,0.439,39,146,0.267,320,671,0.477,200,227,0.881,19,226,245,373,75,13,191,143,957,1.1,1.4,2.6,2014
Reggie Jackson,PG,24,77,2268,432,996,0.434,72,241,0.299,360,755,0.477,181,218,0.83,56,271,327,462,62,9,186,167,1117,3.3,1.7,4.9,2014
Bernard James,C,29,16,158,12,27,0.444,0,0,0.0,12,27,0.444,20,23,0.87,18,21,39,4,2,15,6,17,44,0.4,0.2,0.5,2014
LeBron James,SF,30,69,2493,624,1279,0.488,120,339,0.354,504,940,0.536,375,528,0.71,51,365,416,511,109,49,272,135,1743,7.4,2.9,10.4,2014
Al Jefferson,C,30,65,1992,486,1010,0.481,2,5,0.4,484,1005,0.482,108,165,0.655,99,449,548,113,47,84,68,139,1082,1.3,3.4,4.7,2014
Cory Jefferson,PF,24,50,531,75,167,0.449,2,15,0.133,73,152,0.48,31,54,0.574,47,98,145,16,10,21,20,61,183,0.2,0.6,0.8,2014
Richard Jefferson,SF,34,74,1244,144,324,0.444,66,155,0.426,78,169,0.462,78,114,0.684,25,158,183,61,32,11,52,115,432,1.4,0.9,2.3,2014
John Jenkins,SG,23,24,297,49,99,0.495,21,52,0.404,28,47,0.596,16,19,0.842,2,37,39,13,10,0,8,15,135,0.6,0.3,0.9,2014
Brandon Jennings,PG,25,41,1173,218,543,0.401,76,211,0.36,142,332,0.428,120,143,0.839,21,83,104,272,44,4,90,64,632,2.6,0.7,3.3,2014
Jonas Jerebko,PF,27,75,1230,169,379,0.446,54,140,0.386,115,239,0.481,56,66,0.848,93,189,282,71,46,18,44,135,448,2.0,1.4,3.5,2014
Grant Jerrett,PF,21,8,51,7,26,0.269,1,15,0.067,6,11,0.545,1,1,1.0,2,7,9,3,2,2,3,11,16,-0.2,0.1,-0.1,2014
Amir Johnson,PF,27,75,1979,298,519,0.574,19,46,0.413,279,473,0.59,79,129,0.612,159,297,456,117,44,59,110,225,694,3.5,1.6,5.1,2014
Chris Johnson,SF,24,29,526,62,154,0.403,28,95,0.295,34,59,0.576,14,16,0.875,8,47,55,15,26,7,15,44,166,0.2,0.6,0.8,2014
James Johnson,PF,27,70,1370,238,404,0.589,11,51,0.216,227,353,0.643,67,102,0.657,61,196,257,95,54,70,79,155,554,2.5,1.6,4.1,2014
Joe Johnson,SG,33,80,2791,446,1025,0.435,121,337,0.359,325,688,0.472,141,176,0.801,53,331,384,292,59,14,137,120,1154,2.6,1.5,4.1,2014
Nick Johnson,SG,22,28,262,26,75,0.347,5,21,0.238,21,54,0.389,17,25,0.68,13,26,39,11,7,3,19,34,74,-0.4,0.2,-0.1,2014
Tyler Johnson,SG,22,32,603,70,167,0.419,18,48,0.375,52,119,0.437,32,47,0.681,14,67,81,42,33,9,30,42,190,0.1,0.7,0.8,2014
Wesley Johnson,SF,27,76,2245,286,691,0.414,91,259,0.351,195,432,0.451,90,112,0.804,67,252,319,124,59,45,87,162,753,1.0,0.7,1.7,2014
Dahntay Jones,SF,34,33,123,6,21,0.286,0,4,0.0,6,17,0.353,9,11,0.818,1,10,11,2,3,0,1,23,21,0.0,0.1,0.0,2014
James Jones,SF,34,57,669,74,201,0.368,63,175,0.36,11,26,0.423,39,46,0.848,9,53,62,24,13,8,13,67,250,1.2,0.4,1.5,2014
Perry Jones,SF,23,43,631,73,184,0.397,14,60,0.233,59,124,0.476,24,37,0.649,6,70,76,18,17,8,24,50,184,-0.3,0.5,0.2,2014
Terrence Jones,PF,23,33,889,158,299,0.528,13,37,0.351,145,262,0.553,57,94,0.606,78,142,220,36,18,59,37,78,386,1.7,1.3,3.0,2014
DeAndre Jordan,C,26,82,2820,379,534,0.71,1,4,0.25,378,530,0.713,187,471,0.397,397,829,1226,61,81,183,109,245,946,7.4,5.4,12.8,2014
Jerome Jordan,C,28,44,383,50,94,0.532,0,0,0.0,50,94,0.532,38,44,0.864,52,53,105,13,8,15,22,58,138,0.9,0.3,1.2,2014
Cory Joseph,PG,23,79,1444,207,411,0.504,16,44,0.364,191,367,0.52,105,143,0.734,44,148,192,188,46,17,67,105,535,2.7,1.8,4.5,2014
Chris Kaman,C,32,74,1398,283,549,0.515,0,0,0.0,283,549,0.515,72,102,0.706,149,335,484,65,18,54,108,140,638,1.1,2.2,3.3,2014
Sergey Karasev,SG,21,33,555,54,134,0.403,16,54,0.296,38,80,0.475,29,38,0.763,22,44,66,46,23,1,24,45,153,0.3,0.4,0.7,2014
Ryan Kelly,PF,23,52,1233,104,309,0.337,45,134,0.336,59,175,0.337,79,95,0.832,13,133,146,92,30,24,37,118,332,0.4,0.3,0.7,2014
Michael Kidd-Gilchrist,SF,21,55,1587,224,482,0.465,0,0,0.0,224,482,0.465,150,214,0.701,109,307,416,77,30,38,63,115,598,1.6,2.2,3.8,2014
Sean Kilpatrick,SG,25,4,72,7,20,0.35,4,13,0.308,3,7,0.429,4,4,1.0,1,5,6,4,3,0,2,3,22,0.1,0.0,0.1,2014
Andrei Kirilenko,SF,33,7,36,0,5,0.0,0,0,0.0,0,5,0.0,3,4,0.75,2,6,8,1,1,0,1,1,3,-0.1,0.0,0.0,2014
Alex Kirk,C,23,5,14,1,4,0.25,0,0,0.0,1,4,0.25,2,2,1.0,1,0,1,1,0,0,0,1,4,0.0,0.0,0.0,2014
Brandon Knight,PG,23,63,2035,375,888,0.422,125,321,0.389,250,567,0.441,195,223,0.874,28,216,244,330,90,10,189,114,1070,2.0,2.5,4.5,2014
Kyle Korver,SG,33,75,2418,292,600,0.487,221,449,0.492,71,151,0.47,106,118,0.898,15,289,304,196,52,42,107,140,911,5.0,2.4,7.5,2014
Kosta Koufos,C,25,81,1348,182,358,0.508,0,0,0.0,182,358,0.508,55,85,0.647,121,305,426,37,29,63,69,148,419,0.8,2.5,3.3,2014
Ognjen Kuzmić,C,24,16,72,8,12,0.667,0,0,0.0,8,12,0.667,4,4,1.0,7,10,17,6,2,1,5,13,20,0.2,0.1,0.3,2014
Jeremy Lamb,SG,22,47,633,104,250,0.416,38,111,0.342,66,139,0.475,49,55,0.891,8,99,107,44,21,6,27,52,295,1.0,0.7,1.6,2014
Carl Landry,PF,31,70,1192,190,369,0.515,0,0,0.0,190,369,0.515,123,150,0.82,99,169,268,26,15,17,54,132,503,2.3,0.5,2.8,2014
Shane Larkin,PG,22,76,1865,187,432,0.433,35,116,0.302,152,316,0.481,61,78,0.782,29,147,176,226,93,9,83,150,470,0.8,0.9,1.7,2014
Joffrey Lauvergne,C,23,24,268,36,89,0.404,3,16,0.188,33,73,0.452,18,28,0.643,27,50,77,13,8,10,22,43,93,-0.2,0.3,0.1,2014
Zach LaVine,PG,19,77,1902,286,677,0.422,57,167,0.341,229,510,0.449,149,177,0.842,27,187,214,276,54,10,193,158,778,-0.7,0.0,-0.7,2014
Ty Lawson,PG,27,75,2665,404,926,0.436,70,205,0.341,334,721,0.463,265,363,0.73,42,192,234,720,92,9,185,128,1143,6.0,1.0,7.0,2014
Ricky Ledo,SG,22,17,244,32,96,0.333,10,27,0.37,22,69,0.319,16,22,0.727,16,20,36,19,6,1,26,21,90,-0.6,0.0,-0.6,2014
Courtney Lee,SG,29,77,2354,288,643,0.448,90,224,0.402,198,419,0.473,111,129,0.86,21,157,178,151,75,12,78,129,777,2.5,2.4,4.8,2014
David Lee,PF,31,49,904,160,313,0.511,0,2,0.0,160,311,0.514,68,104,0.654,81,176,257,85,31,26,49,83,388,1.6,1.6,3.2,2014
Malcolm Lee,SG,24,1,2,0,1,0.0,0,0,0.0,0,1,0.0,0,0,0.0,0,0,0,0,0,0,0,0,0,0.0,0.0,0.0,2014
Alex Len,C,21,69,1518,179,353,0.507,1,3,0.333,178,350,0.509,73,104,0.702,142,312,454,32,34,105,74,213,432,1.2,2.1,3.4,2014
Kawhi Leonard,SF,23,64,2033,394,822,0.479,67,192,0.349,327,630,0.519,202,252,0.802,85,376,461,161,148,48,97,128,1057,4.2,4.4,8.6,2014
Meyers Leonard,C,22,55,847,125,245,0.51,47,112,0.42,78,133,0.586,30,32,0.938,46,204,250,32,10,14,39,113,327,1.6,1.2,2.8,2014
Jon Leuer,PF,25,63,824,121,273,0.443,7,29,0.241,114,244,0.467,37,59,0.627,50,157,207,46,17,9,35,86,286,0.2,1.2,1.3,2014
Damian Lillard,PG,24,82,2925,590,1360,0.434,196,572,0.343,394,788,0.5,344,398,0.864,49,329,378,507,97,21,222,164,1720,7.3,3.3,10.6,2014
Jeremy Lin,PG,26,74,1907,277,654,0.424,65,176,0.369,212,478,0.444,213,268,0.795,26,170,196,339,82,32,166,189,832,1.8,0.8,2.7,2014
Shaun Livingston,PG,29,78,1468,198,396,0.5,0,2,0.0,198,394,0.503,65,91,0.714,43,140,183,259,49,20,102,110,461,1.5,1.8,3.3,2014
Brook Lopez,C,26,72,2100,506,987,0.513,1,10,0.1,505,977,0.517,223,274,0.814,214,321,535,50,43,126,104,206,1236,4.7,2.2,7.0,2014
Robin Lopez,C,26,59,1638,234,437,0.535,0,1,0.0,234,436,0.537,98,127,0.772,190,204,394,55,16,84,73,122,566,3.2,1.9,5.1,2014
Kevin Love,PF,26,75,2532,413,952,0.434,144,392,0.367,269,560,0.48,258,321,0.804,142,589,731,168,51,39,122,140,1228,5.8,2.9,8.7,2014
Kyle Lowry,PG,28,70,2414,430,1043,0.412,132,391,0.338,298,652,0.457,252,312,0.808,54,274,328,473,109,13,173,212,1244,5.1,2.0,7.1,2014
Kalin Lucas,PG,25,1,6,0,1,0.0,0,0,0.0,0,1,0.0,0,0,0.0,0,0,0,0,1,0,0,1,0,0.0,0.0,0.0,2014
John Lucas III,PG,32,21,272,42,104,0.404,9,29,0.31,33,75,0.44,5,5,1.0,4,12,16,60,8,0,16,18,98,0.2,0.1,0.3,2014
Shelvin Mack,PG,24,55,833,117,292,0.401,40,127,0.315,77,165,0.467,25,31,0.806,8,71,79,155,30,2,49,32,299,0.5,0.8,1.3,2014
Ian Mahinmi,C,28,61,1146,117,212,0.552,0,0,0.0,117,212,0.552,31,102,0.304,105,251,356,33,30,46,59,172,265,0.1,2.0,2.1,2014
Devyn Marble,SG,22,16,208,14,44,0.318,4,22,0.182,10,22,0.455,5,16,0.313,5,26,31,17,9,2,9,14,37,-0.3,0.2,-0.1,2014
Shawn Marion,SF,36,57,1101,119,267,0.446,12,46,0.261,107,221,0.484,26,34,0.765,64,138,202,51,27,27,33,58,276,0.8,0.9,1.7,2014
Kendall Marshall,PG,23,28,417,46,101,0.455,18,46,0.391,28,55,0.509,8,9,0.889,2,26,28,86,21,0,35,26,118,0.3,0.5,0.8,2014
Cartier Martin,SF,30,23,198,15,53,0.283,6,33,0.182,9,20,0.45,0,0,0.0,0,20,20,11,3,1,5,20,36,-0.3,0.1,-0.2,2014
Kenyon Martin,PF,37,11,104,9,22,0.409,0,0,0.0,9,22,0.409,2,2,1.0,6,13,19,5,5,6,3,13,20,0.0,0.2,0.2,2014
Kevin Martin,SG,31,39,1302,267,625,0.427,75,191,0.393,192,434,0.442,170,193,0.881,19,123,142,89,33,1,76,76,779,2.0,-0.1,1.9,2014
Wesley Matthews,SG,28,60,2024,337,752,0.448,173,445,0.389,164,307,0.534,109,145,0.752,38,184,222,139,77,10,81,132,956,4.0,2.2,6.2,2014
Jason Maxiell,PF,31,61,878,81,192,0.422,0,0,0.0,81,192,0.422,41,71,0.577,86,117,203,19,18,44,29,96,203,0.1,1.2,1.4,2014
O.J. Mayo,SG,27,71,1697,296,701,0.422,99,277,0.357,197,424,0.465,115,139,0.827,30,157,187,197,57,18,128,165,806,0.9,1.9,2.8,2014
Luc Mbah a Moute,PF,28,67,1916,251,636,0.395,62,202,0.307,189,434,0.435,96,163,0.589,82,246,328,106,81,21,99,104,660,-0.9,2.0,1.1,2014
James Michael McAdoo,PF,22,15,137,24,44,0.545,0,0,0.0,24,44,0.545,14,25,0.56,15,22,37,2,5,9,6,21,62,0.2,0.3,0.5,2014
Ray McCallum,PG,23,68,1436,206,470,0.438,34,111,0.306,172,359,0.479,57,84,0.679,52,128,180,188,45,11,85,92,503,0.8,0.5,1.4,2014
CJ McCollum,SG,23,62,973,159,365,0.436,55,139,0.396,104,226,0.46,51,73,0.699,14,77,91,64,43,8,48,81,424,0.7,1.1,1.8,2014
K.J. McDaniels,SG,21,62,1352,172,434,0.396,43,150,0.287,129,284,0.454,100,133,0.752,65,135,200,72,44,70,105,126,487,-0.9,1.5,0.6,2014
Doug McDermott,SF,23,36,321,43,107,0.402,13,41,0.317,30,66,0.455,10,15,0.667,6,37,43,6,4,1,17,29,109,-0.3,0.2,0.0,2014
Mitch McGary,PF,22,32,485,88,165,0.533,0,2,0.0,88,163,0.54,25,40,0.625,53,112,165,14,16,16,31,72,201,0.6,0.7,1.3,2014
JaVale McGee,C,27,23,256,42,79,0.532,0,0,0.0,42,79,0.532,22,33,0.667,18,43,61,3,2,20,18,30,106,0.1,0.3,0.4,2014
Ben McLemore,SG,21,82,2670,363,831,0.437,140,391,0.358,223,440,0.507,130,160,0.813,31,210,241,140,77,19,138,219,996,1.7,0.8,2.5,2014
Jerel McNeal,PG,27,6,36,3,11,0.273,1,2,0.5,2,9,0.222,2,2,1.0,0,3,3,2,3,1,5,5,9,-0.2,0.1,-0.1,2014
Josh McRoberts,PF,27,17,296,28,53,0.528,8,19,0.421,20,34,0.588,8,13,0.615,7,38,45,33,12,3,22,41,72,0.1,0.3,0.4,2014
Jodie Meeks,SG,27,60,1462,222,534,0.416,74,212,0.349,148,322,0.46,145,160,0.906,12,92,104,79,59,6,57,76,663,2.2,0.9,3.1,2014
Gal Mekel,PG,26,4,43,3,20,0.15,0,3,0.0,3,17,0.176,0,0,0.0,0,1,1,13,2,0,2,1,6,-0.2,0.0,-0.2,2014
Khris Middleton,SF,23,79,2378,406,869,0.467,109,268,0.407,297,601,0.494,134,156,0.859,48,299,347,182,122,11,113,183,1055,3.2,3.5,6.7,2014
C.J. Miles,SG,27,70,1841,329,827,0.398,154,446,0.345,175,381,0.459,130,161,0.807,18,196,214,75,60,26,73,132,942,1.3,2.3,3.6,2014
Andre Miller,PG,38,81,1253,145,290,0.5,7,34,0.206,138,256,0.539,58,77,0.753,37,116,153,284,32,6,104,103,355,1.4,0.8,2.2,2014
Darius Miller,SF,24,5,43,1,7,0.143,0,1,0.0,1,6,0.167,0,0,0.0,0,1,1,2,1,0,1,8,2,-0.1,0.0,-0.1,2014
Mike Miller,SF,34,52,701,37,114,0.325,32,98,0.327,5,16,0.313,3,4,0.75,4,87,91,46,14,4,23,74,109,-0.1,0.5,0.4,2014
Quincy Miller,PF,22,10,119,9,38,0.237,3,18,0.167,6,20,0.3,8,11,0.727,4,16,20,8,7,5,5,9,29,-0.2,0.2,-0.1,2014
Patty Mills,PG,26,51,801,128,336,0.381,62,182,0.341,66,154,0.429,33,40,0.825,21,54,75,87,28,2,35,58,351,0.6,0.9,1.4,2014
Elijah Millsap,SG,27,47,924,81,238,0.34,28,90,0.311,53,148,0.358,58,86,0.674,28,122,150,58,56,16,67,124,248,-1.0,1.4,0.4,2014
Paul Millsap,PF,29,73,2390,443,930,0.476,77,216,0.356,366,714,0.513,255,337,0.757,139,431,570,223,130,69,166,201,1218,4.0,4.3,8.3,2014
Nikola Mirotić,PF,23,82,1654,253,624,0.405,99,313,0.316,154,311,0.495,228,284,0.803,63,341,404,97,54,54,89,172,833,3.0,2.7,5.7,2014
Nazr Mohammed,C,37,23,128,13,30,0.433,0,0,0.0,13,30,0.433,1,3,0.333,11,27,38,3,4,5,7,16,27,-0.1,0.2,0.1,2014
Greg Monroe,PF,24,69,2137,423,853,0.496,0,0,0.0,423,853,0.496,252,336,0.75,229,475,704,142,78,34,149,148,1098,4.0,2.8,6.8,2014
E'Twaun Moore,SG,25,56,504,62,139,0.446,13,38,0.342,49,101,0.485,12,20,0.6,12,34,46,33,20,6,14,45,149,0.3,0.5,0.8,2014
Eric Moreland,PF,23,3,2,1,1,1.0,0,0,0.0,1,1,1.0,0,0,0.0,0,1,1,0,0,0,0,1,2,0.0,0.0,0.0,2014
Darius Morris,PG,24,38,299,36,106,0.34,7,33,0.212,29,73,0.397,4,9,0.444,7,20,27,48,9,0,21,20,83,-0.5,0.1,-0.4,2014
Marcus Morris,PF,25,81,2045,331,763,0.434,112,313,0.358,219,450,0.487,71,113,0.628,73,312,385,133,63,16,73,188,845,2.2,1.8,4.0,2014
Markieff Morris,PF,25,82,2581,512,1100,0.465,57,179,0.318,455,921,0.494,177,232,0.763,110,396,506,192,101,39,170,245,1258,1.8,2.7,4.6,2014
Anthony Morrow,SG,29,74,1806,285,615,0.463,141,325,0.434,144,290,0.497,79,89,0.888,40,155,195,60,54,11,38,135,790,4.4,1.2,5.7,2014
Donatas Motiejūnas,PF,24,71,2037,353,700,0.504,49,133,0.368,304,567,0.536,100,166,0.602,137,284,421,130,56,34,123,203,855,2.4,2.3,4.7,2014
Timofey Mozgov,C,28,81,2045,314,566,0.555,2,6,0.333,312,560,0.557,155,216,0.718,203,388,591,55,33,97,116,227,785,3.5,2.2,5.7,2014
Shabazz Muhammad,SG,22,38,866,194,397,0.489,20,51,0.392,174,346,0.503,104,145,0.717,63,91,154,44,18,7,35,49,512,2.1,-0.1,2.0,2014
Toure' Murry,SG,25,5,18,2,5,0.4,0,0,0.0,2,5,0.4,2,2,1.0,1,0,1,1,1,0,4,2,6,-0.1,0.0,-0.1,2014
Mike Muscala,PF,23,40,502,83,151,0.55,9,22,0.409,74,129,0.574,22,25,0.88,52,67,119,25,16,19,21,52,197,1.2,0.7,1.9,2014
Shabazz Napier,PG,23,51,1012,87,228,0.382,43,118,0.364,44,110,0.4,44,56,0.786,17,96,113,130,40,4,81,76,261,-0.3,0.8,0.5,2014
Gary Neal,SG,30,54,1193,188,503,0.374,50,164,0.305,138,339,0.407,117,135,0.867,14,115,129,100,23,1,65,88,543,-0.2,0.8,0.6,2014
Jameer Nelson,PG,32,63,1407,205,504,0.407,89,258,0.345,116,246,0.472,24,36,0.667,33,113,146,253,47,6,109,136,523,0.6,0.8,1.4,2014
Andrew Nicholson,PF,25,40,492,83,190,0.437,13,41,0.317,70,149,0.47,15,25,0.6,17,65,82,22,6,12,24,51,194,-0.2,0.3,0.1,2014
Joakim Noah,C,29,67,2049,190,427,0.445,0,2,0.0,190,425,0.447,105,174,0.603,219,427,646,312,48,74,123,203,485,2.4,3.1,5.6,2014
Nerlens Noel,C,20,75,2311,302,653,0.462,0,0,0.0,302,653,0.462,140,230,0.609,185,426,611,128,133,142,146,208,744,-0.2,4.2,4.0,2014
Lucas Nogueira,C,22,6,23,2,8,0.25,0,0,0.0,2,8,0.25,2,4,0.5,2,9,11,1,2,0,2,6,6,-0.1,0.1,0.0,2014
Steve Novak,SF,31,35,197,22,56,0.393,19,48,0.396,3,8,0.375,0,2,0.0,2,20,22,11,0,2,5,23,63,0.2,0.1,0.3,2014
Dirk Nowitzki*,PF,36,77,2282,487,1062,0.459,104,274,0.38,383,788,0.486,255,289,0.882,44,413,457,143,39,33,82,160,1333,5.2,2.0,7.2,2014
Jusuf Nurkić,C,20,62,1103,171,383,0.446,0,2,0.0,171,381,0.449,84,132,0.636,125,257,382,50,52,68,86,207,426,-0.2,1.8,1.6,2014
Johnny O'Bryant,PF,21,34,368,44,120,0.367,0,0,0.0,44,120,0.367,12,27,0.444,26,38,64,17,5,4,25,44,100,-0.8,0.3,-0.5,2014
Kyle O'Quinn,PF,24,51,824,119,242,0.492,12,43,0.279,107,199,0.538,44,57,0.772,46,153,199,59,31,39,55,110,294,0.5,1.1,1.6,2014
Victor Oladipo,SG,22,72,2573,473,1086,0.436,84,248,0.339,389,838,0.464,262,320,0.819,51,251,302,295,120,19,204,187,1292,1.5,2.0,3.5,2014
Kelly Olynyk,C,23,64,1423,251,528,0.475,61,175,0.349,190,353,0.538,93,136,0.684,92,211,303,109,64,39,98,213,656,1.5,2.1,3.6,2014
Arinze Onuaku,C,27,6,68,12,14,0.857,0,0,0.0,12,14,0.857,3,8,0.375,7,14,21,4,1,3,2,6,27,0.2,0.0,0.3,2014
Zaza Pachulia,C,30,73,1730,240,529,0.454,0,3,0.0,240,526,0.456,126,160,0.788,197,303,500,178,80,21,133,170,606,1.3,2.9,4.2,2014
Kostas Papanikolaou,SF,24,43,795,69,197,0.35,31,106,0.292,38,91,0.418,13,18,0.722,39,79,118,85,29,13,55,71,182,-0.4,0.9,0.5,2014
Jannero Pargo,PG,35,9,73,15,35,0.429,9,22,0.409,6,13,0.462,2,2,1.0,0,3,3,8,0,0,3,8,41,0.1,0.0,0.2,2014
Jabari Parker,PF,19,25,738,129,263,0.49,4,16,0.25,125,247,0.506,46,66,0.697,50,88,138,42,31,5,47,42,308,0.4,1.0,1.3,2014
Tony Parker*,PG,32,68,1953,404,832,0.486,38,89,0.427,366,743,0.493,130,166,0.783,15,114,129,335,44,2,146,108,976,2.4,1.7,4.1,2014
Chandler Parsons,SF,26,66,2186,383,829,0.462,132,347,0.38,251,482,0.521,139,193,0.72,64,259,323,161,69,19,96,140,1037,3.8,1.7,5.5,2014
Patrick Patterson,PF,25,81,2156,240,535,0.449,105,283,0.371,135,252,0.536,63,80,0.788,127,306,433,155,60,44,54,149,648,4.4,1.7,6.1,2014
Chris Paul,PG,29,82,2857,568,1170,0.485,139,349,0.398,429,821,0.523,289,321,0.9,52,324,376,838,156,15,190,203,1564,12.9,3.2,16.1,2014
Adreian Payne,PF,23,32,739,91,220,0.414,1,9,0.111,90,211,0.427,30,46,0.652,48,114,162,30,19,9,44,88,213,-0.7,0.2,-0.5,2014
Elfrid Payton,PG,20,82,2489,301,708,0.425,11,42,0.262,290,666,0.435,118,214,0.551,107,242,349,533,142,20,203,193,731,0.0,2.3,2.3,2014
Nikola Peković,C,29,31,815,139,328,0.424,0,0,0.0,139,328,0.424,108,129,0.837,89,145,234,27,19,12,42,59,386,0.9,0.2,1.2,2014
Kendrick Perkins,C,30,68,1148,102,227,0.449,0,1,0.0,102,226,0.451,42,83,0.506,91,229,320,51,16,42,95,162,246,-1.2,1.3,0.1,2014
Paul Pierce*,SF,37,73,1914,293,656,0.447,118,303,0.389,175,353,0.496,164,210,0.781,45,249,294,144,46,24,92,160,868,3.2,2.3,5.5,2014
Mason Plumlee,C,24,82,1743,280,489,0.573,0,3,0.0,280,486,0.576,157,317,0.495,175,337,512,74,65,63,106,207,717,2.5,2.3,4.8,2014
Miles Plumlee,C,26,73,1194,136,254,0.535,0,0,0.0,136,254,0.535,22,46,0.478,112,208,320,34,41,66,51,111,294,0.9,1.7,2.6,2014
Quincy Pondexter,SF,26,75,1793,188,447,0.421,91,244,0.373,97,203,0.478,71,96,0.74,53,142,195,94,19,24,51,150,538,2.1,0.8,2.9,2014
Otto Porter Jr.,SF,21,74,1432,176,391,0.45,35,104,0.337,141,287,0.491,58,79,0.734,70,151,221,65,44,30,52,97,445,1.0,1.8,2.7,2014
Dwight Powell,PF,23,29,236,31,67,0.463,3,11,0.273,28,56,0.5,25,33,0.758,18,32,50,9,9,6,11,40,90,0.3,0.3,0.6,2014
Phil Pressey,PG,23,50,600,64,174,0.368,16,65,0.246,48,109,0.44,33,49,0.673,13,67,80,117,30,6,41,54,177,0.0,0.7,0.8,2014
A.J. Price,PG,28,26,324,51,137,0.372,15,57,0.263,36,80,0.45,16,24,0.667,6,26,32,46,7,0,14,15,133,0.0,0.2,0.3,2014
Ronnie Price,PG,31,43,982,77,223,0.345,31,109,0.284,46,114,0.404,36,45,0.8,19,50,69,165,67,4,52,118,221,0.2,0.6,0.7,2014
Pablo Prigioni,PG,37,67,1197,91,228,0.399,57,166,0.343,34,62,0.548,35,41,0.854,30,89,119,171,79,1,62,88,274,1.3,1.0,2.3,2014
Tayshaun Prince,SF,34,58,1397,177,402,0.44,31,67,0.463,146,335,0.436,49,65,0.754,52,158,210,93,29,16,35,55,434,1.3,1.2,2.5,2014
Miroslav Raduljica,C,27,5,23,3,8,0.375,0,0,0.0,3,8,0.375,2,2,1.0,2,3,5,0,1,0,2,8,8,0.0,0.0,0.0,2014
Julius Randle,PF,20,1,14,1,3,0.333,0,0,0.0,1,3,0.333,0,2,0.0,0,0,0,0,0,0,1,1,2,-0.1,0.0,-0.1,2014
Shavlik Randolph,PF,31,21,126,9,35,0.257,0,5,0.0,9,30,0.3,6,12,0.5,16,22,38,4,5,3,3,16,24,-0.2,0.2,0.0,2014
Zach Randolph,PF,33,71,2304,454,932,0.487,7,20,0.35,447,912,0.49,228,298,0.765,225,522,747,153,69,14,156,175,1143,3.4,3.8,7.2,2014
JJ Redick,SG,30,78,2409,447,938,0.477,200,458,0.437,247,480,0.515,183,203,0.901,22,145,167,137,39,8,95,134,1277,5.8,0.9,6.7,2014
Glen Rice Jr.,SG,24,5,43,3,15,0.2,1,7,0.143,2,8,0.25,4,6,0.667,2,2,4,2,0,0,2,11,11,-0.1,0.0,-0.1,2014
Jason Richardson,SG,34,19,416,62,178,0.348,31,96,0.323,31,82,0.378,17,22,0.773,13,53,66,38,13,3,16,28,172,0.0,0.4,0.4,2014
Luke Ridnour,PG,33,47,683,75,176,0.426,20,63,0.317,55,113,0.487,18,21,0.857,8,60,68,96,20,4,38,67,188,0.3,0.3,0.6,2014
Austin Rivers,SG,22,76,1563,203,496,0.409,39,131,0.298,164,365,0.449,85,126,0.675,27,125,152,155,48,14,65,146,530,0.5,1.0,1.5,2014
Andre Roberson,SG,23,67,1286,92,201,0.458,21,85,0.247,71,116,0.612,23,48,0.479,60,195,255,70,53,29,46,141,228,0.5,1.6,2.1,2014
Brian Roberts,PG,29,72,1330,176,452,0.389,62,193,0.321,114,259,0.44,66,74,0.892,13,96,109,162,33,6,57,75,480,0.6,1.2,1.8,2014
Glenn Robinson III,SG,21,35,261,26,67,0.388,5,19,0.263,21,48,0.438,16,24,0.667,15,24,39,11,6,1,11,15,73,0.0,0.1,0.1,2014
Nate Robinson,PG,30,42,591,88,255,0.345,31,112,0.277,57,143,0.399,31,46,0.674,17,33,50,97,20,3,30,76,238,0.0,0.2,0.3,2014
Thomas Robinson,PF,23,54,798,126,260,0.485,0,2,0.0,126,258,0.488,56,106,0.528,95,208,303,33,32,20,59,104,308,0.0,1.4,1.5,2014
Rajon Rondo,PG,28,68,2018,275,645,0.426,27,86,0.314,248,559,0.444,31,78,0.397,73,300,373,538,91,7,210,153,608,-0.7,2.3,1.6,2014
Derrick Rose,PG,26,51,1530,338,835,0.405,76,271,0.28,262,564,0.465,152,187,0.813,35,126,161,251,36,16,161,63,904,0.0,1.2,1.2,2014
Terrence Ross,SF,23,82,2092,309,753,0.41,145,390,0.372,164,363,0.452,44,56,0.786,32,194,226,86,53,25,69,136,807,1.3,1.0,2.4,2014
Ricky Rubio,PG,24,22,692,78,219,0.356,13,51,0.255,65,168,0.387,57,71,0.803,19,106,125,193,38,1,64,59,226,0.1,0.4,0.5,2014
Damjan Rudež,SF,28,68,1047,119,263,0.452,69,170,0.406,50,93,0.538,16,23,0.696,8,39,47,53,16,5,47,79,323,0.6,0.7,1.3,2014
Brandon Rush,SG,29,33,271,11,54,0.204,3,27,0.111,8,27,0.296,5,11,0.455,4,37,41,12,5,12,11,27,30,-0.7,0.4,-0.3,2014
Robert Sacre,C,25,67,1133,126,306,0.412,0,1,0.0,126,305,0.413,55,82,0.671,89,144,233,55,28,43,36,121,307,0.3,0.6,0.8,2014
John Salmons,SF,35,21,270,16,48,0.333,8,26,0.308,8,22,0.364,2,4,0.5,4,17,21,13,9,4,5,25,42,0.0,0.1,0.1,2014
JaKarr Sampson,SF,21,74,1131,146,346,0.422,31,127,0.244,115,219,0.525,63,94,0.67,35,128,163,77,38,26,76,135,386,-0.5,1.1,0.6,2014
Larry Sanders,C,26,27,586,86,172,0.5,0,0,0.0,86,172,0.5,24,48,0.5,67,99,166,23,26,39,28,104,196,0.4,1.2,1.6,2014
Dennis Schröder,PG,21,77,1516,284,665,0.427,52,148,0.351,232,517,0.449,148,179,0.827,29,135,164,317,49,4,150,127,768,1.1,1.4,2.5,2014
Luis Scola,PF,34,81,1659,300,642,0.467,5,20,0.25,295,622,0.474,158,226,0.699,138,388,526,105,47,18,94,192,763,1.7,2.7,4.4,2014
Mike Scott,PF,26,68,1123,201,453,0.444,66,192,0.344,135,261,0.517,61,77,0.792,45,154,199,75,25,3,39,83,529,1.6,1.1,2.7,2014
Thabo Sefolosha,SF,30,52,976,104,249,0.418,25,78,0.321,79,171,0.462,45,58,0.776,53,170,223,75,53,21,38,67,278,0.8,1.7,2.5,2014
Kevin Séraphin,C,25,79,1235,231,450,0.513,0,2,0.0,231,448,0.516,58,82,0.707,87,201,288,59,10,59,98,197,520,0.0,1.7,1.7,2014
Ramon Sessions,PG,28,64,1188,125,334,0.374,19,60,0.317,106,274,0.387,133,173,0.769,23,121,144,182,29,0,86,73,402,0.4,0.7,1.1,2014
Iman Shumpert,SG,24,62,1545,193,471,0.41,67,196,0.342,126,275,0.458,43,64,0.672,55,169,224,135,81,16,91,138,496,0.1,1.4,1.5,2014
Alexey Shved,SG,26,42,767,133,335,0.397,47,139,0.338,86,196,0.439,121,150,0.807,23,76,99,106,30,6,48,48,434,1.7,0.5,2.2,2014
Henry Sims,C,24,73,1399,238,502,0.474,4,22,0.182,234,480,0.488,106,137,0.774,121,238,359,79,39,30,99,135,586,0.5,1.5,2.1,2014
Kyle Singler,SF,26,80,1743,172,446,0.386,96,241,0.398,76,205,0.371,40,52,0.769,33,161,194,85,47,21,55,153,480,0.9,1.2,2.0,2014
Donald Sloan,PG,27,53,1107,145,355,0.408,41,131,0.313,104,224,0.464,60,77,0.779,12,131,143,190,23,0,65,47,391,0.9,1.1,2.0,2014
Marcus Smart,PG,20,67,1808,175,477,0.367,91,272,0.335,84,205,0.41,82,127,0.646,61,161,222,208,99,18,90,176,523,0.7,2.2,2.9,2014
Greg Smith,PF,24,42,363,30,49,0.612,0,0,0.0,30,49,0.612,20,39,0.513,26,53,79,9,7,11,11,53,80,0.5,0.3,0.8,2014
Ish Smith,PG,26,55,832,143,367,0.39,18,60,0.3,125,307,0.407,34,57,0.596,15,85,100,180,36,6,78,50,338,-0.9,0.8,-0.1,2014
J.R. Smith,SG,29,70,2080,315,755,0.417,163,426,0.383,152,329,0.462,54,72,0.75,30,188,218,195,82,22,97,163,847,2.2,1.5,3.7,2014
Jason Smith,C,28,82,1785,257,592,0.434,15,42,0.357,242,550,0.44,127,153,0.83,98,226,324,140,32,44,104,205,656,0.5,0.7,1.2,2014
Josh Smith,PF,29,83,2300,414,987,0.419,72,228,0.316,342,759,0.451,127,255,0.498,152,378,530,277,87,116,206,228,1027,-1.1,3.4,2.3,2014
Russ Smith,PG,23,12,65,8,25,0.32,2,11,0.182,6,14,0.429,12,13,0.923,1,5,6,8,3,0,12,13,30,-0.2,0.1,-0.1,2014
Tony Snell,SF,23,72,1412,159,371,0.429,73,197,0.371,86,174,0.494,44,55,0.8,31,145,176,62,32,11,48,86,435,1.2,1.2,2.4,2014
Marreese Speights,C,27,76,1207,318,646,0.492,5,18,0.278,313,628,0.498,150,178,0.843,109,216,325,72,20,34,82,189,791,2.2,1.8,4.0,2014
Tiago Splitter,C,30,52,1030,169,303,0.558,0,0,0.0,169,303,0.558,90,120,0.75,91,161,252,78,35,37,60,103,428,2.3,1.7,4.0,2014
Nik Stauskas,SG,21,73,1127,108,296,0.365,48,149,0.322,60,147,0.408,55,64,0.859,11,77,88,67,20,17,40,92,319,0.3,0.2,0.5,2014
Lance Stephenson,SG,24,61,1573,207,550,0.376,18,105,0.171,189,445,0.425,69,110,0.627,39,238,277,240,38,8,128,134,501,-2.7,1.8,-0.9,2014
Greg Stiemsma,C,29,17,66,6,8,0.75,0,0,0.0,6,8,0.75,2,4,0.5,9,6,15,3,2,0,7,15,14,0.0,0.0,0.1,2014
David Stockton,PG,23,3,33,2,6,0.333,1,2,0.5,1,4,0.25,3,6,0.5,0,2,2,9,2,0,4,1,8,0.0,0.0,0.0,2014
Jarnell Stokes,PF,21,19,126,21,37,0.568,0,0,0.0,21,37,0.568,15,28,0.536,16,18,34,4,5,5,7,25,57,0.3,0.2,0.5,2014
Amar'e Stoudemire,PF,32,59,1245,273,490,0.557,0,4,0.0,273,486,0.562,134,186,0.72,110,219,329,45,29,38,78,161,680,2.6,1.0,3.6,2014
Rodney Stuckey,PG,28,71,1874,332,754,0.44,55,141,0.39,277,613,0.452,177,216,0.819,36,212,248,219,56,10,118,131,896,1.9,2.2,4.0,2014
Jared Sullinger,PF,22,58,1566,311,708,0.439,52,184,0.283,259,524,0.494,96,129,0.744,147,294,441,134,44,42,78,153,770,1.9,2.1,4.0,2014
Jeff Taylor,SF,25,29,430,45,114,0.395,11,36,0.306,34,78,0.436,26,41,0.634,14,39,53,22,12,1,19,36,127,-0.1,0.4,0.3,2014
Jeff Teague,PG,26,73,2228,408,887,0.46,71,207,0.343,337,680,0.496,275,319,0.862,30,154,184,513,125,31,205,139,1162,5.0,2.8,7.7,2014
Mirza Teletović,PF,29,40,892,122,319,0.382,62,193,0.321,60,126,0.476,33,46,0.717,27,167,194,46,14,16,53,74,339,-0.3,0.8,0.5,2014
Sebastian Telfair,PG,29,16,327,46,125,0.368,18,60,0.3,28,65,0.431,24,34,0.706,2,28,30,45,10,0,18,29,134,0.2,0.2,0.4,2014
Garrett Temple,SG,28,52,735,68,170,0.4,33,88,0.375,35,82,0.427,35,48,0.729,24,66,90,56,42,9,34,76,204,0.4,1.1,1.5,2014
Jason Terry,SG,37,77,1641,188,446,0.422,126,323,0.39,62,123,0.504,39,48,0.813,15,106,121,147,66,19,74,116,541,2.0,1.5,3.6,2014
Isaiah Thomas,PG,25,67,1726,335,797,0.42,129,346,0.373,206,451,0.457,302,348,0.868,33,120,153,284,57,5,143,150,1101,5.0,1.1,6.1,2014
Lance Thomas,PF,26,62,1490,182,442,0.412,7,22,0.318,175,420,0.417,72,99,0.727,65,130,195,69,37,8,74,101,443,-0.9,0.4,-0.4,2014
Malcolm Thomas,PF,26,17,194,18,40,0.45,0,7,0.0,18,33,0.545,9,13,0.692,16,40,56,7,3,1,13,17,45,-0.1,0.2,0.1,2014
Tyrus Thomas,PF,28,2,7,1,1,1.0,0,0,0.0,1,1,1.0,2,2,1.0,0,0,0,1,0,0,0,0,4,0.1,0.0,0.1,2014
Hollis Thompson,SG,23,71,1776,224,543,0.413,115,287,0.401,109,256,0.426,63,89,0.708,53,145,198,85,57,26,66,141,626,1.3,1.3,2.6,2014
Jason Thompson,PF,28,81,1991,201,428,0.47,0,1,0.0,201,427,0.471,89,143,0.622,139,391,530,85,33,57,84,239,491,0.9,1.5,2.4,2014
Klay Thompson,SG,24,77,2455,602,1299,0.463,239,545,0.439,363,754,0.481,225,256,0.879,27,220,247,222,87,60,149,122,1668,5.7,3.1,8.8,2014
Tristan Thompson,PF,23,82,2194,267,488,0.547,0,0,0.0,267,488,0.547,159,248,0.641,274,383,657,39,34,61,83,189,693,4.7,2.1,6.8,2014
Marcus Thornton,SG,27,48,721,140,345,0.406,54,143,0.378,86,202,0.426,46,56,0.821,23,63,86,36,27,7,27,38,380,0.6,0.7,1.2,2014
Anthony Tolliver,PF,29,76,1432,161,393,0.41,106,290,0.366,55,103,0.534,54,69,0.783,51,185,236,59,24,16,51,137,482,1.8,0.9,2.7,2014
P.J. Tucker,SF,29,78,2383,261,596,0.438,87,252,0.345,174,344,0.506,104,143,0.727,114,388,502,122,107,23,96,179,713,2.2,2.7,4.9,2014
Ronny Turiaf,C,32,2,19,0,0,0.0,0,0,0.0,0,0,0.0,0,0,0.0,0,1,1,2,0,0,0,0,0,0.0,0.0,0.0,2014
Hedo Türkoğlu,SF,35,62,705,83,188,0.441,60,139,0.432,23,49,0.469,6,11,0.545,5,94,99,37,19,7,29,66,232,0.6,0.6,1.2,2014
Evan Turner,SG,26,82,2260,320,746,0.429,33,119,0.277,287,627,0.458,106,141,0.752,40,377,417,449,83,19,198,180,779,-0.3,2.8,2.5,2014
Ekpe Udoh,PF,27,33,128,11,24,0.458,0,0,0.0,11,24,0.458,7,9,0.778,7,19,26,8,8,7,7,20,29,0.0,0.2,0.3,2014
Beno Udrih,PG,32,79,1494,246,505,0.487,26,97,0.268,220,408,0.539,87,102,0.853,20,123,143,220,46,8,89,88,605,2.0,1.6,3.6,2014
Jonas Valančiūnas,C,22,80,2096,373,652,0.572,0,1,0.0,373,651,0.573,217,276,0.786,215,478,693,39,33,95,109,222,963,5.8,2.4,8.2,2014
Anderson Varejão,C,32,26,636,111,200,0.555,0,2,0.0,111,198,0.561,33,45,0.733,57,113,170,35,19,16,35,58,255,1.2,0.7,1.9,2014
Greivis Vásquez,PG,28,82,1991,296,725,0.408,133,351,0.379,163,374,0.436,50,66,0.758,22,194,216,302,46,10,119,177,775,1.9,0.9,2.8,2014
Charlie Villanueva,PF,30,64,678,150,362,0.414,83,221,0.376,67,141,0.475,20,35,0.571,30,119,149,19,15,22,28,64,403,0.6,0.7,1.4,2014
Noah Vonleh,PF,19,25,259,30,76,0.395,5,13,0.385,25,63,0.397,18,26,0.692,28,58,86,4,4,9,11,20,83,0.1,0.4,0.5,2014
Nikola Vučević,C,24,74,2529,631,1206,0.523,2,6,0.333,629,1200,0.524,164,218,0.752,238,572,810,147,54,54,148,220,1428,4.5,2.5,7.0,2014
Dwyane Wade*,SG,33,62,1971,509,1084,0.47,29,102,0.284,480,982,0.489,284,370,0.768,58,161,219,299,73,21,209,105,1331,2.1,1.4,3.5,2014
Dion Waiters,SG,23,80,2208,375,946,0.396,73,246,0.297,302,700,0.431,117,172,0.68,41,151,192,163,90,21,113,155,940,-0.6,1.7,1.1,2014
Henry Walker,SF,27,24,628,58,168,0.345,45,132,0.341,13,36,0.361,14,18,0.778,7,75,82,29,24,9,24,76,175,-0.1,0.6,0.5,2014
Kemba Walker,PG,24,62,2119,378,981,0.385,85,280,0.304,293,701,0.418,234,283,0.827,35,185,220,318,89,31,100,92,1075,1.8,2.6,4.5,2014
John Wall,PG,24,79,2837,519,1166,0.445,65,217,0.3,454,949,0.478,284,362,0.785,36,330,366,792,138,45,304,180,1387,3.6,4.2,7.8,2014
Gerald Wallace,SF,32,32,286,14,34,0.412,1,3,0.333,13,31,0.419,6,15,0.4,17,40,57,11,15,4,18,19,35,-0.3,0.4,0.1,2014
T.J. Warren,SF,21,40,614,113,214,0.528,5,21,0.238,108,193,0.56,14,19,0.737,41,44,85,25,18,9,27,51,245,0.7,0.4,1.1,2014
C.J. Watson,PG,30,57,1422,181,417,0.434,70,175,0.4,111,242,0.459,138,167,0.826,18,145,163,208,57,9,100,107,570,2.2,1.8,4.0,2014
David Wear,PF,24,2,7,0,2,0.0,0,1,0.0,0,1,0.0,0,0,0.0,2,0,2,1,0,0,0,1,0,0.0,0.0,0.0,2014
Travis Wear,SF,24,51,672,84,209,0.402,11,30,0.367,73,179,0.408,20,26,0.769,31,75,106,40,15,11,35,55,199,-0.5,0.2,-0.3,2014
Martell Webster,SF,28,32,352,24,91,0.264,10,43,0.233,14,48,0.292,48,64,0.75,10,36,46,17,7,1,22,24,106,-0.3,0.3,0.0,2014
David West,PF,34,66,1895,323,686,0.471,4,20,0.2,319,666,0.479,119,161,0.739,108,341,449,223,48,48,120,160,769,1.4,2.8,4.3,2014
Russell Westbrook,PG,26,67,2302,627,1471,0.426,86,288,0.299,541,1183,0.457,546,654,0.835,124,364,488,574,140,14,293,184,1886,7.5,3.2,10.6,2014
Hassan Whiteside,C,25,48,1142,243,387,0.628,0,0,0.0,243,387,0.628,78,156,0.5,145,337,482,6,27,123,58,129,564,2.8,2.4,5.3,2014
Shayne Whittington,PF,23,20,108,19,42,0.452,1,6,0.167,18,36,0.5,18,23,0.783,10,19,29,6,5,2,5,18,57,0.3,0.2,0.4,2014
Andrew Wiggins,SF,19,82,2969,497,1137,0.437,39,126,0.31,458,1011,0.453,354,466,0.76,134,240,374,170,86,50,177,190,1387,2.1,0.0,2.1,2014
C.J. Wilcox,SG,24,21,101,16,38,0.421,7,19,0.368,9,19,0.474,2,2,1.0,1,6,7,8,3,1,10,7,41,-0.1,0.1,0.0,2014
Deron Williams,PG,30,68,2114,298,771,0.387,87,237,0.367,211,534,0.395,201,241,0.834,29,208,237,448,64,17,154,157,884,2.3,1.3,3.6,2014
Derrick Williams,PF,23,74,1462,217,485,0.447,49,156,0.314,168,329,0.511,134,196,0.684,41,161,202,50,34,4,56,67,617,1.7,0.4,2.1,2014
Elliot Williams,SG,25,13,119,14,37,0.378,8,18,0.444,6,19,0.316,1,4,0.25,0,8,8,12,4,0,4,12,37,0.0,0.1,0.1,2014
Lou Williams,SG,28,80,2016,375,928,0.404,152,447,0.34,223,481,0.464,340,395,0.861,24,127,151,164,88,10,101,103,1242,5.4,1.1,6.6,2014
Marvin Williams,PF,28,78,2035,210,495,0.424,95,265,0.358,115,230,0.5,62,87,0.713,58,328,386,100,69,36,60,146,577,1.5,2.9,4.3,2014
Mo Williams,PG,32,68,1980,341,860,0.397,119,348,0.342,222,512,0.434,163,187,0.872,22,152,174,424,46,14,172,162,964,1.6,0.6,2.1,2014
Reggie Williams,SF,28,20,105,15,39,0.385,3,19,0.158,12,20,0.6,4,4,1.0,5,12,17,10,1,0,2,12,37,0.1,0.1,0.2,2014
Shawne Williams,SF,28,63,1087,121,300,0.403,64,178,0.36,57,122,0.467,35,40,0.875,36,130,166,44,25,21,30,135,341,1.1,0.8,1.9,2014
Jeff Withey,C,24,37,259,32,64,0.5,0,0,0.0,32,64,0.5,34,50,0.68,23,41,64,11,4,18,12,26,98,0.5,0.3,0.8,2014
Nate Wolters,PG,23,21,247,20,57,0.351,0,7,0.0,20,50,0.4,2,6,0.333,8,26,34,21,8,2,13,18,42,-0.4,0.2,-0.2,2014
Brandan Wright,PF,27,75,1449,233,363,0.642,0,3,0.0,233,360,0.647,78,112,0.696,128,193,321,41,50,94,34,102,544,4.3,1.8,6.1,2014
Dorell Wright,SF,29,48,592,72,190,0.379,41,108,0.38,31,82,0.378,34,42,0.81,14,97,111,41,20,11,18,55,219,0.7,0.8,1.6,2014
Tony Wroten,PG,21,30,895,175,434,0.403,37,142,0.261,138,292,0.473,120,180,0.667,22,64,86,157,48,8,113,72,507,-0.6,0.9,0.3,2014
James Young,SG,19,31,332,36,102,0.353,17,66,0.258,19,36,0.528,16,29,0.552,9,33,42,13,8,2,5,22,105,0.1,0.3,0.3,2014
Nick Young,SG,29,42,1000,174,476,0.366,83,225,0.369,91,251,0.363,132,148,0.892,17,79,96,41,23,11,44,83,563,1.1,0.1,1.2,2014
Thaddeus Young,PF,26,76,2434,451,968,0.466,38,115,0.33,413,853,0.484,131,200,0.655,127,284,411,173,124,25,117,171,1071,1.6,1.4,3.1,2014
Cody Zeller,C,22,62,1487,172,373,0.461,1,1,1.0,171,372,0.46,127,164,0.774,97,265,362,100,34,49,62,156,472,1.6,2.2,3.8,2014
Tyler Zeller,C,25,82,1731,340,619,0.549,0,0,0.0,340,619,0.549,153,186,0.823,146,319,465,113,18,52,76,205,833,4.5,2.0,6.5,2014
Quincy Acy,PF,25,59,876,119,214,0.556,19,49,0.388,100,165,0.606,50,68,0.735,65,123,188,27,29,24,27,103,307,1.8,0.7,2.5,2015
Jordan Adams,SG,21,2,15,2,6,0.333,0,1,0.0,2,5,0.4,3,5,0.6,0,2,2,3,3,0,2,2,7,0.0,0.0,0.0,2015
Steven Adams,C,22,80,2014,261,426,0.613,0,0,0.0,261,426,0.613,114,196,0.582,219,314,533,62,42,89,84,223,636,4.2,2.3,6.5,2015
Arron Afflalo,SG,30,71,2371,354,799,0.443,91,238,0.382,263,561,0.469,110,131,0.84,23,243,266,144,25,10,82,142,909,1.8,0.9,2.7,2015
Alexis Ajinça,C,27,59,861,150,315,0.476,0,1,0.0,150,314,0.478,52,62,0.839,75,194,269,31,19,36,54,134,352,0.2,0.9,1.0,2015
Cole Aldrich,C,27,60,800,134,225,0.596,0,0,0.0,134,225,0.596,60,84,0.714,86,202,288,50,47,68,64,139,328,1.4,2.0,3.5,2015
LaMarcus Aldridge,PF,30,74,2261,536,1045,0.513,0,16,0.0,536,1029,0.521,259,302,0.858,176,456,632,110,38,81,99,151,1331,5.6,4.5,10.1,2015
Cliff Alexander,PF,20,8,36,5,10,0.5,0,0,0.0,5,10,0.5,0,0,0.0,2,4,6,0,1,2,1,1,10,0.0,0.0,0.0,2015
Lavoy Allen,PF,26,79,1599,191,370,0.516,0,0,0.0,191,370,0.516,46,73,0.63,162,262,424,76,26,42,69,147,428,1.6,2.1,3.7,2015
Tony Allen,SG,34,64,1620,215,469,0.458,15,42,0.357,200,427,0.468,90,138,0.652,104,192,296,70,110,18,78,175,535,0.5,1.9,2.4,2015
Al-Farouq Aminu,SF,25,82,2341,299,719,0.416,126,349,0.361,173,370,0.468,115,156,0.737,98,401,499,138,72,53,120,171,839,1.7,2.3,4.0,2015
Lou Amundson,PF,33,29,204,19,53,0.358,0,0,0.0,19,53,0.358,14,27,0.519,23,26,49,12,6,7,15,44,52,-0.3,0.2,-0.1,2015
Chris Andersen,C,37,27,402,38,72,0.528,4,14,0.286,34,58,0.586,25,36,0.694,36,62,98,12,15,13,9,29,105,0.8,0.4,1.3,2015
Alan Anderson,SG,33,13,192,21,59,0.356,12,37,0.324,9,22,0.409,11,15,0.733,1,26,27,14,4,1,2,25,65,0.2,0.2,0.3,2015
James Anderson,SG,26,51,721,67,178,0.376,23,86,0.267,44,92,0.478,22,29,0.759,13,73,86,41,21,14,42,54,179,-0.6,0.4,-0.3,2015
Justin Anderson,SF,22,55,647,71,175,0.406,22,83,0.265,49,92,0.533,44,55,0.8,18,114,132,29,19,25,24,45,208,0.3,0.8,1.1,2015
Kyle Anderson,SF,22,78,1245,138,295,0.468,12,37,0.324,126,258,0.488,62,83,0.747,25,219,244,123,60,29,59,97,350,0.7,2.8,3.5,2015
Ryan Anderson,PF,27,66,2008,397,929,0.427,131,358,0.366,266,571,0.466,199,228,0.873,131,265,396,73,38,25,90,109,1124,3.1,0.8,3.9,2015
Giannis Antetokounmpo,PG,21,80,2823,513,1013,0.506,28,109,0.257,485,904,0.537,296,409,0.724,113,499,612,345,94,113,208,258,1350,4.2,2.9,7.1,2015
Thanasis Antetokounmpo,SF,23,2,6,3,4,0.75,0,1,0.0,3,3,1.0,0,0,0.0,0,1,1,0,0,0,0,2,6,0.0,0.0,0.0,2015
Carmelo Anthony,SF,31,72,2530,567,1307,0.434,105,310,0.339,462,997,0.463,334,403,0.829,98,458,556,299,62,38,176,180,1573,3.9,2.5,6.4,2015
Joel Anthony,C,33,19,96,6,10,0.6,0,0,0.0,6,10,0.6,6,8,0.75,8,13,21,1,2,12,2,15,18,0.2,0.2,0.4,2015
Keith Appling,PG,23,5,27,2,8,0.25,0,3,0.0,2,5,0.4,2,2,1.0,0,1,1,1,1,0,3,5,6,-0.1,0.0,-0.1,2015
Trevor Ariza,SF,30,81,2859,357,859,0.416,185,499,0.371,172,360,0.478,126,161,0.783,67,299,366,188,160,26,113,177,1025,3.1,2.3,5.4,2015
Darrell Arthur,PF,27,70,1516,221,489,0.452,45,117,0.385,176,372,0.473,40,53,0.755,86,207,293,96,53,48,66,185,527,1.0,1.3,2.3,2015
Ömer Aşık,C,29,68,1178,104,195,0.533,0,0,0.0,104,195,0.533,61,112,0.545,120,294,414,26,21,23,60,124,269,0.7,1.0,1.7,2015
D.J. Augustin,PG,28,62,1178,148,350,0.423,68,168,0.405,80,182,0.44,103,128,0.805,8,87,95,198,38,4,84,85,467,2.0,0.6,2.6,2015
Jeff Ayres,C,28,17,107,12,23,0.522,0,1,0.0,12,22,0.545,6,6,1.0,4,18,22,5,0,3,6,18,30,0.1,0.1,0.2,2015
Luke Babbitt,SF,26,47,845,122,289,0.422,44,109,0.404,78,180,0.433,39,50,0.78,25,123,148,53,11,7,23,90,327,0.8,0.3,1.1,2015
Cameron Bairstow,C,25,18,103,13,40,0.325,1,5,0.2,12,35,0.343,7,8,0.875,4,24,28,6,2,3,4,19,34,-0.1,0.1,0.0,2015
Leandro Barbosa,SG,33,68,1079,171,370,0.462,39,110,0.355,132,260,0.508,52,62,0.839,28,89,117,82,44,10,53,107,433,0.9,1.2,2.1,2015
J.J. Barea,PG,31,74,1667,317,711,0.446,100,260,0.385,217,451,0.481,74,96,0.771,26,126,152,302,26,2,113,110,808,2.1,0.7,2.8,2015
Andrea Bargnani,C,30,46,634,127,279,0.455,3,16,0.188,124,263,0.471,47,57,0.825,28,69,97,18,4,9,26,61,304,0.1,0.0,0.2,2015
Harrison Barnes,SF,23,66,2042,295,633,0.466,82,214,0.383,213,419,0.508,102,134,0.761,77,248,325,117,41,10,57,136,774,3.1,1.9,4.9,2015
Matt Barnes,SF,35,76,2190,264,693,0.381,119,370,0.322,145,323,0.449,111,138,0.804,84,336,420,163,78,57,121,234,758,0.4,2.2,2.6,2015
Will Barton,SG,25,82,2353,425,983,0.432,112,325,0.345,313,658,0.476,216,268,0.806,59,417,476,203,71,39,139,147,1178,2.4,1.9,4.3,2015
Brandon Bass,PF,30,66,1342,174,317,0.549,0,2,0.0,174,315,0.552,125,148,0.845,104,181,285,74,33,55,42,125,473,3.4,0.7,4.1,2015
Nicolas Batum,SF,27,70,2448,372,873,0.426,139,399,0.348,233,474,0.492,163,192,0.849,55,373,428,403,65,43,205,114,1046,2.0,2.9,5.0,2015
Jerryd Bayless,SG,27,52,1505,185,437,0.423,101,231,0.437,84,206,0.408,70,90,0.778,21,120,141,163,47,11,73,111,541,1.8,0.6,2.4,2015
Aron Baynes,C,29,81,1233,194,384,0.505,0,2,0.0,194,382,0.508,126,165,0.764,140,244,384,51,21,52,67,151,514,2.4,1.7,4.1,2015
Kent Bazemore,SF,26,75,2083,320,725,0.441,109,305,0.357,211,420,0.502,123,151,0.815,28,351,379,171,98,38,138,176,872,0.3,3.8,4.1,2015
Bradley Beal,SG,22,55,1708,359,799,0.449,105,271,0.387,254,528,0.481,135,176,0.767,41,147,188,162,54,11,112,117,958,1.4,1.3,2.7,2015
Michael Beasley,PF,27,20,363,107,205,0.522,3,9,0.333,104,196,0.531,38,49,0.776,29,69,98,16,11,9,24,39,255,0.6,0.3,1.0,2015
Marco Belinelli,SG,29,68,1672,245,635,0.386,91,297,0.306,154,338,0.456,115,138,0.833,10,107,117,127,37,2,80,91,696,0.2,0.3,0.5,2015
Anthony Bennett,PF,22,19,84,8,27,0.296,3,14,0.214,5,13,0.385,9,10,0.9,6,17,23,0,5,0,4,8,28,0.0,0.1,0.1,2015
Patrick Beverley,PG,27,71,2041,258,594,0.434,124,310,0.4,134,284,0.472,60,88,0.682,73,177,250,239,94,26,91,234,700,3.1,1.3,4.4,2015
Bismack Biyombo,C,23,82,1808,156,288,0.542,0,1,0.0,156,287,0.544,142,226,0.628,182,473,655,29,19,133,71,225,454,2.8,3.1,5.9,2015
Nemanja Bjelica,PF,27,60,1075,110,235,0.468,48,125,0.384,62,110,0.564,40,55,0.727,49,161,210,83,26,21,47,154,308,1.4,0.6,1.9,2015
Tarik Black,C,24,39,496,57,104,0.548,0,0,0.0,57,104,0.548,19,45,0.422,44,113,157,16,14,18,22,78,133,0.3,0.4,0.7,2015
DeJuan Blair,C,26,29,218,28,68,0.412,0,1,0.0,28,67,0.418,5,13,0.385,20,37,57,11,8,2,15,53,61,-0.3,0.3,-0.1,2015
Steve Blake,PG,35,58,986,93,240,0.388,52,151,0.344,41,89,0.461,16,20,0.8,9,80,89,200,24,5,81,70,254,0.3,0.8,1.1,2015
Eric Bledsoe,PG,26,31,1059,223,492,0.453,48,129,0.372,175,363,0.482,138,172,0.802,18,107,125,190,63,19,110,75,632,1.6,1.0,2.5,2015
Bojan Bogdanović,SF,26,79,2115,324,749,0.433,129,338,0.382,195,411,0.474,110,132,0.833,36,219,255,99,29,5,115,119,887,0.9,0.0,0.9,2015
Andrew Bogut,C,31,70,1451,175,279,0.627,1,1,1.0,174,278,0.626,24,50,0.48,121,371,492,162,33,114,83,221,375,2.6,2.9,5.4,2015
Matt Bonner,C,35,30,206,29,57,0.509,15,34,0.441,14,23,0.609,3,4,0.75,3,24,27,9,6,1,3,16,76,0.4,0.3,0.8,2015
Devin Booker,SG,19,76,2108,367,867,0.423,99,289,0.343,268,578,0.464,215,256,0.84,27,160,187,200,44,20,160,225,1048,1.2,0.7,1.9,2015
Trevor Booker,PF,28,79,1632,190,388,0.49,12,41,0.293,178,347,0.513,71,106,0.67,166,286,452,84,59,41,81,169,463,1.8,2.6,4.3,2015
Chris Bosh*,PF,31,53,1778,358,767,0.467,81,222,0.365,277,545,0.508,213,268,0.795,48,342,390,128,36,34,78,101,1010,4.1,2.3,6.4,2015
Avery Bradley,SG,25,76,2536,456,1019,0.447,147,407,0.361,309,612,0.505,96,123,0.78,48,172,220,158,117,19,109,164,1155,2.0,2.8,4.8,2015
Elton Brand,C,36,17,225,31,72,0.431,0,1,0.0,31,71,0.437,8,9,0.889,9,54,63,18,9,8,11,32,70,-0.1,0.3,0.2,2015
Corey Brewer,SF,29,82,1669,212,552,0.384,61,224,0.272,151,328,0.46,105,140,0.75,42,157,199,109,84,19,78,168,590,0.1,1.2,1.2,2015
Aaron Brooks,PG,31,69,1108,188,469,0.401,66,185,0.357,122,284,0.43,49,64,0.766,21,80,101,180,30,10,82,132,491,0.2,0.7,0.9,2015
Anthony Brown,SF,23,29,599,39,126,0.31,20,70,0.286,19,56,0.339,17,20,0.85,9,61,70,19,14,5,15,34,115,-0.4,0.1,-0.3,2015
Lorenzo Brown,PG,25,8,61,8,25,0.32,1,8,0.125,7,17,0.412,3,4,0.75,0,7,7,11,3,1,9,4,20,-0.3,0.1,-0.2,2015
Markel Brown,SG,24,62,982,127,322,0.394,38,121,0.314,89,201,0.443,71,94,0.755,23,99,122,91,38,15,54,94,363,0.2,0.4,0.6,2015
Kobe Bryant*,SF,37,66,1863,398,1113,0.358,133,467,0.285,265,646,0.41,232,281,0.826,41,206,247,184,62,13,129,115,1161,-0.9,0.5,-0.4,2015
Chase Budinger,SF,27,66,929,104,239,0.435,24,86,0.279,80,153,0.523,39,56,0.696,43,107,150,64,32,10,44,62,271,0.4,1.0,1.4,2015
Reggie Bullock,SF,24,37,429,43,98,0.439,22,53,0.415,21,45,0.467,14,15,0.933,14,54,68,27,10,2,8,29,122,0.8,0.4,1.2,2015
Trey Burke,PG,23,64,1366,262,634,0.413,88,256,0.344,174,378,0.46,67,82,0.817,18,94,112,148,35,6,80,86,679,0.9,1.2,2.1,2015
Alec Burks,SG,24,31,797,137,334,0.41,32,79,0.405,105,255,0.412,106,141,0.752,16,93,109,63,18,4,51,71,412,0.7,0.8,1.5,2015
Caron Butler,SF,35,17,176,25,59,0.424,3,18,0.167,22,41,0.537,10,12,0.833,5,17,22,10,9,1,3,19,63,0.1,0.1,0.3,2015
Jimmy Butler,SG,26,67,2474,470,1035,0.454,64,205,0.312,406,830,0.489,395,475,0.832,79,279,358,321,110,43,132,124,1399,6.5,2.7,9.1,2015
Rasual Butler,SF,36,46,432,49,104,0.471,15,49,0.306,34,55,0.618,11,16,0.688,3,53,56,24,13,23,8,11,124,0.4,0.9,1.3,2015
Bruno Caboclo,SF,20,6,43,1,12,0.083,1,7,0.143,0,5,0.0,0,0,0.0,1,1,2,1,2,1,4,2,3,-0.3,0.0,-0.3,2015
José Calderón,PG,34,72,2024,209,455,0.459,84,203,0.414,125,252,0.496,42,48,0.875,22,207,229,298,63,7,87,135,544,2.7,1.4,4.0,2015
Kentavious Caldwell-Pope,SG,22,76,2789,403,960,0.42,114,369,0.309,289,591,0.489,185,228,0.811,70,212,282,138,110,17,105,167,1105,2.6,2.7,5.3,2015
Isaiah Canaan,SG,24,77,1966,260,722,0.36,176,485,0.363,84,237,0.354,150,180,0.833,20,154,174,137,56,12,91,133,846,0.9,0.5,1.4,2015
Clint Capela,C,21,77,1471,231,397,0.582,0,1,0.0,231,396,0.583,80,211,0.379,194,300,494,47,59,92,60,190,542,2.4,2.0,4.4,2015
DeMarre Carroll,SF,29,26,786,105,270,0.389,46,118,0.39,59,152,0.388,30,50,0.6,31,91,122,27,44,6,28,63,286,0.2,1.0,1.2,2015
Vince Carter*,SG,39,60,1005,133,343,0.388,59,169,0.349,74,174,0.425,70,84,0.833,31,115,146,56,38,16,35,101,395,1.0,0.8,1.8,2015
Michael Carter-Williams,PG,24,54,1649,251,555,0.452,15,55,0.273,236,500,0.472,106,162,0.654,48,228,276,281,80,41,153,162,623,-0.4,1.6,1.2,2015
Omri Casspi,PF,27,69,1880,299,622,0.481,112,274,0.409,187,348,0.537,103,159,0.648,58,352,410,95,56,17,94,154,813,2.1,1.5,3.6,2015
Willie Cauley-Stein,C,22,66,1412,191,339,0.563,0,2,0.0,191,337,0.567,81,125,0.648,134,218,352,37,48,66,46,146,463,2.4,1.4,3.8,2015
Mario Chalmers,PG,29,61,1373,182,444,0.41,46,149,0.309,136,295,0.461,218,262,0.832,24,133,157,230,88,13,110,181,628,2.3,1.5,3.8,2015
Tyson Chandler,C,33,66,1618,183,314,0.583,0,1,0.0,183,313,0.585,106,171,0.62,175,401,576,64,36,44,93,145,472,2.1,1.6,3.8,2015
Rakeem Christmas,PF,24,1,6,2,2,1.0,0,0,0.0,2,2,1.0,0,0,0.0,1,0,1,0,0,0,0,1,4,0.0,0.0,0.0,2015
Ian Clark,SG,24,66,578,89,202,0.441,30,84,0.357,59,118,0.5,28,34,0.824,13,55,68,64,17,13,43,58,236,0.3,0.6,0.9,2015
Coty Clarke,SF,23,3,6,2,4,0.5,2,2,1.0,0,2,0.0,0,0,0.0,0,1,1,0,0,0,1,0,6,0.0,0.0,0.0,2015
Jordan Clarkson,SG,23,79,2552,475,1098,0.433,111,320,0.347,364,778,0.468,164,204,0.804,93,220,313,192,88,7,135,168,1225,1.7,0.4,2.1,2015
Norris Cole,PG,27,45,1198,196,484,0.405,33,102,0.324,163,382,0.427,52,65,0.8,10,141,151,167,37,5,75,102,477,-0.6,0.5,-0.1,2015
Darren Collison,PG,28,74,2219,377,776,0.486,87,217,0.401,290,559,0.519,194,226,0.858,28,141,169,318,76,4,130,142,1035,4.5,0.7,5.2,2015
Nick Collison,PF,35,59,699,50,109,0.459,0,2,0.0,50,107,0.467,23,33,0.697,68,103,171,52,15,16,50,107,123,0.1,0.7,0.8,2015
Mike Conley,PG,28,56,1761,294,696,0.422,78,215,0.363,216,481,0.449,191,229,0.834,26,138,164,342,67,16,84,100,857,4.2,1.1,5.3,2015
Pat Connaughton,SG,23,34,143,13,49,0.265,5,21,0.238,8,28,0.286,5,5,1.0,11,21,32,10,2,0,10,6,36,-0.3,0.1,-0.2,2015
Chris Copeland,PF,31,24,156,17,51,0.333,10,36,0.278,7,15,0.467,6,7,0.857,1,9,10,11,2,0,6,17,50,-0.1,0.0,-0.1,2015
Bryce Cotton,PG,23,8,39,4,10,0.4,0,3,0.0,4,7,0.571,0,0,0.0,0,0,0,3,3,0,5,2,8,-0.2,0.0,-0.1,2015
DeMarcus Cousins,C,25,65,2246,601,1332,0.451,70,210,0.333,531,1122,0.473,476,663,0.718,158,589,747,214,101,92,249,236,1748,2.4,3.3,5.7,2015
Robert Covington,SF,25,67,1903,274,712,0.385,170,482,0.353,104,230,0.452,140,177,0.791,65,354,419,97,105,40,143,232,858,-0.1,2.1,2.0,2015
Allen Crabbe,SG,23,81,2105,311,678,0.459,112,285,0.393,199,393,0.506,98,113,0.867,27,189,216,99,63,16,64,192,832,3.1,1.2,4.3,2015
Jamal Crawford,SG,35,79,2126,379,939,0.404,117,344,0.34,262,595,0.44,245,271,0.904,20,125,145,183,52,12,113,122,1120,1.8,1.5,3.3,2015
Jae Crowder,SF,25,73,2308,360,813,0.443,122,363,0.336,238,450,0.529,196,239,0.82,70,303,373,135,126,35,83,198,1038,3.8,3.5,7.3,2015
Dante Cunningham,SF,28,80,1971,186,412,0.451,55,174,0.316,131,238,0.55,57,82,0.695,57,179,236,77,42,33,41,173,484,1.5,0.7,2.1,2015
Jared Cunningham,SG,24,44,410,36,105,0.343,12,39,0.308,24,66,0.364,36,55,0.655,3,35,38,20,14,2,21,41,120,-0.3,0.4,0.1,2015
Seth Curry,PG,25,44,692,102,224,0.455,50,111,0.45,52,113,0.46,45,54,0.833,9,51,60,67,22,3,36,41,299,1.2,0.2,1.4,2015
Stephen Curry,PG,27,79,2700,805,1598,0.504,402,886,0.454,403,712,0.566,363,400,0.908,68,362,430,527,169,15,262,161,2375,13.8,4.1,17.9,2015
Troy Daniels,SG,24,43,476,89,187,0.476,59,122,0.484,30,65,0.462,5,9,0.556,7,50,57,21,11,3,24,40,242,0.6,0.4,1.1,2015
Anthony Davis,C,22,61,2164,560,1136,0.493,35,108,0.324,525,1028,0.511,326,430,0.758,130,497,627,116,78,125,121,148,1481,4.4,2.8,7.2,2015
Ed Davis,PF,26,81,1684,206,337,0.611,0,0,0.0,206,337,0.611,114,204,0.559,224,375,599,88,57,72,64,202,526,4.4,2.3,6.7,2015
Branden Dawson,PF,22,6,29,2,5,0.4,0,0,0.0,2,5,0.4,1,1,1.0,2,2,4,0,0,1,0,2,5,0.0,0.0,0.0,2015
Dewayne Dedmon,C,26,58,705,99,177,0.559,0,0,0.0,99,177,0.559,57,76,0.75,67,161,228,13,22,46,32,109,255,1.2,1.1,2.4,2015
Bryce Dejean-Jones,SG,23,14,279,28,69,0.406,12,32,0.375,16,37,0.432,11,21,0.524,8,40,48,15,10,2,11,17,79,0.0,0.2,0.2,2015
Sam Dekker,PF,21,3,6,0,0,0.0,0,0,0.0,0,0,0.0,0,0,0.0,0,1,1,0,1,0,0,0,0,0.0,0.0,0.0,2015
Matthew Dellavedova,PG,25,76,1867,207,511,0.405,98,239,0.41,109,272,0.401,57,66,0.864,33,129,162,337,44,9,116,178,569,2.2,1.6,3.8,2015
Luol Deng,PF,30,74,2394,339,745,0.455,88,256,0.344,251,489,0.513,145,192,0.755,108,335,443,140,74,29,81,122,911,3.5,2.8,6.4,2015
DeMar DeRozan,SG,26,78,2804,614,1377,0.446,47,139,0.338,567,1238,0.458,555,653,0.85,64,285,349,315,81,21,175,167,1830,7.5,2.4,9.9,2015
Boris Diaw,PF,33,76,1386,202,383,0.527,25,69,0.362,177,314,0.564,56,76,0.737,58,175,233,176,26,21,97,102,485,1.6,2.2,3.8,2015
Gorgui Dieng,C,26,82,2220,308,579,0.532,6,20,0.3,302,559,0.54,205,248,0.827,157,428,585,143,94,96,140,219,827,3.4,2.5,5.9,2015
Spencer Dinwiddie,PG,22,12,159,19,54,0.352,1,10,0.1,18,44,0.409,19,33,0.576,4,13,17,22,3,0,7,20,58,0.0,0.1,0.1,2015
Toney Douglas,PG,29,61,1262,183,445,0.411,81,203,0.399,102,242,0.421,84,99,0.848,25,118,143,157,70,5,64,131,531,1.6,0.9,2.5,2015
Goran Dragić,PG,29,72,2363,417,875,0.477,64,205,0.312,353,670,0.527,120,165,0.727,54,223,277,419,71,17,185,188,1018,2.4,2.3,4.7,2015
Andre Drummond,C,22,81,2666,552,1060,0.521,2,6,0.333,550,1054,0.522,208,586,0.355,395,803,1198,67,119,112,155,245,1314,2.0,5.5,7.4,2015
Jared Dudley,PF,30,81,2098,233,487,0.478,100,238,0.42,133,249,0.534,72,98,0.735,54,232,286,170,75,18,80,190,638,2.6,2.0,4.6,2015
Duje Dukan,SF,24,1,24,2,10,0.2,2,5,0.4,0,5,0.0,0,0,0.0,2,2,4,1,1,0,0,2,6,0.0,0.0,0.0,2015
Tim Duncan*,C,39,61,1536,215,441,0.488,0,2,0.0,215,439,0.49,92,131,0.702,115,332,447,163,47,78,90,125,522,1.6,3.6,5.2,2015
Mike Dunleavy,SF,35,31,703,77,188,0.41,39,99,0.394,38,89,0.427,29,37,0.784,8,75,83,39,14,10,26,66,222,0.4,0.5,0.9,2015
Kevin Durant,SF,27,72,2578,698,1381,0.505,186,481,0.387,512,900,0.569,447,498,0.898,45,544,589,361,69,85,250,137,2029,11.0,3.5,14.5,2015
Cleanthony Early,SF,24,17,154,12,40,0.3,4,15,0.267,8,25,0.32,3,4,0.75,4,22,26,6,2,3,9,16,31,-0.3,0.1,-0.2,2015
Jarell Eddie,SF,24,26,147,20,65,0.308,15,47,0.319,5,18,0.278,8,8,1.0,2,21,23,5,5,1,1,5,63,0.0,0.1,0.1,2015
Wayne Ellington,SG,28,76,1615,218,561,0.389,96,268,0.358,122,293,0.416,54,63,0.857,20,154,174,83,48,5,45,82,586,0.5,0.3,0.8,2015
Monta Ellis,SG,30,81,2734,436,1021,0.427,87,282,0.309,349,739,0.472,162,206,0.786,42,229,271,383,150,37,203,174,1121,0.4,3.9,4.3,2015
James Ennis III,SF,25,22,329,54,113,0.478,26,58,0.448,28,55,0.509,25,34,0.735,21,21,42,21,16,5,19,28,159,0.7,0.2,0.9,2015
Tyler Ennis,PG,21,46,654,84,187,0.449,13,39,0.333,71,148,0.48,25,34,0.735,13,62,75,95,25,1,46,64,206,0.1,0.3,0.4,2015
Jeremy Evans,SF,28,30,251,26,48,0.542,4,16,0.25,22,32,0.688,15,21,0.714,11,43,54,2,6,9,7,19,71,0.3,0.3,0.6,2015
Tyreke Evans,SG,26,25,765,136,314,0.433,33,85,0.388,103,229,0.45,74,93,0.796,20,109,129,164,32,8,73,66,379,0.8,0.6,1.4,2015
Festus Ezeli,C,26,46,770,125,228,0.548,0,0,0.0,125,228,0.548,70,132,0.53,91,166,257,32,18,50,38,94,320,1.4,1.3,2.7,2015
Kenneth Faried,PF,26,67,1694,349,626,0.558,1,2,0.5,348,624,0.558,136,222,0.613,235,346,581,79,32,60,91,169,835,4.0,1.5,5.5,2015
Jordan Farmar,PG,29,12,291,42,100,0.42,16,45,0.356,26,55,0.473,10,10,1.0,4,21,25,37,15,2,18,22,110,0.2,0.2,0.4,2015
Derrick Favors,PF,24,62,1983,418,811,0.515,0,4,0.0,418,807,0.518,180,254,0.709,169,334,503,94,74,91,104,150,1016,3.8,3.4,7.1,2015
Cristiano Felício,C,23,31,321,40,72,0.556,0,4,0.0,40,68,0.588,25,35,0.714,30,72,102,26,6,13,13,31,105,0.7,0.4,1.2,2015
Raymond Felton,PG,31,80,2192,277,682,0.406,60,213,0.282,217,469,0.463,149,176,0.847,36,222,258,284,68,15,121,141,763,1.0,1.7,2.7,2015
Evan Fournier,SF,23,79,2566,429,929,0.462,156,390,0.4,273,539,0.506,199,238,0.836,33,192,225,213,96,2,133,214,1213,4.0,1.7,5.7,2015
Randy Foye,SG,32,81,1642,169,482,0.351,75,250,0.3,94,232,0.405,61,74,0.824,24,132,156,161,39,29,86,131,474,-0.4,0.9,0.4,2015
Tim Frazier,PG,25,51,741,96,229,0.419,16,48,0.333,80,181,0.442,53,74,0.716,26,84,110,162,33,2,65,73,261,0.4,0.5,1.0,2015
Jimmer Fredette,SG,26,6,18,2,5,0.4,1,2,0.5,1,3,0.333,4,5,0.8,0,0,0,1,1,0,2,2,9,0.0,0.0,0.0,2015
Enes Freedom,C,23,82,1721,414,719,0.576,10,21,0.476,404,698,0.579,200,251,0.797,249,415,664,33,26,33,115,166,1038,6.0,2.1,8.1,2015
Channing Frye,PF,32,70,1200,152,347,0.438,91,235,0.387,61,112,0.545,30,35,0.857,35,199,234,71,29,28,43,127,425,1.6,1.3,3.0,2015
Danilo Gallinari,SF,27,53,1839,287,700,0.41,87,239,0.364,200,461,0.434,375,432,0.868,52,229,281,135,42,19,77,87,1036,5.5,0.9,6.3,2015
Langston Galloway,PG,24,82,2033,231,588,0.393,77,224,0.344,154,364,0.423,86,114,0.754,43,245,288,207,77,22,61,177,625,1.4,1.8,3.3,2015
Kevin Garnett*,PF,39,38,556,54,115,0.47,0,1,0.0,54,114,0.474,14,21,0.667,15,135,150,62,28,10,16,70,122,0.4,0.7,1.1,2015
Marc Gasol,C,31,52,1791,328,707,0.464,2,3,0.667,326,704,0.463,203,245,0.829,58,304,362,196,50,70,118,141,861,1.8,1.9,3.7,2015
Pau Gasol*,C,35,72,2291,467,995,0.469,24,69,0.348,443,926,0.478,229,289,0.792,155,638,793,294,42,146,164,148,1187,3.2,3.9,7.1,2015
Rudy Gay,SF,29,70,2379,466,1007,0.463,74,215,0.344,392,792,0.495,198,254,0.78,103,353,456,120,100,51,139,184,1204,1.8,2.1,3.8,2015
Alonzo Gee,SF,28,73,1632,132,255,0.518,17,60,0.283,115,195,0.59,44,66,0.667,60,185,245,72,63,13,55,169,325,1.0,0.9,1.9,2015
Paul George,SF,25,81,2819,605,1449,0.418,210,566,0.371,395,883,0.447,454,528,0.86,79,484,563,329,152,29,265,230,1874,4.4,4.8,9.2,2015
Taj Gibson,PF,30,73,1936,263,500,0.526,0,3,0.0,263,497,0.529,101,146,0.692,206,298,504,106,47,77,78,180,627,3.2,2.2,5.4,2015
Manu Ginóbili*,SG,38,58,1134,197,435,0.453,70,179,0.391,127,256,0.496,91,112,0.813,26,120,146,177,66,11,99,99,555,1.5,2.3,3.8,2015
Rudy Gobert,C,23,61,1932,198,354,0.559,0,0,0.0,198,354,0.559,161,283,0.569,208,460,668,91,45,135,114,163,557,2.6,3.8,6.4,2015
Drew Gooden,PF,34,30,305,33,103,0.32,7,41,0.171,26,62,0.419,9,14,0.643,28,57,85,13,8,11,13,40,82,-0.4,0.4,0.0,2015
Archie Goodwin,PG,21,57,1114,176,422,0.417,23,99,0.232,153,323,0.474,130,193,0.674,27,115,142,118,27,13,100,84,505,-0.4,0.5,0.1,2015
Aaron Gordon,PF,20,78,1863,274,579,0.473,42,142,0.296,232,437,0.531,129,193,0.668,154,353,507,128,59,55,66,153,719,3.2,2.2,5.4,2015
Eric Gordon,SG,27,45,1481,231,552,0.418,113,294,0.384,118,258,0.457,111,125,0.888,10,89,99,121,43,14,73,98,686,1.7,0.4,2.1,2015
Marcin Gortat,C,31,75,2256,433,764,0.567,0,1,0.0,433,763,0.567,146,207,0.705,222,519,741,106,47,96,121,193,1012,4.2,3.1,7.3,2015
Andrew Goudelock,PG,27,8,50,9,20,0.45,1,9,0.111,8,11,0.727,3,4,0.75,1,1,2,4,6,2,7,4,22,-0.1,0.1,0.0,2015
Jerami Grant,PF,21,77,2066,251,599,0.419,35,146,0.24,216,453,0.477,212,322,0.658,99,262,361,135,54,127,110,215,749,0.5,1.6,2.1,2015
Jerian Grant,PG,23,76,1265,154,391,0.394,22,100,0.22,132,291,0.454,96,123,0.78,23,120,143,177,50,10,87,97,426,-0.2,1.0,0.8,2015
Danny Green,SG,28,79,2062,211,561,0.376,116,349,0.332,95,212,0.448,34,46,0.739,48,255,303,141,79,64,75,141,572,0.2,4.1,4.2,2015
Draymond Green,PF,25,81,2808,401,819,0.49,100,258,0.388,301,561,0.537,229,329,0.696,134,635,769,598,119,113,259,240,1131,6.0,5.1,11.1,2015
Erick Green,PG,24,9,42,5,13,0.385,1,5,0.2,4,8,0.5,2,2,1.0,3,3,6,3,1,0,0,4,13,0.1,0.0,0.1,2015
Gerald Green,SG,30,69,1557,230,587,0.392,84,260,0.323,146,327,0.446,72,92,0.783,25,138,163,56,38,19,46,123,616,0.3,1.4,1.7,2015
JaMychal Green,PF,25,78,1446,230,495,0.465,15,45,0.333,215,450,0.478,103,137,0.752,139,234,373,67,46,33,83,189,578,1.2,1.4,2.6,2015
Jeff Green,SF,29,80,2253,354,824,0.43,67,213,0.315,287,611,0.47,164,220,0.745,74,258,332,138,58,40,93,164,939,1.3,1.7,3.1,2015
Blake Griffin,PF,26,35,1170,301,603,0.499,6,18,0.333,295,585,0.504,141,194,0.727,51,243,294,170,28,17,83,95,749,2.2,1.6,3.8,2015
Jorge Gutiérrez,PG,27,12,63,6,11,0.545,0,2,0.0,6,9,0.667,10,11,0.909,0,7,7,17,3,0,6,3,22,0.2,0.1,0.3,2015
P.J. Hairston,SF,23,66,1313,145,408,0.355,70,241,0.29,75,167,0.449,50,64,0.781,25,149,174,38,32,11,41,137,410,-0.6,1.1,0.6,2015
Jordan Hamilton,SF,25,11,304,49,116,0.422,13,45,0.289,36,71,0.507,14,21,0.667,12,50,62,25,8,3,17,24,125,0.0,0.2,0.2,2015
Tyler Hansbrough,PF,30,44,343,32,71,0.451,2,3,0.667,30,68,0.441,38,65,0.585,40,49,89,8,12,7,12,55,104,0.5,0.5,1.0,2015
Tim Hardaway Jr.,SG,23,51,864,114,265,0.43,48,142,0.338,66,123,0.537,50,56,0.893,7,79,86,51,21,7,23,48,326,0.9,1.0,1.9,2015
James Harden,SG,26,82,3125,710,1617,0.439,236,657,0.359,474,960,0.494,720,837,0.86,63,438,501,612,139,51,374,229,2376,10.7,2.6,13.3,2015
Maurice Harkless,SF,22,78,1457,195,411,0.474,39,140,0.279,156,271,0.576,69,111,0.622,101,179,280,67,49,35,62,124,498,1.6,1.3,2.9,2015
Justin Harper,PF,26,5,35,4,10,0.4,4,9,0.444,0,1,0.0,1,2,0.5,0,1,1,0,1,0,2,3,13,0.0,0.0,0.0,2015
Montrezl Harrell,PF,22,39,379,58,90,0.644,0,1,0.0,58,89,0.652,24,46,0.522,25,40,65,17,11,11,17,48,140,0.7,0.2,0.9,2015
Devin Harris,PG,32,64,1280,167,374,0.447,52,158,0.329,115,216,0.532,101,140,0.721,18,120,138,118,60,13,66,124,487,1.2,1.3,2.5,2015
Gary Harris,SG,21,76,2439,359,765,0.469,105,297,0.354,254,468,0.543,109,133,0.82,54,166,220,147,97,18,98,143,932,2.8,1.2,4.0,2015
Joe Harris,SG,24,5,15,1,4,0.25,1,4,0.25,0,0,0.0,0,0,0.0,0,3,3,2,0,0,1,1,3,0.0,0.0,0.0,2015
Tobias Harris,PF,23,76,2513,417,889,0.469,80,239,0.335,337,650,0.518,202,243,0.831,96,414,510,169,65,40,108,153,1116,4.1,2.5,6.6,2015
Aaron Harrison,SG,21,21,93,5,19,0.263,3,10,0.3,2,9,0.222,5,12,0.417,4,11,15,2,6,0,4,10,18,-0.2,0.1,0.0,2015
Udonis Haslem,PF,35,37,260,23,61,0.377,1,9,0.111,22,52,0.423,12,16,0.75,10,65,75,14,5,2,5,25,59,0.0,0.4,0.4,2015
Spencer Hawes,PF,27,57,1035,124,306,0.405,38,102,0.373,86,204,0.422,54,65,0.831,51,193,244,109,22,27,58,111,340,0.6,1.4,1.9,2015
Chuck Hayes,C,32,2,24,1,2,0.5,0,0,0.0,1,2,0.5,2,2,1.0,0,8,8,2,0,0,3,6,4,0.0,0.0,0.0,2015
Gordon Hayward,SF,25,80,2893,521,1202,0.433,143,410,0.349,378,792,0.477,393,477,0.824,61,336,397,296,95,27,202,183,1578,5.5,3.4,8.9,2015
Gerald Henderson,SG,28,72,1431,232,529,0.439,48,136,0.353,184,393,0.468,112,146,0.767,30,181,211,75,39,19,68,87,624,1.0,1.0,2.0,2015
John Henson,C,25,57,960,164,291,0.564,0,1,0.0,164,290,0.566,69,117,0.59,87,134,221,54,18,109,64,131,397,1.2,1.1,2.3,2015
Mario Hezonja,SF,20,79,1413,181,418,0.433,67,192,0.349,114,226,0.504,49,54,0.907,28,148,176,109,39,17,97,124,478,-0.1,1.0,0.9,2015
Roy Hibbert,C,29,81,1878,182,411,0.443,0,2,0.0,182,409,0.445,117,145,0.807,132,266,398,95,32,110,76,252,481,1.1,1.0,2.2,2015
J.J. Hickson,C,27,35,436,80,155,0.516,0,1,0.0,80,154,0.519,46,103,0.447,39,93,132,23,15,14,25,47,206,0.3,0.5,0.8,2015
Nenê,PF,33,57,1094,209,384,0.544,0,3,0.0,209,381,0.549,107,185,0.578,52,207,259,97,54,26,76,156,525,1.1,1.6,2.7,2015
George Hill,PG,29,74,2524,326,739,0.441,128,314,0.408,198,425,0.466,114,150,0.76,58,240,298,259,83,17,101,149,894,3.4,2.8,6.2,2015
Jordan Hill,C,28,73,1513,278,549,0.506,0,1,0.0,278,548,0.507,89,125,0.712,156,295,451,87,36,37,92,155,645,1.6,2.3,3.9,2015
Solomon Hill,SF,24,59,866,93,208,0.447,24,74,0.324,69,134,0.515,36,42,0.857,39,127,166,57,37,11,33,68,246,0.8,1.3,2.1,2015
Darrun Hilliard,SG,22,38,383,52,131,0.397,19,50,0.38,33,81,0.407,29,40,0.725,5,40,45,27,9,1,19,28,152,0.2,0.3,0.5,2015
Kirk Hinrich,PG,35,46,631,49,129,0.38,24,62,0.387,25,67,0.373,15,16,0.938,8,62,70,73,15,2,30,64,137,0.1,0.5,0.6,2015
Jrue Holiday,PG,25,65,1831,410,935,0.439,87,259,0.336,323,676,0.478,182,216,0.843,27,168,195,391,88,22,167,148,1089,2.2,1.2,3.4,2015
Justin Holiday,SG,26,53,773,88,228,0.386,36,105,0.343,52,123,0.423,27,37,0.73,12,78,90,56,32,19,39,61,239,-0.3,0.9,0.6,2015
Ryan Hollins,C,31,37,460,49,79,0.62,0,0,0.0,49,79,0.62,26,42,0.619,47,51,98,10,6,21,24,62,124,0.6,0.3,1.0,2015
Rondae Hollis-Jefferson,SF,21,29,615,63,138,0.457,4,14,0.286,59,124,0.476,37,52,0.712,39,115,154,43,39,16,26,61,167,0.5,0.7,1.2,2015
Richaun Holmes,PF,22,51,702,114,222,0.514,8,44,0.182,106,178,0.596,51,74,0.689,62,73,135,33,19,40,32,92,287,1.0,0.5,1.5,2015
Rodney Hood,SG,23,79,2541,408,972,0.42,161,449,0.359,247,523,0.472,172,200,0.86,38,229,267,213,73,16,125,202,1149,3.4,2.5,6.0,2015
Al Horford,C,29,82,2631,529,1048,0.505,88,256,0.344,441,792,0.557,103,129,0.798,148,448,596,263,68,121,107,163,1249,4.9,4.5,9.4,2015
Dwight Howard,C,30,71,2280,372,600,0.62,0,6,0.0,372,594,0.626,232,474,0.489,238,597,835,98,69,113,166,219,976,3.5,3.1,6.6,2015
Marcelo Huertas,PG,32,53,869,97,230,0.422,16,61,0.262,81,169,0.479,27,29,0.931,18,72,90,182,26,7,80,76,237,-0.2,0.1,-0.1,2015
Josh Huestis,PF,24,5,55,5,12,0.417,4,6,0.667,1,6,0.167,0,4,0.0,2,8,10,0,1,2,3,3,14,0.0,0.1,0.0,2015
Kris Humphries,PF,30,53,835,121,295,0.41,34,108,0.315,87,187,0.465,67,84,0.798,57,161,218,36,16,23,38,94,343,0.5,1.1,1.6,2015
R.J. Hunter,SG,22,36,315,36,98,0.367,19,63,0.302,17,35,0.486,6,7,0.857,2,35,37,13,14,4,11,29,97,-0.1,0.4,0.3,2015
Serge Ibaka,PF,26,78,2500,416,869,0.479,60,184,0.326,356,685,0.52,91,121,0.752,141,392,533,66,38,148,108,211,983,2.5,3.0,5.5,2015
Andre Iguodala,SF,32,65,1732,176,368,0.478,54,154,0.351,122,214,0.57,51,83,0.614,52,211,263,219,73,19,79,102,457,2.3,2.1,4.4,2015
Ersan İlyasova,PF,28,74,1881,280,661,0.424,96,259,0.371,184,402,0.458,111,154,0.721,144,259,403,67,52,33,71,171,767,2.4,2.0,4.4,2015
Joe Ingles,SF,28,81,1241,124,291,0.426,81,210,0.386,43,81,0.531,13,18,0.722,19,132,151,96,55,4,65,98,342,0.7,1.6,2.3,2015
Damien Inglis,SF,20,20,156,13,37,0.351,3,13,0.231,10,24,0.417,7,8,0.875,2,29,31,10,6,3,11,11,36,-0.2,0.2,-0.1,2015
Kyrie Irving,PG,23,53,1667,394,879,0.448,84,262,0.321,310,617,0.502,169,191,0.885,44,113,157,249,56,18,124,107,1041,3.2,1.7,5.0,2015
Jarrett Jack,PG,32,32,1027,140,358,0.391,31,102,0.304,109,256,0.426,100,112,0.893,9,127,136,236,34,7,94,77,411,0.5,0.4,0.9,2015
Reggie Jackson,PG,25,79,2424,540,1244,0.434,118,334,0.353,422,910,0.464,291,337,0.864,58,195,253,492,59,11,223,187,1489,4.9,1.9,6.9,2015
LeBron James,SF,31,76,2709,737,1416,0.52,87,282,0.309,650,1134,0.573,359,491,0.731,111,454,565,514,104,49,249,143,1920,9.6,4.0,13.6,2015
Al Jefferson,C,31,47,1096,245,505,0.485,0,0,0.0,245,505,0.485,72,111,0.649,57,244,301,70,30,41,34,117,562,1.0,1.8,2.8,2015
Cory Jefferson,PF,25,8,50,9,22,0.409,0,1,0.0,9,21,0.429,4,6,0.667,6,10,16,0,0,1,0,8,22,0.0,0.0,0.1,2015
Richard Jefferson,SF,35,74,1326,143,312,0.458,66,173,0.382,77,139,0.554,58,87,0.667,15,113,128,59,33,14,43,129,410,1.4,1.3,2.7,2015
John Jenkins,SG,24,43,480,71,160,0.444,16,51,0.314,55,109,0.505,20,24,0.833,8,49,57,35,8,1,27,22,178,0.0,0.2,0.2,2015
Brandon Jennings,PG,26,48,868,112,304,0.368,51,155,0.329,61,149,0.409,57,78,0.731,16,80,96,170,29,7,57,57,332,0.8,0.7,1.5,2015
Jonas Jerebko,PF,28,78,1176,118,286,0.413,43,108,0.398,75,178,0.421,61,78,0.782,77,211,288,62,20,24,52,137,340,0.9,1.5,2.4,2015
Amir Johnson,PF,28,79,1800,249,426,0.585,10,43,0.233,239,383,0.624,69,121,0.57,178,327,505,138,52,83,94,214,577,3.0,2.9,5.9,2015
Chris Johnson,SF,25,70,857,72,194,0.371,27,99,0.273,45,95,0.474,34,42,0.81,27,105,132,45,32,20,40,100,205,-0.1,1.2,1.1,2015
James Johnson,PF,28,57,926,114,240,0.475,20,66,0.303,94,174,0.54,39,68,0.574,28,98,126,67,29,33,54,84,287,0.3,1.0,1.3,2015
Joe Johnson,SF,34,81,2703,377,859,0.439,120,313,0.383,257,546,0.471,118,142,0.831,49,243,292,318,61,4,159,146,992,1.9,0.8,2.7,2015
Orlando Johnson,SG,26,7,101,9,34,0.265,2,10,0.2,7,24,0.292,6,8,0.75,4,11,15,2,3,3,4,9,26,-0.2,0.1,-0.2,2015
Stanley Johnson,SF,19,73,1687,225,600,0.375,63,205,0.307,162,395,0.41,80,102,0.784,58,248,306,118,55,12,114,178,593,-1.3,1.9,0.6,2015
Tyler Johnson,SG,23,36,863,118,243,0.486,27,71,0.38,91,172,0.529,51,64,0.797,28,81,109,79,24,14,47,66,314,1.2,0.9,2.0,2015
Wesley Johnson,SF,28,80,1666,208,515,0.404,103,309,0.333,105,206,0.51,30,46,0.652,37,211,248,49,89,56,54,173,549,0.0,2.7,2.6,2015
Nikola Jokić,C,20,80,1733,307,600,0.512,28,84,0.333,279,516,0.541,154,190,0.811,181,379,560,189,79,50,104,208,796,4.5,2.2,6.7,2015
Dahntay Jones,SF,35,1,42,6,14,0.429,1,2,0.5,5,12,0.417,0,0,0.0,1,4,5,2,1,2,0,6,13,0.0,0.1,0.1,2015
James Jones,SF,35,48,463,58,142,0.408,41,104,0.394,17,38,0.447,21,26,0.808,8,42,50,14,11,10,13,50,178,0.7,0.5,1.2,2015
Terrence Jones,PF,24,50,1044,166,367,0.452,25,79,0.316,141,288,0.49,77,116,0.664,62,149,211,41,23,39,49,86,434,0.8,0.7,1.5,2015
Tyus Jones,PG,19,37,573,56,156,0.359,16,53,0.302,40,103,0.388,28,39,0.718,7,40,47,108,31,3,33,33,156,0.0,0.3,0.3,2015
DeAndre Jordan,C,27,77,2598,357,508,0.703,0,1,0.0,357,507,0.704,266,619,0.43,267,792,1059,90,51,177,107,207,980,6.0,5.5,11.5,2015
Cory Joseph,SG,24,80,2046,257,585,0.439,30,110,0.273,227,475,0.478,133,174,0.764,39,171,210,250,63,20,102,131,677,1.8,1.7,3.5,2015
Chris Kaman,C,33,16,112,20,43,0.465,1,4,0.25,19,39,0.487,3,3,1.0,7,17,24,11,1,1,8,15,44,0.0,0.1,0.1,2015
Frank Kaminsky,C,22,81,1708,215,525,0.41,68,202,0.337,147,323,0.455,108,148,0.73,69,266,335,98,38,43,58,126,606,1.2,2.1,3.3,2015
Sergey Karasev,SF,22,40,399,30,74,0.405,11,37,0.297,19,37,0.514,26,28,0.929,8,50,58,35,6,2,22,27,97,0.2,0.1,0.3,2015
Sasha Kaun,C,30,25,95,9,17,0.529,0,0,0.0,9,17,0.529,5,11,0.455,12,14,26,3,4,5,7,11,23,0.0,0.2,0.2,2015
Ryan Kelly,PF,24,36,470,55,149,0.369,5,37,0.135,50,112,0.446,37,54,0.685,21,100,121,20,13,10,18,39,152,-0.3,0.3,0.1,2015
Michael Kidd-Gilchrist,SF,22,7,205,33,61,0.541,3,7,0.429,30,54,0.556,20,29,0.69,12,33,45,9,3,3,8,9,89,0.4,0.2,0.6,2015
Sean Kilpatrick,SG,26,31,616,123,270,0.456,39,114,0.342,84,156,0.538,60,67,0.896,12,44,56,29,12,2,31,37,345,1.0,0.0,1.0,2015
Brandon Knight,SG,24,52,1870,371,895,0.415,120,351,0.342,251,544,0.461,156,183,0.852,36,166,202,263,61,20,177,124,1018,0.7,0.9,1.7,2015
Kyle Korver,SG,34,80,2401,268,616,0.435,158,397,0.398,110,219,0.502,45,54,0.833,14,246,260,164,60,35,98,161,739,1.2,2.9,4.1,2015
Kosta Koufos,C,26,78,1482,236,444,0.532,0,0,0.0,236,444,0.532,57,104,0.548,169,254,423,33,40,70,48,185,529,2.1,1.4,3.5,2015
Jeremy Lamb,SG,23,66,1227,230,510,0.451,56,181,0.309,174,329,0.529,64,88,0.727,44,208,252,77,42,30,50,105,580,1.0,1.8,2.7,2015
Carl Landry,PF,32,36,569,139,250,0.556,6,13,0.462,133,237,0.561,67,91,0.736,49,97,146,32,12,9,22,69,351,1.8,0.3,2.1,2015
Shane Larkin,PG,23,78,1751,222,502,0.442,39,108,0.361,183,394,0.464,83,107,0.776,28,152,180,342,95,12,146,121,566,0.5,1.0,1.4,2015
Joffrey Lauvergne,C,24,59,1041,195,380,0.513,13,53,0.245,182,327,0.557,62,69,0.899,77,213,290,56,13,15,54,115,465,1.6,0.7,2.3,2015
Zach LaVine,SG,20,82,2294,433,959,0.452,123,316,0.389,310,643,0.482,161,203,0.793,27,201,228,251,69,17,155,193,1150,1.9,0.7,2.6,2015
Ty Lawson,PG,28,66,1411,139,354,0.393,36,108,0.333,103,246,0.419,59,86,0.686,26,94,120,237,53,7,95,87,373,0.2,0.7,0.9,2015
Courtney Lee,SG,30,79,2334,290,639,0.454,82,217,0.378,208,422,0.493,99,118,0.839,29,176,205,136,85,28,72,134,761,2.1,1.7,3.9,2015
David Lee,PF,32,55,903,178,335,0.531,0,1,0.0,178,334,0.533,71,93,0.763,101,204,305,84,22,28,66,114,427,1.7,1.4,3.0,2015
Alex Len,C,22,78,1821,264,624,0.423,1,7,0.143,263,617,0.426,174,239,0.728,178,416,594,97,38,62,145,230,703,-0.5,1.8,1.3,2015
Kawhi Leonard,SF,24,72,2380,551,1090,0.506,129,291,0.443,422,799,0.528,292,334,0.874,95,398,493,186,128,71,105,133,1523,8.3,5.5,13.7,2015
Meyers Leonard,PF,23,61,1333,195,435,0.448,86,228,0.377,109,207,0.527,35,46,0.761,51,263,314,92,8,18,77,183,511,1.2,1.0,2.2,2015
Jon Leuer,PF,26,67,1255,224,466,0.481,42,110,0.382,182,356,0.511,77,101,0.762,76,297,373,72,38,30,75,125,567,1.4,1.3,2.7,2015
Damian Lillard,PG,25,75,2676,618,1474,0.419,229,610,0.375,389,864,0.45,414,464,0.892,45,257,302,512,65,28,242,165,1879,7.7,1.4,9.2,2015
Jeremy Lin,SG,27,78,2048,300,728,0.412,76,226,0.336,224,502,0.446,238,292,0.815,42,211,253,235,58,42,150,165,914,1.3,2.3,3.5,2015
Shaun Livingston,PG,30,78,1520,203,379,0.536,2,12,0.167,201,367,0.548,80,93,0.86,42,127,169,237,57,27,78,140,488,2.9,1.7,4.6,2015
Kevon Looney,PF,19,5,21,4,7,0.571,1,2,0.5,3,5,0.6,0,0,0.0,4,6,10,0,0,0,1,2,9,0.1,0.0,0.1,2015
Brook Lopez,C,27,73,2457,591,1157,0.511,2,14,0.143,589,1143,0.515,317,403,0.787,204,369,573,147,58,124,175,215,1501,4.5,1.7,6.2,2015
Robin Lopez,C,27,82,2219,357,662,0.539,0,1,0.0,357,661,0.54,128,161,0.795,268,334,602,114,16,129,133,182,842,3.7,2.1,5.8,2015
Kevin Love,PF,27,77,2424,409,977,0.419,158,439,0.36,251,538,0.467,258,314,0.822,149,613,762,186,58,41,142,159,1234,4.7,3.8,8.5,2015
Kyle Lowry,PG,29,77,2851,512,1198,0.427,212,547,0.388,300,651,0.461,398,491,0.811,55,310,365,494,158,34,225,211,1634,8.0,3.7,11.6,2015
Trey Lyles,PF,20,80,1382,191,436,0.438,49,128,0.383,142,308,0.461,57,82,0.695,59,240,299,59,26,18,65,114,488,0.6,1.7,2.3,2015
Shelvin Mack,PG,25,52,1058,182,415,0.439,39,125,0.312,143,290,0.493,45,61,0.738,13,115,128,187,34,3,95,72,448,0.2,1.2,1.3,2015
Ian Mahinmi,C,29,71,1816,264,448,0.589,0,0,0.0,264,448,0.589,132,225,0.587,138,369,507,104,65,75,100,220,660,2.9,3.3,6.2,2015
Devyn Marble,SG,23,28,249,21,71,0.296,8,32,0.25,13,39,0.333,10,24,0.417,6,32,38,12,13,1,7,25,60,-0.4,0.3,-0.1,2015
Boban Marjanović,C,27,54,508,105,174,0.603,0,0,0.0,105,174,0.603,87,114,0.763,73,121,194,21,12,23,29,54,297,2.3,1.2,3.4,2015
Kendall Marshall,PG,24,30,400,43,118,0.364,16,49,0.327,27,69,0.391,9,13,0.692,2,26,28,73,16,2,43,30,111,-0.7,0.1,-0.5,2015
Jarell Martin,PF,21,27,380,54,116,0.466,0,2,0.0,54,114,0.474,45,62,0.726,39,47,86,15,8,7,19,58,153,0.5,0.2,0.8,2015
Kevin Martin,SG,32,55,1095,156,419,0.372,49,136,0.36,107,283,0.378,153,172,0.89,14,96,110,58,26,3,54,83,514,0.7,0.5,1.2,2015
Wesley Matthews,SF,29,78,2644,331,854,0.388,189,525,0.36,142,329,0.432,126,146,0.863,27,211,238,151,78,17,78,179,977,1.9,1.8,3.7,2015
O.J. Mayo,SG,28,41,1090,119,321,0.371,52,162,0.321,67,159,0.421,31,40,0.775,13,92,105,118,48,8,72,126,321,-0.7,0.6,-0.1,2015
Luc Mbah a Moute,PF,29,75,1274,94,207,0.454,13,40,0.325,81,167,0.485,30,57,0.526,60,111,171,30,44,19,34,100,231,0.2,1.3,1.6,2015
James Michael McAdoo,PF,23,41,262,45,84,0.536,1,2,0.5,44,82,0.537,26,49,0.531,30,28,58,17,10,8,16,39,117,0.5,0.3,0.8,2015
Ray McCallum,PG,24,41,475,55,146,0.377,15,42,0.357,40,104,0.385,12,15,0.8,8,39,47,60,12,7,24,29,137,-0.2,0.5,0.3,2015
CJ McCollum,SG,24,80,2780,641,1431,0.448,197,472,0.417,444,959,0.463,187,226,0.827,47,212,259,341,97,23,196,187,1666,4.4,1.7,6.0,2015
T.J. McConnell,PG,23,81,1606,218,464,0.47,31,89,0.348,187,375,0.499,26,41,0.634,43,207,250,367,95,10,140,114,493,0.6,1.4,1.9,2015
Chris McCullough,PF,20,24,362,44,109,0.404,13,34,0.382,31,75,0.413,11,23,0.478,25,43,68,9,28,12,15,39,112,-0.1,0.4,0.3,2015
K.J. McDaniels,SF,22,37,235,29,72,0.403,7,25,0.28,22,47,0.468,24,30,0.8,16,26,42,10,7,6,17,30,89,0.1,0.1,0.2,2015
Doug McDermott,SF,24,81,1861,291,644,0.452,110,259,0.425,181,385,0.47,72,84,0.857,37,158,195,59,14,6,53,127,764,2.1,0.7,2.8,2015
Mitch McGary,PF,23,20,72,11,23,0.478,0,4,0.0,11,19,0.579,4,10,0.4,4,14,18,3,1,2,7,10,26,-0.1,0.1,0.0,2015
JaVale McGee,C,28,34,370,77,134,0.575,0,1,0.0,77,133,0.579,18,36,0.5,53,80,133,3,5,26,21,49,172,0.6,0.5,1.1,2015
Ben McLemore,SG,22,68,1443,195,455,0.429,67,185,0.362,128,270,0.474,74,103,0.718,34,114,148,79,52,10,99,140,531,-0.4,0.7,0.3,2015
Jordan McRae,PG,24,22,195,34,78,0.436,10,22,0.455,24,56,0.429,21,28,0.75,4,16,20,25,3,1,15,17,99,0.2,0.1,0.4,2015
Josh McRoberts,PF,28,42,595,55,148,0.372,12,49,0.245,43,99,0.434,28,40,0.7,22,83,105,81,18,7,30,68,150,0.1,0.7,0.8,2015
Jodie Meeks,SG,28,3,43,7,20,0.35,4,9,0.444,3,11,0.273,4,4,1.0,1,4,5,3,0,0,1,2,22,0.1,0.0,0.1,2015
Salah Mejri,C,29,34,397,49,78,0.628,0,1,0.0,49,77,0.636,27,46,0.587,41,82,123,10,8,36,23,54,125,0.6,0.7,1.3,2015
Jordan Mickey,PF,21,16,57,8,22,0.364,0,0,0.0,8,22,0.364,5,10,0.5,6,7,13,1,0,11,1,5,21,0.0,0.1,0.1,2015
Khris Middleton,SG,24,79,2852,507,1142,0.444,143,361,0.396,364,781,0.466,277,312,0.888,44,258,302,331,131,19,180,204,1434,4.3,1.8,6.1,2015
C.J. Miles,SF,28,64,1464,259,634,0.409,142,387,0.367,117,247,0.474,93,124,0.75,25,150,175,63,53,29,70,142,753,1.2,1.9,3.1,2015
Andre Miller,PG,39,39,461,59,106,0.557,2,8,0.25,57,98,0.582,24,32,0.75,12,39,51,87,16,0,37,46,144,0.6,0.4,1.0,2015
Mike Miller,SF,35,47,373,22,62,0.355,19,52,0.365,3,10,0.3,0,0,0.0,6,47,53,40,13,4,17,53,63,0.1,0.3,0.3,2015
Patty Mills,PG,27,81,1662,260,612,0.425,123,320,0.384,137,292,0.469,47,58,0.81,27,131,158,226,59,6,76,102,690,2.2,2.6,4.8,2015
Elijah Millsap,SG,28,20,173,11,39,0.282,1,12,0.083,10,27,0.37,13,18,0.722,6,29,35,19,7,3,9,33,36,-0.2,0.3,0.1,2015
Paul Millsap,PF,30,81,2647,501,1066,0.47,74,232,0.319,427,834,0.512,309,408,0.757,198,534,732,265,147,139,191,237,1385,4.1,6.0,10.1,2015
Nikola Mirotić,PF,24,66,1646,248,609,0.407,135,346,0.39,113,263,0.43,146,181,0.807,58,304,362,100,58,46,102,151,777,1.8,2.2,3.9,2015
Nazr Mohammed,C,38,5,19,3,5,0.6,0,0,0.0,3,5,0.6,2,2,1.0,1,3,4,0,0,0,3,4,8,0.0,0.0,0.0,2015
Greg Monroe,C,25,79,2314,491,941,0.522,0,1,0.0,491,940,0.522,228,308,0.74,218,478,696,178,72,67,129,163,1210,5.0,2.4,7.5,2015
Luis Montero,SG,22,12,42,5,19,0.263,1,9,0.111,4,10,0.4,3,4,0.75,0,4,4,1,0,0,4,1,14,-0.2,0.0,-0.2,2015
E'Twaun Moore,SG,26,59,1263,187,389,0.481,47,104,0.452,140,285,0.491,22,35,0.629,19,114,133,99,37,18,53,103,443,0.9,1.0,1.8,2015
Eric Moreland,PF,24,8,48,3,6,0.5,0,0,0.0,3,6,0.5,2,4,0.5,3,8,11,1,0,4,3,4,8,0.0,0.0,0.0,2015
Marcus Morris,SF,26,80,2856,410,945,0.434,108,298,0.362,302,647,0.467,203,271,0.749,91,313,404,201,67,23,140,170,1131,2.9,2.5,5.4,2015
Markieff Morris,PF,26,64,1629,305,718,0.425,47,155,0.303,258,563,0.458,108,147,0.735,73,279,352,124,58,34,135,184,765,-1.2,1.7,0.5,2015
Anthony Morrow,SG,30,68,926,136,333,0.408,79,204,0.387,57,129,0.442,29,39,0.744,10,52,62,24,22,5,17,64,380,1.4,0.5,1.9,2015
Donatas Motiejūnas,PF,25,37,547,90,205,0.439,16,57,0.281,74,148,0.5,34,53,0.642,37,72,109,41,17,5,44,69,230,0.0,0.3,0.3,2015
Timofey Mozgov,C,29,76,1326,203,359,0.565,1,7,0.143,202,352,0.574,68,95,0.716,110,227,337,33,22,57,71,159,475,1.8,1.9,3.7,2015
Emmanuel Mudiay,PG,19,68,2068,329,905,0.364,74,232,0.319,255,673,0.379,140,209,0.67,32,200,232,372,65,35,217,141,872,-3.3,1.2,-2.1,2015
Shabazz Muhammad,SF,23,82,1682,317,681,0.465,44,152,0.289,273,529,0.516,185,242,0.764,100,167,267,52,24,7,70,94,863,2.6,0.2,2.7,2015
Xavier Munford,SG,23,14,244,32,77,0.416,9,23,0.391,23,54,0.426,7,14,0.5,3,28,31,22,13,3,15,25,80,-0.2,0.2,0.1,2015
Mike Muscala,C,24,60,565,76,152,0.5,12,39,0.308,64,113,0.566,31,39,0.795,38,79,117,34,13,27,27,72,195,0.7,0.9,1.6,2015
Larry Nance Jr.,PF,23,63,1266,158,300,0.527,1,10,0.1,157,290,0.541,32,47,0.681,101,211,312,44,54,23,41,124,349,1.3,0.9,2.2,2015
Shabazz Napier,PG,24,55,600,68,201,0.338,34,104,0.327,34,97,0.351,33,45,0.733,9,46,55,97,23,1,46,38,203,-0.3,0.4,0.1,2015
Gary Neal,SG,31,40,807,151,325,0.465,41,100,0.41,110,225,0.489,47,55,0.855,11,72,83,47,20,1,29,55,390,0.9,0.5,1.4,2015
Jameer Nelson,PG,33,39,1036,113,307,0.368,43,144,0.299,70,163,0.429,30,35,0.857,19,96,115,190,25,5,66,100,299,0.1,0.4,0.5,2015
Raul Neto,PG,23,81,1499,180,418,0.431,64,162,0.395,116,256,0.453,52,70,0.743,17,103,120,174,62,2,109,122,476,0.2,1.6,1.8,2015
Andrew Nicholson,PF,26,56,823,146,310,0.471,41,114,0.36,105,196,0.536,51,65,0.785,34,167,201,25,10,22,41,69,384,0.8,0.8,1.6,2015
Joakim Noah,C,30,29,635,51,133,0.383,0,1,0.0,51,132,0.386,22,45,0.489,87,168,255,110,18,29,52,77,124,0.0,1.1,1.1,2015
Nerlens Noel,C,21,67,1965,306,587,0.521,1,2,0.5,305,585,0.521,134,227,0.59,154,388,542,122,118,100,158,192,747,0.3,2.8,3.0,2015
Lucas Nogueira,C,23,29,225,28,44,0.636,1,3,0.333,27,41,0.659,8,15,0.533,18,28,46,7,12,12,11,29,65,0.3,0.4,0.7,2015
Steve Novak,PF,32,10,44,8,18,0.444,7,15,0.467,1,3,0.333,1,1,1.0,0,5,5,0,0,0,1,3,24,0.1,0.0,0.1,2015
Dirk Nowitzki*,PF,37,75,2364,498,1112,0.448,126,342,0.368,372,770,0.483,250,280,0.893,52,437,489,132,52,52,84,161,1372,4.2,2.6,6.8,2015
Jusuf Nurkić,C,21,32,547,101,242,0.417,0,3,0.0,101,239,0.423,61,99,0.616,65,110,175,40,24,44,55,91,263,-0.5,0.9,0.4,2015
J.J. O'Brien,SF,23,2,6,0,1,0.0,0,0,0.0,0,1,0.0,0,0,0.0,0,1,1,0,1,0,0,1,0,0.0,0.0,0.0,2015
Johnny O'Bryant,PF,22,66,857,86,209,0.411,1,1,1.0,85,208,0.409,27,40,0.675,65,111,176,32,18,8,31,100,200,-0.2,0.4,0.3,2015
Kyle O'Quinn,PF,25,65,764,129,271,0.476,5,22,0.227,124,249,0.498,46,60,0.767,76,174,250,72,20,49,61,107,309,0.5,1.2,1.6,2015
Jahlil Okafor,C,20,53,1591,397,781,0.508,1,6,0.167,396,775,0.511,133,194,0.686,122,251,373,65,22,61,124,140,928,0.3,0.9,1.2,2015
Victor Oladipo,SG,23,72,2379,425,970,0.438,98,282,0.348,327,688,0.475,205,247,0.83,48,297,345,282,116,54,153,174,1153,2.2,2.7,4.9,2015
Kelly Olynyk,C,24,69,1395,253,556,0.455,85,210,0.405,168,346,0.486,96,128,0.75,72,209,281,105,52,33,74,163,687,2.1,2.0,4.1,2015
Kelly Oubre Jr.,SF,20,63,671,90,211,0.427,25,79,0.316,65,132,0.492,31,49,0.633,25,108,133,13,22,7,34,100,236,-0.3,0.7,0.4,2015
Zaza Pachulia,C,31,76,2004,219,470,0.466,0,3,0.0,219,467,0.469,212,276,0.768,249,469,718,128,64,22,119,181,650,3.4,2.7,6.0,2015
Kostas Papanikolaou,SF,25,26,294,24,66,0.364,10,32,0.313,14,34,0.412,9,14,0.643,8,32,40,16,13,5,21,24,67,-0.4,0.2,-0.1,2015
Jabari Parker,PF,20,76,2408,443,899,0.493,9,35,0.257,434,864,0.502,175,228,0.768,123,272,395,130,69,29,116,154,1070,2.4,1.2,3.6,2015
Tony Parker*,PG,33,72,1980,350,710,0.493,27,65,0.415,323,645,0.501,130,171,0.76,17,159,176,379,54,11,131,114,857,2.9,2.9,5.8,2015
Chandler Parsons,SF,27,61,1799,320,651,0.492,104,251,0.414,216,400,0.54,93,136,0.684,29,256,285,169,46,21,95,114,837,2.6,1.6,4.3,2015
Lamar Patterson,SG,24,35,395,28,80,0.35,12,49,0.245,16,31,0.516,16,22,0.727,4,46,50,39,9,2,23,45,84,-0.3,0.5,0.2,2015
Patrick Patterson,PF,26,79,2020,204,493,0.414,106,293,0.362,98,200,0.49,29,34,0.853,77,265,342,94,53,32,65,128,543,1.6,2.0,3.6,2015
Chris Paul,PG,30,74,2420,515,1114,0.462,122,329,0.371,393,785,0.501,294,328,0.896,39,271,310,738,152,13,194,185,1446,9.2,3.5,12.7,2015
Adreian Payne,PF,24,52,486,53,145,0.366,9,32,0.281,44,113,0.389,17,26,0.654,20,91,111,29,16,11,36,77,132,-0.9,0.4,-0.5,2015
Cameron Payne,PG,21,57,698,114,278,0.41,36,111,0.324,78,167,0.467,19,24,0.792,9,76,85,108,36,6,44,80,283,0.6,0.8,1.4,2015
Elfrid Payton,PG,21,73,2145,318,730,0.436,30,92,0.326,288,638,0.451,112,190,0.589,77,184,261,468,89,20,177,159,778,0.5,1.7,2.2,2015
Nikola Peković,C,30,12,156,19,50,0.38,0,0,0.0,19,50,0.38,16,20,0.8,7,14,21,11,1,0,9,22,54,-0.1,0.0,-0.1,2015
Kendrick Perkins,C,31,37,542,40,75,0.533,0,0,0.0,40,75,0.533,11,25,0.44,25,103,128,31,11,11,41,64,91,-0.4,0.4,-0.1,2015
Paul Pierce*,SF,38,68,1231,144,397,0.363,75,242,0.31,69,155,0.445,54,66,0.818,12,174,186,71,33,17,58,129,417,-0.6,1.4,0.9,2015
Tibor Pleiß,C,26,12,82,11,25,0.44,0,2,0.0,11,23,0.478,2,2,1.0,6,9,15,2,1,2,8,19,24,-0.2,0.1,-0.1,2015
Mason Plumlee,C,25,82,2084,267,517,0.516,0,4,0.0,267,513,0.52,215,335,0.642,201,427,628,226,68,85,154,253,749,3.4,2.7,6.1,2015
Miles Plumlee,C,27,61,870,140,233,0.601,0,0,0.0,140,233,0.601,34,59,0.576,94,138,232,16,21,50,40,73,314,1.4,0.8,2.2,2015
Otto Porter Jr.,SF,22,75,2276,339,717,0.473,98,267,0.367,241,450,0.536,95,126,0.754,97,294,391,120,105,32,70,163,871,3.0,2.7,5.6,2015
Bobby Portis,PF,20,62,1102,186,436,0.427,16,52,0.308,170,384,0.443,48,66,0.727,123,214,337,52,25,22,54,100,436,0.3,1.3,1.5,2015
Kristaps Porziņģis,PF,20,72,2047,373,886,0.421,81,243,0.333,292,643,0.454,201,240,0.838,132,394,526,94,53,134,121,205,1028,1.5,2.9,4.4,2015
Dwight Powell,PF,24,69,992,146,296,0.493,2,16,0.125,144,280,0.514,105,142,0.739,84,189,273,44,36,24,40,118,399,1.8,1.3,3.1,2015
Norman Powell,SG,22,49,725,97,229,0.424,36,89,0.404,61,140,0.436,43,53,0.811,16,95,111,47,29,10,32,59,273,0.7,0.9,1.6,2015
Phil Pressey,PG,24,23,283,30,78,0.385,4,18,0.222,26,60,0.433,13,25,0.52,3,28,31,75,18,4,33,28,77,-0.4,0.3,-0.1,2015
Ronnie Price,PG,32,62,1211,116,302,0.384,68,196,0.347,48,106,0.453,31,41,0.756,25,74,99,147,74,13,70,161,331,0.4,1.0,1.4,2015
Pablo Prigioni,PG,38,59,823,55,147,0.374,28,95,0.295,27,52,0.519,7,8,0.875,38,76,114,130,53,1,49,82,145,0.3,1.1,1.5,2015
Tayshaun Prince,SF,35,77,1462,102,229,0.445,4,23,0.174,98,206,0.476,13,19,0.684,32,115,147,73,36,13,27,62,221,0.1,0.3,0.4,2015
Julius Randle,PF,21,81,2286,358,835,0.429,10,36,0.278,348,799,0.436,193,270,0.715,172,657,829,144,53,29,149,242,919,-0.3,1.9,1.6,2015
Zach Randolph,PF,34,68,2016,431,907,0.475,6,26,0.231,425,881,0.482,172,216,0.796,179,350,529,142,43,13,105,146,1040,2.8,1.5,4.3,2015
JJ Redick,SG,31,75,2097,422,880,0.48,200,421,0.475,222,459,0.484,182,205,0.888,10,129,139,106,42,5,78,135,1226,5.3,1.4,6.7,2015
Willie Reed,C,25,39,426,76,133,0.571,0,0,0.0,76,133,0.571,30,55,0.545,49,73,122,10,6,30,16,47,182,0.9,0.3,1.2,2015
Josh Richardson,SG,22,52,1107,123,272,0.452,53,115,0.461,70,157,0.446,42,63,0.667,21,86,107,73,36,25,35,107,341,1.3,1.2,2.5,2015
Austin Rivers,SG,23,67,1464,226,516,0.438,62,185,0.335,164,331,0.495,79,116,0.681,22,108,130,99,48,9,61,137,593,0.6,1.3,1.9,2015
Andre Roberson,SG,24,70,1553,136,274,0.496,32,103,0.311,104,171,0.608,33,54,0.611,79,172,251,47,53,42,35,133,337,1.8,1.6,3.4,2015
Brian Roberts,PG,30,51,470,74,165,0.448,15,42,0.357,59,123,0.48,42,47,0.894,6,35,41,54,10,2,23,35,205,0.7,0.3,1.0,2015
Glenn Robinson III,SF,22,45,508,65,151,0.43,14,37,0.378,51,114,0.447,27,39,0.692,12,56,68,26,17,9,18,21,171,0.2,0.6,0.8,2015
Nate Robinson,PG,31,2,23,0,1,0.0,0,1,0.0,0,0,0.0,0,0,0.0,0,0,0,4,1,0,0,5,0,0.0,0.0,0.0,2015
Thomas Robinson,PF,24,71,917,130,291,0.447,0,1,0.0,130,290,0.448,47,109,0.431,136,223,359,46,39,36,69,111,307,-0.5,1.1,0.6,2015
Rajon Rondo,PG,29,72,2537,355,782,0.454,62,170,0.365,293,612,0.479,87,150,0.58,77,358,435,839,141,10,278,175,859,2.3,2.3,4.6,2015
Derrick Rose,PG,27,66,2097,447,1048,0.427,44,150,0.293,403,898,0.449,142,179,0.793,46,179,225,311,44,14,175,84,1080,-0.8,1.2,0.4,2015
Terrence Ross,SF,24,73,1747,270,626,0.431,131,339,0.386,139,287,0.484,49,62,0.79,21,164,185,56,54,25,46,120,720,2.1,1.6,3.6,2015
Terry Rozier,PG,21,39,311,29,106,0.274,6,27,0.222,23,79,0.291,8,10,0.8,24,39,63,37,6,1,19,23,72,-0.6,0.3,-0.3,2015
Ricky Rubio,PG,25,76,2323,219,586,0.374,62,190,0.326,157,396,0.396,266,314,0.847,40,286,326,658,162,10,193,201,766,3.6,2.2,5.8,2015
Damjan Rudež,SF,29,33,277,25,62,0.403,17,50,0.34,8,12,0.667,8,8,1.0,5,15,20,11,3,1,13,33,75,0.1,0.0,0.1,2015
Brandon Rush,SG,30,72,1055,111,260,0.427,65,157,0.414,46,103,0.447,18,28,0.643,21,160,181,57,20,23,33,57,305,0.8,1.2,2.0,2015
D'Angelo Russell,PG,19,80,2259,392,956,0.41,130,370,0.351,262,586,0.447,140,190,0.737,47,227,274,266,93,13,196,142,1054,-0.7,0.7,0.0,2015
Robert Sacre,C,26,25,320,31,75,0.413,0,0,0.0,31,75,0.413,25,38,0.658,32,40,72,14,4,10,12,43,87,0.2,0.1,0.3,2015
JaKarr Sampson,SF,22,73,1160,140,317,0.442,14,63,0.222,126,254,0.496,80,122,0.656,46,144,190,46,23,33,70,142,374,-0.5,0.6,0.1,2015
Dennis Schröder,PG,22,80,1621,329,781,0.421,77,239,0.322,252,542,0.465,144,182,0.791,25,179,204,349,70,9,183,138,879,-0.2,2.3,2.2,2015
Luis Scola,PF,35,76,1636,269,598,0.45,65,161,0.404,204,437,0.467,61,84,0.726,84,276,360,66,46,27,68,178,664,1.4,1.9,3.3,2015
Mike Scott,PF,27,75,1146,176,376,0.468,62,158,0.392,114,218,0.523,50,63,0.794,53,153,206,78,25,17,42,102,464,1.7,1.5,3.2,2015
Thabo Sefolosha,SF,31,75,1758,188,372,0.505,42,124,0.339,146,248,0.589,62,99,0.626,52,282,334,107,85,37,68,109,480,1.3,3.2,4.5,2015
Kevin Séraphin,C,26,48,526,84,205,0.41,0,2,0.0,84,203,0.414,19,23,0.826,31,95,126,47,8,36,43,67,187,-0.8,0.7,-0.2,2015
Ramon Sessions,PG,29,82,1667,280,592,0.473,36,111,0.324,244,481,0.507,214,283,0.756,25,178,203,239,46,5,115,102,810,2.5,1.3,3.8,2015
Iman Shumpert,SG,25,54,1316,114,305,0.374,43,146,0.295,71,159,0.447,40,51,0.784,32,171,203,92,54,19,57,119,311,-0.1,1.8,1.7,2015
Jonathon Simmons,SG,26,55,813,122,242,0.504,18,47,0.383,104,195,0.533,69,92,0.75,16,80,96,58,24,5,53,103,331,0.7,1.3,2.0,2015
Henry Sims,C,25,14,263,33,77,0.429,0,0,0.0,33,77,0.429,25,30,0.833,21,51,72,9,9,14,12,37,91,0.2,0.3,0.4,2015
Kyle Singler,SF,27,68,977,86,221,0.389,30,97,0.309,56,124,0.452,29,44,0.659,50,91,141,24,30,9,32,120,231,0.3,0.8,1.1,2015
Donald Sloan,PG,28,61,1318,154,350,0.44,38,99,0.384,116,251,0.462,78,104,0.75,17,156,173,268,32,4,80,73,424,1.7,0.3,2.0,2015
Marcus Smart,PG,21,61,1667,184,529,0.348,61,241,0.253,123,288,0.427,129,166,0.777,76,179,255,185,91,18,80,183,558,0.5,2.4,2.9,2015
Greg Smith,PF,25,18,192,18,32,0.563,0,0,0.0,18,32,0.563,7,17,0.412,12,30,42,6,4,1,7,28,43,0.1,0.1,0.2,2015
Ish Smith,PG,27,77,2239,397,967,0.411,56,170,0.329,341,797,0.428,122,176,0.693,43,262,305,502,88,24,175,133,972,0.0,1.3,1.3,2015
J.R. Smith,SG,30,77,2362,353,850,0.415,204,510,0.4,149,340,0.438,45,71,0.634,43,174,217,130,81,21,59,204,955,3.0,2.5,5.5,2015
Jason Smith,C,29,76,1181,244,503,0.485,4,16,0.25,240,487,0.493,54,67,0.806,53,166,219,62,33,65,57,163,546,0.4,1.4,1.8,2015
Josh Smith,PF,30,55,880,127,349,0.364,41,143,0.287,86,206,0.417,37,67,0.552,51,141,192,90,34,47,77,118,332,-1.2,1.2,0.0,2015
Russ Smith,PG,24,15,66,7,22,0.318,1,5,0.2,6,17,0.353,8,13,0.615,1,8,9,11,5,1,7,5,23,-0.1,0.1,-0.1,2015
Tony Snell,SF,24,64,1301,126,339,0.372,56,155,0.361,70,184,0.38,30,33,0.909,19,180,199,63,16,17,52,100,338,-0.5,1.0,0.4,2015
Marreese Speights,C,28,72,832,197,456,0.432,24,62,0.387,173,394,0.439,94,114,0.825,77,162,239,61,19,34,66,117,512,0.5,1.2,1.8,2015
Tiago Splitter,C,31,36,579,81,155,0.523,0,2,0.0,81,153,0.529,39,48,0.813,45,75,120,30,20,12,24,71,201,0.9,0.9,1.7,2015
Nik Stauskas,SG,22,73,1809,210,545,0.385,106,325,0.326,104,220,0.473,91,118,0.771,23,160,183,138,44,20,94,115,617,0.0,0.5,0.5,2015
Lance Stephenson,SF,25,69,1372,228,474,0.481,30,78,0.385,198,396,0.5,87,111,0.784,40,183,223,133,43,9,94,135,573,0.9,1.3,2.2,2015
Alex Stepheson,PF,28,8,73,9,27,0.333,0,0,0.0,9,27,0.333,4,12,0.333,19,9,28,2,1,5,0,12,22,0.0,0.1,0.1,2015
Jarnell Stokes,C,22,7,18,3,5,0.6,0,0,0.0,3,5,0.6,1,2,0.5,1,3,4,1,1,0,0,1,7,0.1,0.0,0.1,2015
Amar'e Stoudemire,C,33,52,762,125,221,0.566,0,0,0.0,125,221,0.566,50,67,0.746,65,157,222,27,18,41,47,92,300,1.1,1.3,2.4,2015
Rodney Stuckey,PG,29,58,1275,183,443,0.413,20,83,0.241,163,360,0.453,131,158,0.829,19,137,156,142,43,8,76,77,517,0.5,1.5,2.0,2015
Jared Sullinger,PF,23,81,1915,351,806,0.435,29,103,0.282,322,703,0.458,103,161,0.64,194,479,673,187,75,47,102,209,834,1.3,3.6,4.8,2015
Edy Tavares,C,23,11,73,11,19,0.579,0,0,0.0,11,19,0.579,3,8,0.375,7,14,21,3,1,6,5,8,25,0.0,0.1,0.2,2015
Jeff Teague,PG,27,79,2255,434,988,0.439,110,275,0.4,324,713,0.454,261,312,0.837,33,181,214,470,97,24,218,167,1239,2.8,3.0,5.9,2015
Mirza Teletović,PF,30,79,1686,332,777,0.427,181,460,0.393,151,317,0.476,120,155,0.774,55,247,302,89,32,21,84,159,965,2.9,0.9,3.8,2015
Garrett Temple,SF,29,80,1951,201,505,0.398,89,258,0.345,112,247,0.453,91,125,0.728,36,176,212,140,69,18,64,195,582,1.0,1.7,2.7,2015
Jason Terry,SG,38,72,1258,151,376,0.402,93,261,0.356,58,115,0.504,27,33,0.818,14,65,79,103,47,9,49,91,422,1.1,0.4,1.5,2015
Isaiah Thomas,PG,26,82,2644,591,1382,0.428,167,465,0.359,424,917,0.462,474,544,0.871,46,197,243,509,91,9,220,167,1823,7.2,2.5,9.7,2015
Lance Thomas,PF,27,59,1313,169,382,0.442,44,109,0.404,125,273,0.458,102,119,0.857,34,97,131,53,22,7,57,109,484,1.2,0.5,1.7,2015
Hollis Thompson,SG,24,77,2154,270,680,0.397,149,392,0.38,121,288,0.42,69,96,0.719,54,218,272,99,36,24,76,187,758,0.7,0.5,1.2,2015
Jason Thompson,C,29,47,471,52,108,0.481,5,15,0.333,47,93,0.505,38,54,0.704,32,102,134,29,12,20,15,80,147,0.9,0.7,1.6,2015
Klay Thompson,SG,25,80,2666,651,1386,0.47,276,650,0.425,375,736,0.51,193,221,0.873,35,271,306,166,60,49,138,152,1771,5.5,2.6,8.0,2015
Tristan Thompson,PF,24,82,2269,247,420,0.588,0,0,0.0,247,420,0.588,149,242,0.616,268,470,738,62,38,51,61,202,643,5.6,3.1,8.7,2015
Marcus Thornton,SG,28,61,1109,216,542,0.399,91,270,0.337,125,272,0.46,67,79,0.848,38,112,150,85,47,4,51,90,590,1.0,0.7,1.7,2015
Anthony Tolliver,PF,30,72,1341,128,332,0.386,98,272,0.36,30,60,0.5,29,47,0.617,39,190,229,52,26,16,28,86,383,1.5,1.3,2.8,2015
Axel Toupane,SF,23,21,305,25,70,0.357,13,40,0.325,12,30,0.4,13,17,0.765,8,23,31,15,7,6,6,40,76,0.2,0.1,0.3,2015
Karl-Anthony Towns,C,20,82,2627,625,1153,0.542,30,88,0.341,595,1065,0.559,223,275,0.811,229,629,858,161,58,138,183,245,1503,5.5,2.8,8.3,2015
P.J. Tucker,SF,30,82,2540,239,582,0.411,68,206,0.33,171,376,0.455,106,142,0.746,165,347,512,177,106,20,111,202,652,1.5,1.9,3.5,2015
Evan Turner,SG,27,81,2271,343,753,0.456,20,83,0.241,323,670,0.482,148,179,0.827,50,347,397,359,80,28,169,139,854,1.0,3.0,4.0,2015
Myles Turner,C,19,60,1367,264,530,0.498,3,14,0.214,261,516,0.506,88,121,0.727,68,264,332,41,25,86,67,158,619,0.8,2.3,3.1,2015
Beno Udrih,PG,33,44,707,86,198,0.434,15,44,0.341,71,154,0.461,18,20,0.9,8,64,72,116,14,1,53,51,205,-0.1,0.5,0.4,2015
Jonas Valančiūnas,C,23,60,1557,303,536,0.565,0,0,0.0,303,536,0.565,162,213,0.761,184,363,547,42,25,80,85,158,768,4.5,2.4,6.9,2015
Anderson Varejão,C,33,53,496,53,124,0.427,0,1,0.0,53,123,0.431,32,50,0.64,37,104,141,35,16,10,22,70,138,0.3,0.8,1.0,2015
Greivis Vásquez,PG,29,23,460,45,138,0.326,18,73,0.247,27,65,0.415,22,26,0.846,5,42,47,91,10,0,40,42,130,-0.4,0.1,-0.3,2015
Rashad Vaughn,SG,19,70,1001,81,266,0.305,43,147,0.293,38,119,0.319,12,15,0.8,11,77,88,39,29,16,28,73,217,-1.2,0.4,-0.8,2015
Charlie Villanueva,PF,31,62,665,125,327,0.382,47,172,0.273,78,155,0.503,22,24,0.917,24,128,152,24,18,15,31,71,319,-0.6,0.8,0.2,2015
Noah Vonleh,PF,20,78,1174,117,278,0.421,11,46,0.239,106,232,0.457,38,51,0.745,91,214,305,30,27,26,50,152,283,0.0,1.1,1.2,2015
Nikola Vučević,C,25,65,2037,533,1046,0.51,2,9,0.222,531,1037,0.512,113,150,0.753,174,402,576,179,53,70,123,173,1181,2.8,2.4,5.2,2015
Sasha Vujačić,SG,31,61,908,106,277,0.383,52,143,0.364,54,134,0.403,32,39,0.821,26,123,149,84,34,5,44,83,296,0.3,0.8,1.1,2015
Dwyane Wade*,SG,34,74,2258,540,1183,0.456,7,44,0.159,533,1139,0.468,322,406,0.793,82,220,302,344,79,42,203,116,1409,2.4,2.6,4.9,2015
Dion Waiters,SG,24,78,2152,282,706,0.399,86,240,0.358,196,466,0.421,112,157,0.713,36,166,202,154,81,15,120,143,762,0.3,1.8,2.1,2015
Kemba Walker,PG,25,81,2885,568,1331,0.427,182,490,0.371,386,841,0.459,371,438,0.847,56,301,357,421,126,39,171,111,1689,6.3,3.6,9.9,2015
John Wall,PG,25,77,2784,572,1349,0.424,115,328,0.351,457,1021,0.448,272,344,0.791,42,337,379,789,145,59,318,159,1531,2.2,3.5,5.7,2015
T.J. Warren,SF,22,47,1070,221,441,0.501,28,70,0.4,193,371,0.52,45,64,0.703,57,90,147,44,37,16,32,94,515,1.7,0.6,2.2,2015
C.J. Watson,PG,31,33,656,47,137,0.343,14,48,0.292,33,89,0.371,34,39,0.872,10,56,66,88,19,5,25,49,142,0.2,0.4,0.6,2015
Briante Weber,PG,23,7,169,14,39,0.359,0,5,0.0,14,34,0.412,3,4,0.75,8,17,25,21,9,3,9,12,31,-0.2,0.2,0.0,2015
Sonny Weems,SG,29,43,499,42,110,0.382,15,41,0.366,27,69,0.391,8,15,0.533,7,46,53,49,10,1,41,47,107,-0.7,0.1,-0.5,2015
David West,PF,35,78,1404,244,448,0.545,3,7,0.429,241,441,0.546,63,80,0.788,72,237,309,143,44,55,68,142,554,2.4,2.9,5.4,2015
Russell Westbrook,PG,27,80,2750,656,1444,0.454,101,341,0.296,555,1103,0.503,465,573,0.812,145,481,626,834,163,20,342,200,1878,10.0,4.0,14.0,2015
Hassan Whiteside,C,26,73,2125,413,682,0.606,0,0,0.0,413,682,0.606,214,329,0.65,238,627,865,30,44,269,137,201,1040,5.0,5.3,10.3,2015
Shayne Whittington,PF,24,7,41,5,11,0.455,0,2,0.0,5,9,0.556,1,2,0.5,5,7,12,3,1,1,5,7,11,-0.1,0.1,0.0,2015
Andrew Wiggins,SF,20,81,2845,594,1294,0.459,57,190,0.3,537,1104,0.486,430,565,0.761,105,186,291,164,78,46,182,165,1675,3.4,0.7,4.1,2015
C.J. Wilcox,SG,25,23,167,26,66,0.394,9,23,0.391,17,43,0.395,9,12,0.75,1,11,12,10,10,2,2,15,70,0.1,0.2,0.3,2015
Alan Williams,PF,23,10,68,10,24,0.417,0,0,0.0,10,24,0.417,9,14,0.643,14,24,38,5,4,5,6,15,29,0.1,0.2,0.2,2015
Deron Williams,PG,31,65,2106,321,775,0.414,97,282,0.344,224,493,0.454,179,206,0.869,19,171,190,378,61,14,150,155,918,2.2,1.4,3.7,2015
Derrick Williams,SF,24,80,1435,254,565,0.45,44,150,0.293,210,415,0.506,194,256,0.758,47,249,296,75,29,9,61,69,746,2.4,1.2,3.6,2015
Elliot Williams,PG,26,5,45,2,10,0.2,1,4,0.25,1,6,0.167,3,4,0.75,1,3,4,4,0,0,1,2,8,0.0,0.0,0.0,2015
Lou Williams,SG,29,67,1907,283,693,0.408,110,320,0.344,173,373,0.464,352,424,0.83,31,138,169,167,62,19,107,107,1028,4.5,0.3,4.7,2015
Marvin Williams,PF,29,81,2338,338,747,0.452,152,378,0.402,186,369,0.504,120,144,0.833,127,394,521,110,58,77,62,133,948,4.7,3.2,7.8,2015
Mo Williams,PG,33,41,748,132,302,0.437,36,102,0.353,96,200,0.48,38,42,0.905,6,66,72,98,14,5,57,60,338,0.4,0.7,1.1,2015
Justise Winslow,SF,19,78,2232,195,462,0.422,32,116,0.276,163,346,0.471,80,117,0.684,81,322,403,117,68,26,95,184,502,-0.2,2.7,2.5,2015
Jeff Withey,C,25,51,658,87,162,0.537,0,2,0.0,87,160,0.544,43,59,0.729,56,117,173,20,21,53,28,75,217,1.1,1.3,2.3,2015
Christian Wood,PF,20,17,145,22,53,0.415,4,11,0.364,18,42,0.429,13,21,0.619,13,25,38,3,5,7,2,11,61,0.2,0.1,0.3,2015
Metta World Peace,SF,36,35,590,55,177,0.311,26,84,0.31,29,93,0.312,40,57,0.702,19,70,89,27,22,11,15,67,176,-0.2,0.3,0.1,2015
Brandan Wright,PF,28,12,212,35,52,0.673,0,0,0.0,35,52,0.673,13,24,0.542,14,29,43,6,5,15,10,21,83,0.4,0.2,0.7,2015
Delon Wright,PG,23,27,229,36,80,0.45,5,13,0.385,31,67,0.463,26,35,0.743,8,29,37,31,8,3,16,7,103,0.3,0.2,0.6,2015
Tony Wroten,PG,22,8,144,22,65,0.338,3,17,0.176,19,48,0.396,20,37,0.541,2,19,21,20,3,0,29,11,67,-0.8,0.0,-0.8,2015
James Young,SG,20,29,199,11,36,0.306,6,26,0.231,5,10,0.5,1,4,0.25,4,22,26,9,6,1,5,17,29,-0.2,0.2,0.1,2015
Joe Young,PG,23,41,384,62,169,0.367,10,46,0.217,52,123,0.423,20,25,0.8,6,44,50,65,15,0,33,30,154,-0.5,0.5,-0.1,2015
Nick Young,SG,30,54,1033,126,372,0.339,77,237,0.325,49,135,0.363,63,76,0.829,14,83,97,34,23,7,30,50,392,0.1,0.0,0.1,2015
Thaddeus Young,PF,27,73,2407,495,963,0.514,7,30,0.233,488,933,0.523,105,163,0.644,176,484,660,136,112,37,136,182,1102,1.9,2.2,4.1,2015
Cody Zeller,C,23,73,1774,231,437,0.529,1,10,0.1,230,427,0.539,175,232,0.754,138,317,455,71,57,63,68,204,638,3.6,2.7,6.3,2015
Tyler Zeller,C,26,60,710,138,290,0.476,0,0,0.0,138,290,0.476,88,108,0.815,62,116,178,29,10,22,46,97,364,0.8,0.9,1.7,2015
Álex Abrines,SG,23,68,1055,134,341,0.393,94,247,0.381,40,94,0.426,44,49,0.898,18,68,86,40,37,8,33,114,406,1.2,0.9,2.1,2016
Quincy Acy,PF,26,38,558,70,170,0.412,37,90,0.411,33,80,0.413,45,60,0.75,20,95,115,18,14,15,21,67,222,0.5,0.5,0.9,2016
Steven Adams,C,23,80,2389,374,655,0.571,0,1,0.0,374,654,0.572,157,257,0.611,281,332,613,86,89,78,146,195,905,3.3,3.1,6.5,2016
Arron Afflalo,SG,31,61,1580,185,420,0.44,62,151,0.411,123,269,0.457,83,93,0.892,9,116,125,78,21,6,42,104,515,1.2,0.2,1.4,2016
Alexis Ajinça,C,28,39,584,89,178,0.5,0,4,0.0,89,174,0.511,29,40,0.725,46,131,177,12,20,22,31,77,207,0.0,0.9,1.0,2016
Cole Aldrich,C,28,62,531,45,86,0.523,0,0,0.0,45,86,0.523,15,22,0.682,51,107,158,25,25,23,17,85,105,0.6,0.7,1.3,2016
LaMarcus Aldridge,PF,31,72,2335,500,1049,0.477,23,56,0.411,477,993,0.48,220,271,0.812,172,351,523,139,46,88,98,158,1243,3.5,3.7,7.2,2016
Lavoy Allen,PF,27,61,871,77,168,0.458,0,1,0.0,77,167,0.461,23,33,0.697,105,114,219,57,18,24,29,78,177,0.9,0.8,1.7,2016
Tony Allen,SG,35,71,1914,274,595,0.461,15,54,0.278,259,541,0.479,80,130,0.615,166,225,391,98,115,29,100,178,643,0.2,2.9,3.1,2016
Al-Farouq Aminu,PF,26,61,1773,183,466,0.393,70,212,0.33,113,254,0.445,96,136,0.706,77,374,451,99,60,44,94,102,532,-0.1,2.0,1.9,2016
Chris Andersen,C,38,12,114,9,22,0.409,0,3,0.0,9,19,0.474,10,14,0.714,9,22,31,5,5,7,5,20,28,0.1,0.2,0.2,2016
Alan Anderson,SF,34,30,308,30,80,0.375,14,44,0.318,16,36,0.444,12,16,0.75,3,21,24,11,3,0,7,35,86,0.0,0.1,0.1,2016
Justin Anderson,SF,23,75,1228,186,439,0.424,58,194,0.299,128,245,0.522,102,129,0.791,69,176,245,66,41,23,66,109,532,0.6,1.3,1.9,2016
Kyle Anderson,SF,23,72,1020,93,209,0.445,15,40,0.375,78,169,0.462,45,57,0.789,33,175,208,91,51,26,39,63,246,0.7,2.0,2.7,2016
Ryan Anderson,PF,28,72,2116,323,773,0.418,204,506,0.403,119,267,0.446,129,150,0.86,112,218,330,68,31,14,55,142,979,4.0,1.1,5.2,2016
Giannis Antetokounmpo,SF,22,80,2845,656,1259,0.521,49,180,0.272,607,1079,0.563,471,612,0.77,142,558,700,434,131,151,234,246,1832,7.9,4.5,12.4,2016
Carmelo Anthony,SF,32,74,2538,602,1389,0.433,151,421,0.359,451,968,0.466,304,365,0.833,62,376,438,213,60,34,153,198,1659,3.2,1.5,4.7,2016
Joel Anthony,C,34,19,122,10,16,0.625,0,0,0.0,10,16,0.625,5,8,0.625,8,23,31,3,2,6,4,11,25,0.1,0.2,0.4,2016
Trevor Ariza,SF,31,80,2773,326,798,0.409,191,555,0.344,135,243,0.556,93,126,0.738,54,404,458,175,147,20,73,133,936,2.8,3.2,6.0,2016
Darrell Arthur,PF,28,41,639,95,215,0.442,53,117,0.453,42,98,0.429,19,22,0.864,25,87,112,42,19,21,36,76,262,0.6,0.4,1.1,2016
Ömer Aşık,C,30,31,482,31,65,0.477,0,0,0.0,31,65,0.477,23,39,0.59,48,115,163,15,5,10,14,51,85,0.4,0.6,1.0,2016
D.J. Augustin,PG,29,78,1538,195,517,0.377,95,274,0.347,100,243,0.412,131,161,0.814,15,102,117,209,31,1,90,101,616,0.7,0.5,1.2,2016
Luke Babbitt,SF,27,68,1065,113,281,0.402,87,210,0.414,26,71,0.366,11,15,0.733,12,129,141,36,20,11,25,118,324,0.8,1.0,1.8,2016
Ron Baker,SG,23,52,857,82,217,0.378,23,86,0.267,59,131,0.45,28,43,0.651,12,86,98,107,34,8,56,74,215,-0.6,0.5,-0.1,2016
Wade Baldwin,PG,20,33,405,36,115,0.313,3,22,0.136,33,93,0.355,31,37,0.838,11,35,46,61,18,7,39,40,106,-0.8,0.5,-0.3,2016
Leandro Barbosa,SG,34,67,963,172,392,0.439,35,98,0.357,137,294,0.466,40,45,0.889,15,89,104,81,31,8,48,82,419,0.3,0.4,0.6,2016
J.J. Barea,PG,32,35,771,142,343,0.414,53,148,0.358,89,195,0.456,44,51,0.863,9,75,84,193,14,1,63,30,381,0.8,0.5,1.3,2016
Harrison Barnes,PF,24,79,2803,599,1280,0.468,78,222,0.351,521,1058,0.492,242,281,0.861,93,301,394,116,65,15,102,128,1518,2.5,2.1,4.6,2016
Matt Barnes,SF,36,74,1777,185,473,0.391,87,263,0.331,98,210,0.467,70,89,0.787,70,314,384,195,48,26,107,185,527,0.3,1.7,2.0,2016
Will Barton,SG,26,60,1705,295,666,0.443,87,235,0.37,208,431,0.483,143,190,0.753,58,201,259,206,48,28,97,110,820,2.5,0.8,3.3,2016
Brandon Bass,PF,31,52,577,107,186,0.575,1,3,0.333,106,183,0.579,77,88,0.875,43,86,129,21,14,11,29,45,292,1.6,0.6,2.2,2016
Nicolas Batum,SG,28,77,2617,393,975,0.403,135,405,0.333,258,570,0.453,243,284,0.856,46,435,481,456,86,29,194,109,1164,1.7,2.8,4.6,2016
Jerryd Bayless,PG,28,3,71,11,32,0.344,2,5,0.4,9,27,0.333,9,10,0.9,3,9,12,13,0,0,9,4,33,-0.1,0.0,-0.1,2016
Aron Baynes,C,30,75,1163,143,279,0.513,0,0,0.0,143,279,0.513,79,94,0.84,111,222,333,32,17,39,50,166,365,1.4,1.5,3.0,2016
Kent Bazemore,SF,27,73,1963,295,721,0.409,92,266,0.346,203,455,0.446,119,168,0.708,45,186,231,177,91,52,125,165,801,-0.6,2.8,2.1,2016
Bradley Beal,SG,23,77,2684,637,1322,0.482,223,552,0.404,414,770,0.538,282,342,0.825,53,187,240,267,83,21,156,169,1779,6.9,1.6,8.5,2016
Malik Beasley,SG,20,22,165,33,73,0.452,9,28,0.321,24,45,0.533,8,10,0.8,5,12,17,11,7,0,8,10,83,0.1,0.1,0.2,2016
Michael Beasley,PF,28,56,935,216,406,0.532,18,43,0.419,198,363,0.545,78,105,0.743,40,153,193,53,27,27,66,92,528,0.8,1.0,1.8,2016
Marco Belinelli,SG,30,74,1778,264,615,0.429,102,283,0.36,162,332,0.488,150,168,0.893,14,164,178,147,44,9,70,90,780,2.0,1.2,3.2,2016
DeAndre' Bembry,SF,22,38,371,47,98,0.48,1,18,0.056,46,80,0.575,6,16,0.375,14,45,59,28,8,5,16,21,101,-0.1,0.4,0.3,2016
Dragan Bender,PF,19,43,574,57,161,0.354,28,101,0.277,29,60,0.483,4,11,0.364,23,80,103,23,10,22,32,74,146,-0.7,0.3,-0.3,2016
Anthony Bennett,PF,23,23,264,38,92,0.413,13,48,0.271,25,44,0.568,26,36,0.722,25,53,78,12,5,3,12,18,115,0.3,0.2,0.5,2016
Ben Bentil,PF,21,3,10,0,3,0.0,0,1,0.0,0,2,0.0,0,0,0.0,0,2,2,0,0,0,1,1,0,-0.1,0.0,-0.1,2016
Dāvis Bertāns,PF,24,67,808,103,234,0.44,69,173,0.399,34,61,0.557,28,34,0.824,22,76,98,46,20,28,32,75,303,1.1,1.2,2.3,2016
Patrick Beverley,SG,28,67,2058,228,543,0.42,110,288,0.382,118,255,0.463,73,95,0.768,95,298,393,281,99,25,100,222,639,2.9,2.4,5.3,2016
Bismack Biyombo,C,24,81,1793,179,339,0.528,0,0,0.0,179,339,0.528,125,234,0.534,157,410,567,74,25,91,95,202,483,0.8,2.1,2.9,2016
Nemanja Bjelica,PF,28,65,1190,151,356,0.424,56,177,0.316,95,179,0.531,45,61,0.738,57,187,244,79,40,20,59,154,403,0.6,0.9,1.5,2016
Tarik Black,C,25,67,1091,150,294,0.51,1,2,0.5,149,292,0.51,82,109,0.752,144,199,343,39,29,44,58,173,383,1.5,0.8,2.4,2016
Eric Bledsoe,PG,27,66,2176,449,1034,0.434,104,310,0.335,345,724,0.477,388,458,0.847,52,268,320,418,91,31,224,164,1390,4.0,1.4,5.3,2016
Bojan Bogdanović,SF,27,81,2083,376,845,0.445,144,392,0.367,232,453,0.512,217,243,0.893,37,240,277,111,34,7,131,146,1113,2.0,0.9,2.9,2016
Andrew Bogut,C,32,27,583,38,81,0.469,0,1,0.0,38,80,0.475,3,11,0.273,56,162,218,49,13,25,43,86,79,-0.3,1.0,0.7,2016
Joel Bolomboy,PF,23,12,53,9,16,0.563,1,4,0.25,8,12,0.667,3,6,0.5,4,13,17,2,1,2,2,1,22,0.1,0.1,0.2,2016
Devin Booker,SG,20,78,2730,606,1431,0.423,147,405,0.363,459,1026,0.447,367,441,0.832,46,203,249,268,72,21,241,242,1726,1.3,0.6,2.0,2016
Trevor Booker,PF,29,71,1754,305,591,0.516,25,78,0.321,280,513,0.546,74,110,0.673,143,428,571,138,75,28,127,152,709,1.0,2.2,3.1,2016
Avery Bradley,SG,26,55,1835,359,775,0.463,108,277,0.39,251,498,0.504,68,93,0.731,65,269,334,122,68,11,88,141,894,1.1,2.0,3.1,2016
Corey Brewer,SF,30,82,1281,147,348,0.422,27,118,0.229,120,230,0.522,50,68,0.735,32,134,166,97,61,20,55,133,371,0.0,1.2,1.2,2016
Malcolm Brogdon,SG,24,75,1982,290,635,0.457,78,193,0.404,212,442,0.48,109,126,0.865,47,166,213,317,84,12,113,140,767,2.6,1.5,4.1,2016
Aaron Brooks,PG,32,65,894,121,300,0.403,48,128,0.375,73,172,0.424,32,40,0.8,18,51,69,125,25,9,66,93,322,-0.2,0.5,0.3,2016
Anthony Brown,SF,24,11,159,18,50,0.36,7,27,0.259,11,23,0.478,0,0,0.0,8,25,33,8,5,1,6,15,43,-0.2,0.2,0.0,2016
Bobby Brown,PG,32,25,123,23,60,0.383,14,35,0.4,9,25,0.36,2,2,1.0,0,6,6,14,1,0,5,5,62,0.1,0.0,0.1,2016
Jaylen Brown,SF,20,78,1341,192,423,0.454,46,135,0.341,146,288,0.507,85,124,0.685,45,175,220,64,35,18,68,142,515,0.2,1.3,1.5,2016
Nicolás Brussino,SG,23,54,521,52,141,0.369,29,95,0.305,23,46,0.5,17,22,0.773,26,69,95,47,17,8,26,43,150,0.0,0.6,0.6,2016
Reggie Bullock,SF,25,31,467,54,128,0.422,28,73,0.384,26,55,0.473,5,7,0.714,13,51,64,29,18,3,10,22,141,0.4,0.5,1.0,2016
Trey Burke,PG,24,57,703,116,255,0.455,31,70,0.443,85,185,0.459,22,29,0.759,7,40,47,100,11,5,48,54,285,0.3,0.3,0.5,2016
Alec Burks,SG,25,42,653,99,248,0.399,25,76,0.329,74,172,0.43,60,78,0.769,17,103,120,30,18,5,35,50,283,-0.1,0.9,0.8,2016
Jimmy Butler,SF,27,76,2809,570,1252,0.455,91,248,0.367,479,1004,0.477,585,676,0.865,129,341,470,417,143,32,159,112,1816,10.1,3.8,13.8,2016
Bruno Caboclo,SF,21,9,40,6,16,0.375,2,6,0.333,4,10,0.4,0,0,0.0,5,5,10,4,2,1,2,4,14,0.0,0.1,0.1,2016
José Calderón,PG,35,41,539,55,134,0.41,20,64,0.313,35,70,0.5,11,12,0.917,15,59,74,88,11,1,41,36,141,0.0,0.3,0.3,2016
Kentavious Caldwell-Pope,SG,23,76,2529,370,928,0.399,153,437,0.35,217,491,0.442,154,185,0.832,55,193,248,193,89,12,86,118,1047,2.0,2.5,4.5,2016
Isaiah Canaan,SG,25,39,592,63,173,0.364,25,94,0.266,38,79,0.481,30,33,0.909,6,44,50,37,22,1,21,35,181,0.0,0.6,0.5,2016
Clint Capela,C,22,65,1551,362,563,0.643,0,0,0.0,362,563,0.643,94,177,0.531,178,348,526,63,34,79,87,179,818,3.8,2.1,5.9,2016
DeMarre Carroll,SF,30,72,1882,220,550,0.4,109,320,0.341,111,230,0.483,89,117,0.761,63,212,275,74,81,27,54,143,638,1.7,2.1,3.8,2016
Vince Carter*,SF,40,73,1799,193,490,0.394,112,296,0.378,81,194,0.418,88,115,0.765,36,191,227,133,60,36,50,163,586,1.9,2.1,4.0,2016
Michael Carter-Williams,PG,25,45,846,112,306,0.366,15,64,0.234,97,242,0.401,58,77,0.753,24,129,153,113,38,23,66,102,297,-1.0,1.3,0.2,2016
Omri Casspi,PF,28,36,643,77,164,0.47,15,43,0.349,62,121,0.512,17,29,0.586,27,85,112,37,23,3,29,50,186,0.1,0.4,0.5,2016
Willie Cauley-Stein,C,23,75,1421,255,481,0.53,0,2,0.0,255,479,0.532,101,151,0.669,85,254,339,80,53,44,69,147,611,1.4,1.5,2.9,2016
Tyson Chandler,C,34,47,1298,153,228,0.671,0,0,0.0,153,228,0.671,91,124,0.734,153,386,539,30,33,24,65,126,397,2.7,1.3,4.1,2016
Wilson Chandler,SF,29,71,2197,433,939,0.461,110,326,0.337,323,613,0.527,141,194,0.727,103,357,460,141,51,30,114,172,1117,2.4,1.1,3.5,2016
Marquese Chriss,PF,19,82,1743,284,632,0.449,72,224,0.321,212,408,0.52,113,181,0.624,96,252,348,60,67,70,108,263,753,0.3,1.5,1.8,2016
Rakeem Christmas,PF,25,29,219,19,43,0.442,0,0,0.0,19,43,0.442,21,29,0.724,26,30,56,4,3,6,8,37,59,0.3,0.2,0.5,2016
Semaj Christon,PG,24,64,973,77,223,0.345,12,63,0.19,65,160,0.406,17,31,0.548,19,68,87,130,28,7,43,79,183,-0.7,0.8,0.1,2016
Ian Clark,SG,25,77,1137,211,433,0.487,61,163,0.374,150,270,0.556,44,58,0.759,22,99,121,90,39,8,55,77,527,1.0,1.3,2.3,2016
Jordan Clarkson,SG,24,82,2397,477,1071,0.445,117,356,0.329,360,715,0.503,134,168,0.798,49,197,246,213,88,8,164,150,1205,0.5,0.7,1.2,2016
Norris Cole,PG,28,13,125,16,52,0.308,3,13,0.231,13,39,0.333,8,10,0.8,0,11,11,14,8,0,7,18,43,-0.2,0.2,-0.1,2016
Darren Collison,PG,29,68,2063,340,714,0.476,73,175,0.417,267,539,0.495,147,171,0.86,23,129,152,312,67,9,114,119,900,3.1,0.8,3.9,2016
Nick Collison,PF,36,20,128,14,23,0.609,0,1,0.0,14,22,0.636,5,8,0.625,9,22,31,12,2,2,4,17,33,0.3,0.1,0.4,2016
Mike Conley,PG,29,69,2292,464,1009,0.46,171,419,0.408,293,590,0.497,316,368,0.859,31,210,241,433,92,19,156,126,1415,7.5,2.5,10.0,2016
Pat Connaughton,SG,24,39,316,37,72,0.514,17,33,0.515,20,39,0.513,7,9,0.778,10,42,52,28,6,2,17,23,98,0.4,0.2,0.6,2016
Quinn Cook,PG,23,14,188,33,66,0.5,11,26,0.423,22,40,0.55,2,5,0.4,1,6,7,26,4,0,13,13,79,0.1,0.1,0.2,2016
DeMarcus Cousins,C,26,72,2465,647,1432,0.452,131,363,0.361,516,1069,0.483,517,670,0.772,152,642,794,332,100,93,269,278,1942,3.9,3.8,7.6,2016
Robert Covington,SF,26,67,2119,292,732,0.399,137,412,0.333,155,320,0.484,143,174,0.822,92,344,436,102,127,69,131,203,864,0.0,3.2,3.1,2016
Allen Crabbe,SG,24,79,2254,303,647,0.468,134,302,0.444,169,345,0.49,105,124,0.847,19,207,226,94,54,20,62,171,845,3.1,1.0,4.2,2016
Jamal Crawford,SG,36,82,2157,359,870,0.413,116,322,0.36,243,548,0.443,174,203,0.857,17,112,129,214,61,14,134,115,1008,0.5,1.4,1.9,2016
Jordan Crawford,SG,28,19,442,105,218,0.482,37,95,0.389,68,123,0.553,20,26,0.769,4,30,34,57,11,2,25,30,267,0.6,0.3,0.9,2016
Jae Crowder,SF,26,72,2335,333,720,0.463,157,394,0.398,176,326,0.54,176,217,0.811,48,367,415,155,73,23,80,161,999,4.1,2.5,6.7,2016
Dante Cunningham,PF,29,66,1649,174,359,0.485,71,181,0.392,103,178,0.579,16,27,0.593,56,221,277,37,39,28,28,100,435,1.4,1.6,3.0,2016
Seth Curry,PG,26,70,2029,338,703,0.481,137,322,0.425,201,381,0.528,85,100,0.85,25,154,179,189,79,7,92,126,898,2.9,1.7,4.6,2016
Stephen Curry,PG,28,79,2638,675,1443,0.468,324,789,0.411,351,654,0.537,325,362,0.898,61,292,353,524,142,17,239,183,1999,8.7,3.9,12.6,2016
Troy Daniels,SG,25,67,1183,185,495,0.374,138,355,0.389,47,140,0.336,43,54,0.796,22,78,100,46,20,4,45,90,551,0.5,0.8,1.3,2016
Anthony Davis,C,23,75,2708,770,1526,0.505,40,134,0.299,730,1392,0.524,519,647,0.802,172,712,884,157,94,167,181,168,2099,5.9,5.1,11.0,2016
Deyonta Davis,C,20,36,238,24,47,0.511,0,0,0.0,24,47,0.511,10,18,0.556,20,40,60,2,3,17,8,40,58,0.1,0.4,0.5,2016
Ed Davis,PF,27,46,789,75,142,0.528,0,0,0.0,75,142,0.528,50,81,0.617,96,148,244,26,15,22,37,137,200,1.0,0.7,1.7,2016
Dewayne Dedmon,C,27,76,1330,161,259,0.622,0,0,0.0,161,259,0.622,65,93,0.699,129,367,496,44,37,61,61,180,387,2.3,3.0,5.2,2016
Sam Dekker,PF,22,77,1419,203,429,0.473,60,187,0.321,143,242,0.591,38,68,0.559,94,190,284,76,38,21,41,83,504,1.9,1.2,3.1,2016
Malcolm Delaney,PG,27,73,1248,145,388,0.374,26,110,0.236,119,278,0.428,75,93,0.806,10,113,123,193,39,1,95,112,391,-1.2,1.3,0.1,2016
Matthew Dellavedova,PG,26,76,1986,208,534,0.39,79,215,0.367,129,319,0.404,82,96,0.854,24,123,147,357,53,0,133,153,577,0.3,0.9,1.2,2016
Luol Deng,SF,31,56,1486,164,424,0.387,51,165,0.309,113,259,0.436,46,63,0.73,63,232,295,74,48,20,43,61,425,0.1,0.8,0.9,2016
DeMar DeRozan,SG,27,74,2620,721,1545,0.467,33,124,0.266,688,1421,0.484,545,647,0.842,70,316,386,290,78,13,180,134,2020,6.7,2.4,9.0,2016
Cheick Diallo,PF,20,17,199,36,76,0.474,0,0,0.0,36,76,0.474,15,21,0.714,23,50,73,4,4,7,7,17,87,0.2,0.3,0.5,2016
Boris Diaw,PF,34,73,1283,146,327,0.446,20,81,0.247,126,246,0.512,26,35,0.743,46,112,158,170,18,9,87,83,338,-0.1,1.2,1.1,2016
Gorgui Dieng,PF,27,82,2653,332,661,0.502,16,43,0.372,316,618,0.511,136,167,0.814,188,459,647,158,88,95,107,254,816,3.2,2.5,5.7,2016
Spencer Dinwiddie,PG,23,59,1334,134,302,0.444,38,101,0.376,96,201,0.478,126,159,0.792,27,137,164,185,44,23,66,119,432,1.9,0.9,2.8,2016
Toney Douglas,PG,30,24,394,43,117,0.368,7,42,0.167,36,75,0.48,24,29,0.828,13,48,61,56,18,5,21,50,117,0.0,0.5,0.5,2016
Goran Dragić,PG,30,73,2459,534,1124,0.475,117,289,0.405,417,835,0.499,298,377,0.79,62,217,279,423,89,13,212,199,1483,5.0,2.6,7.5,2016
Andre Drummond,C,23,81,2409,483,911,0.53,2,7,0.286,481,904,0.532,137,355,0.386,345,770,1115,90,124,89,152,237,1105,1.4,5.3,6.7,2016
Jared Dudley,PF,31,64,1362,157,346,0.454,77,203,0.379,80,143,0.559,43,65,0.662,31,194,225,121,42,16,73,154,434,1.1,0.7,1.8,2016
Mike Dunleavy,SF,36,53,841,93,220,0.423,53,134,0.396,40,86,0.465,36,45,0.8,18,97,115,50,15,7,28,67,275,0.8,0.7,1.5,2016
Kris Dunn,PG,22,78,1333,118,313,0.377,21,73,0.288,97,240,0.404,36,59,0.61,24,142,166,188,78,36,89,178,293,-1.2,1.3,0.1,2016
Kevin Durant,PF,28,62,2070,551,1026,0.537,117,312,0.375,434,714,0.608,336,384,0.875,39,474,513,300,66,99,138,117,1555,8.0,4.0,12.0,2016
Jarell Eddie,SF,25,5,62,6,19,0.316,4,16,0.25,2,3,0.667,8,9,0.889,1,6,7,0,1,0,1,1,24,0.1,0.0,0.1,2016
Henry Ellenson,PF,20,19,146,23,64,0.359,10,35,0.286,13,29,0.448,4,8,0.5,8,33,41,7,1,1,14,6,60,-0.4,0.2,-0.2,2016
Wayne Ellington,SG,29,62,1500,231,555,0.416,149,394,0.378,82,161,0.509,37,43,0.86,18,114,132,70,35,4,30,70,648,2.1,1.2,3.3,2016
Monta Ellis,SG,31,74,1998,247,557,0.443,43,135,0.319,204,422,0.483,93,128,0.727,19,185,204,236,78,27,135,149,630,-0.7,1.7,1.1,2016
Joel Embiid,C,22,31,786,200,429,0.466,36,98,0.367,164,331,0.495,191,244,0.783,61,182,243,66,27,76,117,112,627,0.5,1.5,1.9,2016
James Ennis III,SF,26,64,1501,146,321,0.455,51,137,0.372,95,184,0.516,86,110,0.782,69,190,259,64,46,19,59,165,429,1.4,1.7,3.1,2016
Tyler Ennis,PG,22,53,588,90,208,0.433,27,70,0.386,63,138,0.457,21,25,0.84,9,36,45,86,25,2,45,58,228,0.1,0.3,0.4,2016
Tyreke Evans,SF,27,40,788,150,370,0.405,42,118,0.356,108,252,0.429,69,92,0.75,13,124,137,124,35,9,61,60,411,-0.2,0.9,0.7,2016
Dante Exum,PG,21,66,1228,155,363,0.427,44,149,0.295,111,214,0.519,58,73,0.795,30,102,132,111,21,12,80,146,412,-0.1,1.3,1.2,2016
Kenneth Faried,PF,27,61,1296,228,416,0.548,0,6,0.0,228,410,0.556,131,189,0.693,183,279,462,55,43,40,59,124,587,3.3,1.2,4.5,2016
Jordan Farmar,PG,30,2,35,4,12,0.333,4,9,0.444,0,3,0.0,0,0,0.0,1,2,3,9,2,0,3,1,12,0.0,0.0,0.0,2016
Derrick Favors,PF,25,50,1186,203,417,0.487,3,10,0.3,200,407,0.491,67,109,0.615,92,213,305,56,45,40,60,103,476,0.5,2.2,2.7,2016
Kay Felder,PG,21,42,386,62,158,0.392,7,22,0.318,55,136,0.404,35,49,0.714,3,38,41,58,18,7,30,38,166,-0.3,0.4,0.1,2016
Cristiano Felício,C,24,66,1040,128,221,0.579,0,0,0.0,128,221,0.579,60,93,0.645,124,187,311,40,25,17,33,110,316,2.1,1.3,3.4,2016
Raymond Felton,PG,32,80,1700,221,514,0.43,46,144,0.319,175,370,0.473,50,64,0.781,33,185,218,191,66,22,83,125,538,0.2,1.8,1.9,2016
Yogi Ferrell,PG,23,46,1197,160,394,0.406,68,176,0.386,92,218,0.422,74,89,0.831,20,91,111,172,42,9,70,90,462,0.8,1.0,1.8,2016
Dorian Finney-Smith,PF,23,81,1642,124,333,0.372,56,191,0.293,68,142,0.479,46,61,0.754,55,167,222,67,52,25,45,125,350,-0.1,1.5,1.4,2016
Bryn Forbes,SG,23,36,285,36,99,0.364,17,53,0.321,19,46,0.413,5,6,0.833,2,21,23,23,1,0,11,20,94,-0.2,0.2,0.1,2016
Evan Fournier,SG,24,68,2234,408,930,0.439,128,360,0.356,280,570,0.491,223,277,0.805,44,165,209,202,66,4,141,180,1167,1.7,1.1,2.8,2016
Randy Foye,SG,33,69,1284,118,325,0.363,67,203,0.33,51,122,0.418,54,63,0.857,9,146,155,135,35,9,80,99,357,-0.6,0.7,0.2,2016
Tim Frazier,PG,26,65,1525,163,404,0.403,40,128,0.313,123,276,0.446,98,129,0.76,34,139,173,335,56,6,101,133,464,1.0,1.4,2.4,2016
Enes Freedom,C,24,72,1533,402,737,0.545,5,38,0.132,397,699,0.568,224,285,0.786,195,287,482,67,32,38,123,154,1033,4.0,1.8,5.8,2016
Channing Frye,C,33,74,1398,238,520,0.458,137,335,0.409,101,185,0.546,63,74,0.851,37,253,290,45,33,37,53,138,676,2.3,1.4,3.7,2016
Danilo Gallinari,SF,28,63,2134,335,750,0.447,126,324,0.389,209,426,0.491,349,387,0.902,39,286,325,135,40,15,82,93,1145,6.2,0.7,6.8,2016
Langston Galloway,PG,25,74,1495,207,545,0.38,120,308,0.39,87,237,0.367,51,64,0.797,27,129,156,93,46,6,46,96,585,0.2,1.1,1.3,2016
Patricio Garino,SG,23,5,43,0,7,0.0,0,5,0.0,0,2,0.0,0,0,0.0,1,6,7,0,0,0,3,4,0,-0.2,0.0,-0.2,2016
Marc Gasol,C,32,74,2531,532,1160,0.459,104,268,0.388,428,892,0.48,278,332,0.837,60,404,464,338,67,99,166,171,1446,4.2,3.5,7.7,2016
Pau Gasol*,C,36,64,1627,303,604,0.502,56,104,0.538,247,500,0.494,130,184,0.707,107,394,501,150,24,70,81,110,792,3.3,3.1,6.4,2016
Rudy Gay,SF,30,30,1013,201,442,0.455,42,113,0.372,159,329,0.483,118,138,0.855,35,155,190,83,44,26,74,79,562,0.8,1.0,1.8,2016
Michael Gbinije,SG,24,9,32,1,10,0.1,0,4,0.0,1,6,0.167,2,2,1.0,2,1,3,2,0,0,0,2,4,-0.1,0.0,-0.1,2016
Alonzo Gee,SF,29,13,89,3,14,0.214,0,3,0.0,3,11,0.273,5,9,0.556,4,11,15,6,5,1,4,14,11,-0.1,0.1,-0.1,2016
Paul George,SF,26,75,2689,622,1348,0.461,195,496,0.393,427,852,0.501,336,374,0.898,58,434,492,251,119,27,220,206,1775,3.9,3.1,7.1,2016
Marcus Georges-Hunt,SG,22,5,48,2,7,0.286,1,2,0.5,1,5,0.2,9,10,0.9,1,8,9,3,1,0,2,5,14,0.1,0.0,0.1,2016
Jonathan Gibson,PG,29,17,231,35,95,0.368,15,45,0.333,20,50,0.4,21,29,0.724,1,21,22,26,8,0,21,21,106,-0.3,0.2,-0.1,2016
Taj Gibson,PF,31,78,1989,365,709,0.515,3,13,0.231,362,696,0.52,113,158,0.715,158,327,485,73,41,65,105,163,846,1.6,2.5,4.0,2016
Manu Ginóbili*,SG,39,69,1291,171,439,0.39,89,227,0.392,82,212,0.387,86,107,0.804,28,129,157,183,82,16,96,119,517,0.6,2.4,3.0,2016
Rudy Gobert,C,24,81,2744,413,625,0.661,0,1,0.0,413,624,0.662,311,476,0.653,314,721,1035,97,49,214,147,246,1137,8.3,6.0,14.3,2016
Archie Goodwin,SG,22,15,214,36,66,0.545,5,15,0.333,31,51,0.608,33,42,0.786,7,21,28,24,4,5,14,8,110,0.6,0.1,0.7,2016
Aaron Gordon,SF,21,80,2298,393,865,0.454,77,267,0.288,316,598,0.528,156,217,0.719,116,289,405,150,65,40,89,172,1019,2.0,1.7,3.7,2016
Eric Gordon,SG,28,75,2323,412,1016,0.406,246,661,0.372,166,355,0.468,147,175,0.84,29,172,201,188,48,41,121,150,1217,2.5,1.4,3.8,2016
Marcin Gortat,C,32,82,2556,390,674,0.579,0,2,0.0,390,672,0.58,103,159,0.648,238,611,849,121,40,61,119,213,883,3.9,2.9,6.8,2016
Treveon Graham,SG,23,27,189,19,40,0.475,9,15,0.6,10,25,0.4,10,15,0.667,5,17,22,6,6,1,3,18,57,0.3,0.2,0.4,2016
Jerami Grant,PF,22,80,1531,152,328,0.463,43,116,0.371,109,212,0.514,90,147,0.612,38,167,205,46,33,79,44,149,437,1.1,1.8,2.9,2016
Jerian Grant,PG,24,63,1028,128,301,0.425,49,134,0.366,79,167,0.473,65,73,0.89,17,94,111,121,47,8,44,93,370,1.4,1.2,2.5,2016
Danny Green,SG,29,68,1807,176,449,0.392,118,311,0.379,58,138,0.42,27,32,0.844,31,193,224,124,70,57,76,120,497,0.4,3.0,3.4,2016
Draymond Green,PF,26,76,2471,272,650,0.418,81,263,0.308,191,387,0.494,151,213,0.709,98,501,599,533,154,106,184,217,776,2.8,5.4,8.2,2016
Gerald Green,SF,31,47,538,95,232,0.409,39,111,0.351,56,121,0.463,33,41,0.805,16,68,84,33,9,7,25,48,262,0.1,0.4,0.6,2016
JaMychal Green,PF,26,77,2101,250,500,0.5,55,145,0.379,195,355,0.549,134,167,0.802,167,377,544,84,47,34,94,248,689,3.2,2.6,5.8,2016
Jeff Green,PF,30,69,1534,220,558,0.394,53,193,0.275,167,365,0.458,145,168,0.863,39,175,214,81,37,13,75,103,638,-0.2,0.9,0.7,2016
Blake Griffin,PF,27,61,2076,479,971,0.493,38,113,0.336,441,858,0.514,320,421,0.76,112,385,497,300,57,22,142,157,1316,5.4,2.4,7.7,2016
Justin Hamilton,C,26,64,1177,174,379,0.459,55,180,0.306,119,199,0.598,39,52,0.75,71,191,262,55,29,43,43,91,442,1.0,1.0,2.1,2016
A.J. Hammons,C,24,22,163,17,42,0.405,5,10,0.5,12,32,0.375,9,20,0.45,8,28,36,4,1,13,10,21,48,-0.2,0.2,0.0,2016
Tim Hardaway Jr.,SG,24,79,2154,415,912,0.455,149,417,0.357,266,495,0.537,164,214,0.766,35,189,224,182,55,15,106,103,1143,2.7,2.1,4.8,2016
James Harden,PG,27,81,2947,674,1533,0.44,262,756,0.347,412,777,0.53,746,881,0.847,95,564,659,907,121,38,464,215,2356,11.5,3.6,15.0,2016
Maurice Harkless,SF,23,77,2223,314,624,0.503,68,194,0.351,246,430,0.572,77,124,0.621,125,216,341,88,85,70,86,214,773,2.3,1.9,4.2,2016
Justin Harper,PF,27,3,31,5,12,0.417,2,7,0.286,3,5,0.6,0,0,0.0,2,3,5,2,0,0,4,2,12,-0.1,0.0,-0.1,2016
Montrezl Harrell,C,23,58,1064,225,345,0.652,1,7,0.143,224,338,0.663,76,121,0.628,81,138,219,64,20,42,44,126,527,3.1,1.0,4.1,2016
Devin Harris,PG,33,65,1087,136,341,0.399,58,177,0.328,78,164,0.476,107,129,0.829,11,116,127,136,43,7,57,101,437,1.1,1.1,2.2,2016
Gary Harris,SG,22,57,1782,320,637,0.502,107,255,0.42,213,382,0.558,104,134,0.776,48,130,178,164,71,8,76,92,851,3.9,0.7,4.6,2016
Joe Harris,SG,25,52,1138,154,362,0.425,85,221,0.385,69,141,0.489,35,49,0.714,16,131,147,54,30,8,55,121,428,0.1,0.6,0.8,2016
Manny Harris,SG,27,4,25,3,15,0.2,0,2,0.0,3,13,0.231,2,4,0.5,3,6,9,2,0,0,2,1,8,-0.2,0.0,-0.2,2016
Tobias Harris,PF,24,82,2567,511,1063,0.481,109,314,0.347,402,749,0.537,190,226,0.841,63,353,416,142,60,39,96,133,1321,4.0,2.8,6.8,2016
Aaron Harrison,SG,22,5,17,0,4,0.0,0,2,0.0,0,2,0.0,1,2,0.5,0,3,3,3,0,0,0,2,1,-0.1,0.0,-0.1,2016
Andrew Harrison,PG,22,72,1474,117,360,0.325,43,156,0.276,74,204,0.363,148,194,0.763,23,113,136,198,53,21,85,194,425,0.0,1.5,1.6,2016
Udonis Haslem,C,36,16,130,11,23,0.478,0,3,0.0,11,20,0.55,9,15,0.6,8,28,36,6,6,1,8,22,31,0.0,0.2,0.2,2016
Spencer Hawes,PF,28,54,797,134,277,0.484,25,81,0.309,109,196,0.556,44,52,0.846,38,153,191,81,15,30,49,77,337,0.7,1.0,1.7,2016
Gordon Hayward,SF,26,73,2516,545,1156,0.471,149,374,0.398,396,782,0.506,362,429,0.844,49,345,394,252,73,20,140,117,1601,7.1,3.3,10.4,2016
Gerald Henderson,SG,29,72,1667,234,553,0.423,61,173,0.353,173,380,0.455,133,165,0.806,34,151,185,112,40,15,62,129,662,1.0,1.0,2.0,2016
John Henson,C,26,58,1123,159,309,0.515,0,1,0.0,159,308,0.516,74,107,0.692,92,203,295,57,29,78,52,151,392,1.2,1.6,2.7,2016
Juancho Hernangómez,PF,21,62,842,101,224,0.451,46,113,0.407,55,111,0.495,57,76,0.75,43,144,187,29,30,12,31,62,305,1.2,0.6,1.8,2016
Willy Hernangómez,C,22,72,1324,246,465,0.529,4,15,0.267,242,450,0.538,91,125,0.728,170,332,502,96,41,36,100,150,587,1.8,1.6,3.4,2016
Mario Hezonja,SF,21,65,960,117,330,0.355,43,144,0.299,74,186,0.398,40,50,0.8,20,126,146,62,30,15,58,74,317,-1.4,0.8,-0.7,2016
Roy Hibbert,C,30,48,682,80,147,0.544,0,0,0.0,80,147,0.544,61,75,0.813,54,98,152,21,8,46,32,100,221,1.0,0.8,1.8,2016
Buddy Hield,SG,24,82,1888,327,767,0.426,148,379,0.391,179,388,0.461,64,76,0.842,35,234,269,121,38,9,101,115,866,0.0,1.3,1.3,2016
Nenê,C,34,67,1198,245,397,0.617,3,9,0.333,242,388,0.624,116,197,0.589,95,187,282,65,56,39,73,163,609,2.5,1.6,4.1,2016
George Hill,PG,30,49,1544,289,606,0.477,94,233,0.403,195,373,0.523,157,196,0.801,23,144,167,204,50,11,85,114,829,4.0,1.9,5.9,2016
Jordan Hill,C,29,7,47,5,13,0.385,0,0,0.0,5,13,0.385,2,2,1.0,8,6,14,0,1,0,4,9,12,-0.1,0.0,0.0,2016
Solomon Hill,SF,25,80,2374,183,478,0.383,94,270,0.348,89,208,0.428,103,128,0.805,51,256,307,141,72,32,82,182,563,0.4,2.3,2.7,2016
Darrun Hilliard,SG,23,39,381,47,126,0.373,12,46,0.261,35,80,0.438,21,28,0.75,2,31,33,33,11,2,28,39,127,-0.6,0.4,-0.2,2016
Jrue Holiday,PG,26,67,2190,405,893,0.454,100,281,0.356,305,612,0.498,119,168,0.708,46,218,264,488,100,44,194,133,1029,1.3,2.6,3.8,2016
Justin Holiday,SG,27,82,1639,233,538,0.433,97,273,0.355,136,265,0.513,66,80,0.825,27,198,225,102,65,31,66,109,629,1.3,1.2,2.5,2016
Rondae Hollis-Jefferson,SF,22,78,1761,235,542,0.434,15,67,0.224,220,475,0.463,190,253,0.751,96,356,452,154,82,44,116,177,675,0.4,2.2,2.6,2016
Richaun Holmes,C,23,57,1193,230,412,0.558,27,77,0.351,203,335,0.606,72,103,0.699,94,217,311,58,42,55,55,136,559,2.2,1.6,3.8,2016
Rodney Hood,SG,24,59,1593,272,666,0.408,114,307,0.371,158,359,0.44,90,115,0.783,16,186,202,96,38,11,65,132,748,0.7,1.9,2.6,2016
Al Horford,C,30,68,2193,379,801,0.473,86,242,0.355,293,559,0.524,108,135,0.8,95,370,465,337,52,86,115,138,952,3.6,2.7,6.3,2016
Danuel House Jr.,SG,23,1,1,0,0,0.0,0,0,0.0,0,0,0.0,0,0,0.0,0,1,1,0,0,0,0,0,0,0.0,0.0,0.0,2016
Dwight Howard,C,31,74,2199,388,613,0.633,0,2,0.0,388,611,0.635,226,424,0.533,296,644,940,104,64,92,170,203,1002,3.8,4.5,8.3,2016
Marcelo Huertas,PG,33,23,237,25,68,0.368,4,19,0.211,21,49,0.429,9,17,0.529,2,22,24,52,10,2,19,16,63,-0.2,0.1,-0.1,2016
Josh Huestis,PF,25,2,31,6,11,0.545,2,4,0.5,4,7,0.571,0,1,0.0,4,5,9,3,0,3,0,0,14,0.1,0.0,0.2,2016
Kris Humphries,PF,31,56,689,87,214,0.407,19,54,0.352,68,160,0.425,64,82,0.78,60,146,206,29,15,21,28,69,257,0.6,1.1,1.6,2016
R.J. Hunter,SG,23,3,9,0,1,0.0,0,1,0.0,0,0,0.0,0,0,0.0,0,1,1,0,0,0,0,0,0,0.0,0.0,0.0,2016
Serge Ibaka,PF,27,79,2422,471,982,0.48,124,317,0.391,347,665,0.522,107,125,0.856,129,409,538,75,41,124,105,215,1173,2.5,2.6,5.1,2016
Andre Iguodala,SF,33,76,1998,219,415,0.528,64,177,0.362,155,238,0.651,72,102,0.706,51,253,304,261,76,39,58,97,574,4.1,2.9,6.9,2016
Ersan İlyasova,PF,29,82,2142,384,890,0.431,142,402,0.353,242,488,0.496,161,207,0.778,115,366,481,141,58,23,116,211,1071,1.8,2.3,4.1,2016
Joe Ingles,SF,29,82,1972,204,451,0.452,123,279,0.441,81,172,0.471,50,68,0.735,23,238,261,225,96,8,107,163,581,2.0,3.0,5.0,2016
Brandon Ingram,SF,19,79,2279,276,686,0.402,55,187,0.294,221,499,0.443,133,214,0.621,60,256,316,166,50,36,116,158,740,-1.0,0.7,-0.3,2016
Kyrie Irving,PG,24,72,2525,671,1420,0.473,177,441,0.401,494,979,0.505,297,328,0.905,52,178,230,418,83,24,180,157,1816,7.4,1.5,8.9,2016
Jarrett Jack,PG,33,2,33,2,3,0.667,0,1,0.0,2,2,1.0,2,2,1.0,0,0,0,5,2,0,3,4,6,0.0,0.0,0.0,2016
Demetrius Jackson,PG,22,5,17,3,4,0.75,1,1,1.0,2,3,0.667,3,6,0.5,2,2,4,3,0,0,0,0,10,0.1,0.0,0.1,2016
Pierre Jackson,PG,25,8,84,13,39,0.333,3,11,0.273,10,28,0.357,6,7,0.857,1,8,9,19,2,0,3,5,35,0.0,0.1,0.0,2016
Reggie Jackson,PG,26,52,1424,284,677,0.419,66,184,0.359,218,493,0.442,118,136,0.868,21,93,114,270,35,5,114,129,752,0.8,1.2,1.9,2016
LeBron James,SF,32,74,2794,736,1344,0.548,124,342,0.363,612,1002,0.611,358,531,0.674,97,542,639,646,92,44,303,134,1954,9.8,3.0,12.9,2016
Al Jefferson,C,32,66,931,235,471,0.499,0,1,0.0,235,470,0.5,65,85,0.765,75,203,278,57,19,16,33,125,535,1.2,1.1,2.3,2016
Richard Jefferson,SF,36,79,1614,153,343,0.446,62,186,0.333,91,157,0.58,80,108,0.741,28,175,203,78,26,10,52,153,448,1.3,0.8,2.1,2016
John Jenkins,SG,25,4,13,2,5,0.4,1,2,0.5,1,3,0.333,2,2,1.0,0,1,1,1,0,0,0,0,7,0.0,0.0,0.0,2016
Brandon Jennings,PG,27,81,1802,192,535,0.359,79,252,0.313,113,283,0.399,114,152,0.75,29,167,196,395,70,4,128,116,577,0.7,1.0,1.7,2016
Jonas Jerebko,PF,29,78,1232,114,262,0.435,45,130,0.346,69,132,0.523,26,37,0.703,59,213,272,71,25,17,39,122,299,0.8,1.3,2.1,2016
Amir Johnson,PF,29,80,1608,213,370,0.576,27,66,0.409,186,304,0.612,67,100,0.67,118,248,366,140,51,62,77,211,520,2.9,2.1,5.0,2016
Brice Johnson,PF,22,3,9,2,7,0.286,0,0,0.0,2,7,0.286,0,0,0.0,1,2,3,1,2,1,1,0,4,-0.1,0.0,0.0,2016
James Johnson,PF,29,76,2085,368,769,0.479,87,256,0.34,281,513,0.548,152,215,0.707,66,310,376,276,76,86,171,197,975,1.9,3.2,5.1,2016
Joe Johnson,SF,35,78,1843,273,626,0.436,106,258,0.411,167,368,0.454,63,77,0.818,33,210,243,144,36,18,69,93,715,1.7,2.1,3.8,2016
Stanley Johnson,SF,20,77,1371,129,365,0.353,45,154,0.292,84,211,0.398,36,53,0.679,36,153,189,105,56,24,71,121,339,-1.4,1.8,0.4,2016
Tyler Johnson,PG,24,73,2178,357,824,0.433,93,250,0.372,264,574,0.46,195,254,0.768,50,243,293,233,84,44,90,176,1002,3.1,2.7,5.8,2016
Wesley Johnson,SF,29,68,810,73,200,0.365,29,118,0.246,44,82,0.537,11,17,0.647,26,155,181,23,29,30,18,83,186,-0.3,1.2,0.9,2016
Nikola Jokić,C,21,73,2038,494,854,0.578,45,139,0.324,449,715,0.628,188,228,0.825,212,506,718,359,61,55,171,214,1221,7.7,2.0,9.7,2016
Dahntay Jones,SF,36,1,12,3,8,0.375,0,2,0.0,3,6,0.5,3,4,0.75,1,1,2,1,0,0,1,1,9,0.0,0.0,0.0,2016
Damian Jones,C,21,10,85,8,16,0.5,0,0,0.0,8,16,0.5,3,10,0.3,9,14,23,0,1,4,6,15,19,-0.1,0.1,0.0,2016
Derrick Jones Jr.,SF,19,32,545,68,121,0.562,3,11,0.273,65,110,0.591,29,41,0.707,39,40,79,12,14,13,13,63,168,0.9,0.2,1.1,2016
James Jones,SF,36,48,381,44,92,0.478,31,66,0.47,13,26,0.5,13,20,0.65,3,34,37,14,6,10,10,37,132,0.6,0.2,0.8,2016
Terrence Jones,PF,25,54,1270,231,492,0.47,19,75,0.253,212,417,0.508,103,170,0.606,65,241,306,59,40,54,48,67,584,0.4,1.9,2.3,2016
Tyus Jones,PG,20,60,774,75,181,0.414,26,73,0.356,49,108,0.454,33,43,0.767,10,57,67,156,48,5,38,50,209,1.0,0.6,1.5,2016
DeAndre Jordan,C,28,81,2570,412,577,0.714,0,2,0.0,412,575,0.717,205,425,0.482,298,816,1114,96,51,134,115,212,1029,7.2,4.6,11.8,2016
Cory Joseph,PG,25,80,2003,299,661,0.452,48,135,0.356,251,526,0.477,94,122,0.77,51,184,235,265,66,13,108,140,740,1.7,1.7,3.4,2016
Frank Kaminsky,C,23,75,1954,320,802,0.399,116,354,0.328,204,448,0.455,118,156,0.756,57,279,336,162,46,34,76,139,874,0.4,1.9,2.3,2016
Ryan Kelly,PF,25,16,110,8,28,0.286,4,10,0.4,4,18,0.222,5,6,0.833,1,17,18,8,4,5,4,5,25,-0.1,0.2,0.1,2016
Michael Kidd-Gilchrist,SF,23,81,2349,295,618,0.477,1,9,0.111,294,609,0.483,152,194,0.784,156,409,565,114,81,77,56,187,743,2.7,3.1,5.8,2016
Sean Kilpatrick,SG,27,70,1754,305,735,0.415,105,308,0.341,200,427,0.468,204,242,0.843,22,258,280,157,45,6,135,118,919,0.4,1.1,1.4,2016
Brandon Knight,SG,25,54,1140,209,525,0.398,45,139,0.324,164,386,0.425,132,154,0.857,25,93,118,130,27,5,88,87,595,0.1,0.2,0.3,2016
Kyle Korver,SG,35,67,1753,239,515,0.464,162,359,0.451,77,156,0.494,38,42,0.905,7,179,186,110,34,21,69,107,678,2.3,1.3,3.7,2016
Kosta Koufos,C,27,71,1419,216,392,0.551,0,1,0.0,216,391,0.552,38,62,0.613,118,285,403,47,36,48,61,172,470,1.2,1.4,2.6,2016
Mindaugas Kuzminskas,SF,27,68,1016,158,369,0.428,54,168,0.321,104,201,0.517,55,68,0.809,47,79,126,69,29,11,51,79,425,0.8,0.4,1.2,2016
Skal Labissière,PF,20,33,612,117,218,0.537,3,8,0.375,114,210,0.543,52,74,0.703,51,111,162,27,16,13,37,64,289,0.7,0.5,1.3,2016
Jeremy Lamb,SG,24,62,1143,226,491,0.46,41,146,0.281,185,345,0.536,110,129,0.853,30,234,264,75,27,23,40,98,603,1.4,1.3,2.7,2016
Nicolás Laprovíttola,PG,27,18,174,20,47,0.426,10,27,0.37,10,20,0.5,9,9,1.0,1,9,10,28,4,1,19,19,59,0.0,0.2,0.2,2016
Joffrey Lauvergne,PF,25,70,980,148,336,0.44,33,98,0.337,115,238,0.483,46,73,0.63,72,179,251,70,25,6,56,83,375,0.4,1.1,1.5,2016
Zach LaVine,SG,21,47,1749,326,710,0.459,120,310,0.387,206,400,0.515,117,140,0.836,19,141,160,139,41,10,85,104,889,2.6,0.4,3.0,2016
Ty Lawson,PG,29,69,1732,237,522,0.454,34,118,0.288,203,404,0.502,173,217,0.797,44,135,179,334,74,6,129,119,681,2.2,1.0,3.2,2016
Jake Layman,SF,22,35,249,26,89,0.292,13,51,0.255,13,38,0.342,13,17,0.765,6,18,24,11,9,3,11,22,78,-0.4,0.1,-0.3,2016
Courtney Lee,SG,31,77,2459,321,704,0.456,108,269,0.401,213,435,0.49,85,98,0.867,53,206,259,179,81,24,69,141,835,3.1,1.1,4.2,2016
David Lee,PF,33,79,1477,248,420,0.59,0,0,0.0,248,420,0.59,80,113,0.708,149,292,441,124,31,40,82,125,576,3.2,2.5,5.7,2016
Alex Len,C,23,77,1560,230,463,0.497,3,12,0.25,227,451,0.503,150,208,0.721,156,354,510,44,38,98,102,242,613,1.2,1.7,3.0,2016
Kawhi Leonard,SF,25,74,2474,636,1312,0.485,147,387,0.38,489,925,0.529,469,533,0.88,80,350,430,260,133,55,154,122,1888,8.9,4.7,13.6,2016
Meyers Leonard,PF,24,74,1222,146,378,0.386,74,213,0.347,72,165,0.436,35,40,0.875,27,210,237,71,13,28,35,172,401,0.5,0.8,1.4,2016
Jon Leuer,PF,27,75,1944,310,646,0.48,49,167,0.293,261,479,0.545,98,113,0.867,102,300,402,111,31,26,66,145,767,2.5,2.0,4.5,2016
Caris LeVert,SF,22,57,1237,171,380,0.45,59,184,0.321,112,196,0.571,67,93,0.72,23,165,188,110,49,8,59,91,468,0.8,1.0,1.8,2016
DeAndre Liggins,SG,28,62,777,55,142,0.387,17,46,0.37,38,96,0.396,25,40,0.625,20,88,108,54,47,14,42,81,152,-0.4,0.9,0.5,2016
Damian Lillard,PG,26,75,2694,661,1488,0.444,214,579,0.37,447,909,0.492,488,545,0.895,46,322,368,440,68,20,197,152,2024,8.8,1.5,10.4,2016
Jeremy Lin,PG,28,36,883,175,400,0.438,58,156,0.372,117,244,0.48,115,141,0.816,11,124,135,184,42,14,86,79,523,1.3,0.8,2.1,2016
Shaun Livingston,PG,31,76,1345,173,316,0.547,1,3,0.333,172,313,0.55,42,60,0.7,28,123,151,139,38,20,62,120,389,1.1,1.6,2.6,2016
Shawn Long,C,24,18,234,61,109,0.56,7,19,0.368,54,90,0.6,19,35,0.543,41,44,85,13,9,9,13,49,148,0.6,0.3,0.9,2016
Kevon Looney,C,20,53,447,56,107,0.523,2,9,0.222,54,98,0.551,21,34,0.618,44,80,124,29,15,17,17,64,135,0.7,0.8,1.4,2016
Brook Lopez,C,28,75,2222,555,1172,0.474,134,387,0.346,421,785,0.536,295,364,0.81,121,282,403,176,38,124,184,192,1539,3.1,1.8,4.9,2016
Robin Lopez,C,28,81,2271,382,775,0.493,0,2,0.0,382,773,0.494,75,104,0.721,244,276,520,80,18,117,91,151,839,1.8,2.4,4.3,2016
Kevin Love,PF,28,60,1885,370,867,0.427,145,389,0.373,225,478,0.471,257,295,0.871,148,518,666,116,53,21,122,125,1142,4.0,2.4,6.4,2016
Kyle Lowry,PG,30,60,2244,426,918,0.464,193,468,0.412,233,450,0.518,299,365,0.819,48,238,286,417,88,19,173,170,1344,7.8,2.3,10.1,2016
John Lucas III,PG,34,5,11,1,4,0.25,0,1,0.0,1,3,0.333,0,0,0.0,0,0,0,1,2,0,0,0,2,0.0,0.0,0.0,2016
Timothé Luwawu-Cabarrot,SF,21,69,1190,145,361,0.402,50,161,0.311,95,200,0.475,105,123,0.854,25,124,149,75,32,10,73,154,445,0.0,0.8,0.8,2016
Trey Lyles,PF,21,71,1158,159,439,0.362,65,204,0.319,94,235,0.4,57,79,0.722,48,187,235,69,26,20,64,97,440,-0.9,1.6,0.8,2016
Sheldon Mac,SG,24,30,287,30,75,0.4,7,30,0.233,23,45,0.511,23,27,0.852,4,30,34,15,8,2,5,17,90,0.3,0.2,0.5,2016
Shelvin Mack,PG,26,55,1205,170,381,0.446,37,120,0.308,133,261,0.51,53,77,0.688,20,105,125,154,42,3,90,100,430,-0.1,1.5,1.4,2016
Ian Mahinmi,C,30,31,555,65,111,0.586,0,0,0.0,65,111,0.586,43,75,0.573,47,103,150,19,33,24,34,90,173,0.5,0.9,1.4,2016
Thon Maker,C,19,57,562,83,181,0.459,28,74,0.378,55,107,0.514,32,49,0.653,40,74,114,23,10,26,17,84,226,0.8,0.5,1.3,2016
Boban Marjanović,C,28,35,293,72,132,0.545,0,0,0.0,72,132,0.545,47,58,0.81,46,84,130,9,6,12,10,25,191,1.2,0.5,1.7,2016
Jarell Martin,PF,22,42,558,58,151,0.384,9,25,0.36,49,126,0.389,40,50,0.8,42,120,162,8,17,9,28,91,165,-0.2,0.8,0.6,2016
Wesley Matthews,SG,30,73,2495,333,847,0.393,174,479,0.363,159,368,0.432,146,179,0.816,18,241,259,210,77,15,102,161,986,1.0,2.1,3.1,2016
Luc Mbah a Moute,SF,30,80,1787,191,378,0.505,43,110,0.391,148,268,0.552,59,87,0.678,44,126,170,39,81,35,46,122,484,1.3,1.8,3.1,2016
James Michael McAdoo,PF,24,52,457,62,117,0.53,2,8,0.25,60,109,0.55,21,42,0.5,34,57,91,18,18,29,19,47,147,0.3,0.8,1.1,2016
Patrick McCaw,SG,21,71,1074,106,245,0.433,41,123,0.333,65,122,0.533,29,37,0.784,21,79,100,77,32,15,36,62,282,0.5,1.2,1.7,2016
CJ McCollum,SG,25,80,2796,692,1441,0.48,185,439,0.421,507,1002,0.506,268,294,0.912,60,229,289,285,72,42,172,202,1837,6.2,1.4,7.6,2016
T.J. McConnell,PG,24,81,2133,236,512,0.461,11,55,0.2,225,457,0.492,73,90,0.811,39,212,251,534,134,10,159,139,556,1.4,2.4,3.8,2016
Chris McCullough,PF,21,16,80,16,32,0.5,1,7,0.143,15,25,0.6,3,5,0.6,9,10,19,2,2,2,3,7,36,0.1,0.1,0.1,2016
K.J. McDaniels,SF,23,49,505,77,169,0.456,20,66,0.303,57,103,0.553,32,38,0.842,15,67,82,13,19,18,29,49,206,0.0,0.5,0.5,2016
Doug McDermott,SF,25,66,1508,222,497,0.447,77,208,0.37,145,289,0.502,71,84,0.845,20,159,179,58,13,5,38,79,592,1.6,1.0,2.6,2016
JaVale McGee,C,29,77,739,208,319,0.652,0,3,0.0,208,316,0.658,56,111,0.505,100,144,244,17,19,67,40,109,472,2.0,1.5,3.5,2016
Rodney McGruder,SG,25,78,1966,190,460,0.413,73,220,0.332,117,240,0.488,44,71,0.62,94,162,256,124,46,18,56,140,497,1.2,1.7,2.9,2016
Ben McLemore,SG,23,61,1176,180,419,0.43,65,170,0.382,115,249,0.462,70,93,0.753,19,110,129,51,29,6,62,108,495,-0.1,0.5,0.4,2016
Jordan McRae,SG,25,37,384,58,150,0.387,18,51,0.353,40,99,0.404,27,34,0.794,6,35,41,19,8,6,14,31,161,-0.1,0.2,0.2,2016
Josh McRoberts,PF,29,22,381,44,118,0.373,13,31,0.419,31,87,0.356,6,9,0.667,23,51,74,50,10,4,23,31,107,-0.1,0.4,0.3,2016
Jodie Meeks,SG,29,36,738,103,256,0.402,56,137,0.409,47,119,0.395,65,74,0.878,5,72,77,45,34,4,36,41,327,0.5,0.6,1.1,2016
Salah Mejri,C,30,73,905,88,137,0.642,1,3,0.333,87,134,0.649,36,61,0.59,97,211,308,14,32,61,40,152,213,1.3,1.7,3.0,2016
Jordan Mickey,PF,22,25,141,15,34,0.441,0,1,0.0,15,33,0.455,8,14,0.571,13,21,34,7,3,6,9,12,38,-0.1,0.2,0.1,2016
Khris Middleton,SF,25,29,889,150,333,0.45,45,104,0.433,105,229,0.459,81,92,0.88,11,112,123,99,41,7,65,79,426,0.7,0.9,1.6,2016
C.J. Miles,SF,29,76,1776,281,647,0.434,169,409,0.413,112,238,0.471,84,93,0.903,30,199,229,48,46,25,40,151,815,2.7,1.4,4.0,2016
Mike Miller,SF,36,20,151,9,23,0.391,8,20,0.4,1,3,0.333,2,2,1.0,2,36,38,22,2,0,13,9,28,0.0,0.1,0.1,2016
Patty Mills,PG,28,80,1754,273,621,0.44,147,355,0.414,126,266,0.474,66,80,0.825,24,117,141,280,65,3,101,109,759,2.9,2.2,5.1,2016
Elijah Millsap,SG,29,2,23,1,7,0.143,0,2,0.0,1,5,0.2,1,2,0.5,3,3,6,1,0,0,2,2,3,-0.1,0.0,-0.1,2016
Paul Millsap,PF,31,69,2343,430,972,0.442,75,241,0.311,355,731,0.486,311,405,0.768,111,422,533,252,90,62,158,186,1246,2.6,3.8,6.4,2016
Nikola Mirotić,PF,25,70,1679,258,625,0.413,129,377,0.342,129,248,0.52,99,128,0.773,61,323,384,75,53,55,80,128,744,1.2,2.5,3.8,2016
Greg Monroe,C,26,81,1823,387,726,0.533,0,4,0.0,387,722,0.536,177,239,0.741,167,365,532,187,92,38,140,168,951,3.0,2.6,5.6,2016
E'Twaun Moore,SG,27,73,1820,283,619,0.457,77,208,0.37,206,411,0.501,57,74,0.77,33,119,152,164,50,32,62,131,700,1.2,1.5,2.7,2016
Marcus Morris,SF,27,79,2565,421,1007,0.418,118,357,0.331,303,650,0.466,145,185,0.784,77,289,366,160,52,25,87,168,1105,1.4,2.4,3.9,2016
Markieff Morris,PF,27,76,2374,406,889,0.457,71,196,0.362,335,693,0.483,180,215,0.837,107,386,493,126,82,42,129,254,1063,1.6,2.5,4.1,2016
Anthony Morrow,SG,31,49,714,98,252,0.389,41,133,0.308,57,119,0.479,34,37,0.919,12,19,31,25,24,2,6,44,271,0.7,0.5,1.2,2016
Donatas Motiejūnas,PF,26,34,479,57,138,0.413,11,47,0.234,46,91,0.505,25,49,0.51,26,75,101,32,18,11,31,55,150,-0.5,0.6,0.2,2016
Timofey Mozgov,C,30,54,1104,169,328,0.515,0,1,0.0,169,327,0.517,63,78,0.808,104,160,264,43,16,31,72,133,401,0.7,0.4,1.1,2016
Emmanuel Mudiay,PG,20,55,1406,208,551,0.377,56,178,0.315,152,373,0.408,131,167,0.784,29,149,178,217,41,13,123,95,603,-0.4,0.5,0.2,2016
Shabazz Muhammad,SF,24,78,1516,288,598,0.482,49,145,0.338,239,453,0.528,147,190,0.774,84,136,220,35,22,6,56,86,772,2.5,0.2,2.7,2016
Dejounte Murray,PG,20,38,322,50,116,0.431,9,23,0.391,41,93,0.441,21,30,0.7,6,36,42,48,8,6,38,29,130,-0.4,0.5,0.0,2016
Jamal Murray,SG,19,82,1764,295,730,0.404,115,344,0.334,180,386,0.466,106,120,0.883,41,173,214,170,51,24,113,124,811,0.6,0.7,1.3,2016
Mike Muscala,C,25,70,1237,170,337,0.504,46,110,0.418,124,227,0.546,49,64,0.766,76,164,240,95,30,41,55,97,435,1.8,1.6,3.4,2016
Larry Nance Jr.,PF,24,63,1442,190,361,0.526,10,36,0.278,180,325,0.554,59,80,0.738,120,249,369,96,82,39,56,149,449,2.1,1.5,3.5,2016
Shabazz Napier,PG,25,53,512,73,183,0.399,34,92,0.37,39,91,0.429,38,49,0.776,8,53,61,67,32,2,41,38,218,0.1,0.5,0.6,2016
Maurice Ndour,PF,24,32,331,39,86,0.453,1,7,0.143,38,79,0.481,19,26,0.731,22,42,64,8,15,8,12,30,98,0.1,0.3,0.4,2016
Gary Neal,SG,32,2,18,0,7,0.0,0,2,0.0,0,5,0.0,4,4,1.0,0,1,1,1,0,0,0,1,4,-0.1,0.0,-0.1,2016
Jameer Nelson,PG,34,75,2045,268,604,0.444,106,273,0.388,162,331,0.489,45,63,0.714,28,164,192,385,54,8,128,197,687,2.3,0.5,2.8,2016
Raul Neto,PG,24,40,346,41,91,0.451,10,31,0.323,31,60,0.517,8,9,0.889,4,26,30,34,21,5,15,48,100,0.2,0.6,0.7,2016
Georges Niang,PF,23,23,93,9,36,0.25,1,12,0.083,8,24,0.333,2,2,1.0,2,15,17,5,3,0,5,6,21,-0.4,0.1,-0.3,2016
Andrew Nicholson,PF,27,38,342,43,111,0.387,5,27,0.185,38,84,0.452,9,14,0.643,15,46,61,10,16,6,17,55,100,-0.5,0.4,-0.1,2016
Joakim Noah,C,31,46,1015,99,202,0.49,0,1,0.0,99,201,0.493,34,78,0.436,162,241,403,103,30,37,58,127,232,1.0,1.2,2.2,2016
Nerlens Noel,C,22,51,1047,184,309,0.595,0,1,0.0,184,308,0.597,77,111,0.694,93,201,294,50,65,50,51,126,445,2.1,1.9,4.0,2016
Lucas Nogueira,C,24,57,1088,103,156,0.66,3,12,0.25,100,144,0.694,44,67,0.657,82,162,244,42,52,89,46,137,253,1.7,2.0,3.7,2016
Steve Novak,PF,33,8,22,2,7,0.286,1,6,0.167,1,1,1.0,0,0,0.0,0,3,3,0,0,0,0,1,5,0.0,0.0,0.0,2016
Dirk Nowitzki*,PF,38,54,1424,296,678,0.437,79,209,0.378,217,469,0.463,98,112,0.875,23,330,353,82,30,38,51,113,769,0.6,1.9,2.5,2016
Jusuf Nurkić,C,22,65,1391,271,534,0.507,0,1,0.0,271,533,0.508,120,210,0.571,154,313,467,123,50,74,143,161,662,0.2,1.8,2.0,2016
David Nwaba,SG,24,20,397,47,81,0.58,1,5,0.2,46,76,0.605,25,39,0.641,17,46,63,14,13,7,11,36,120,0.6,0.2,0.8,2016
Johnny O'Bryant,PF,23,11,80,15,30,0.5,3,6,0.5,12,24,0.5,5,6,0.833,9,10,19,6,0,1,6,10,38,0.1,0.0,0.1,2016
Kyle O'Quinn,C,26,79,1229,215,413,0.521,2,17,0.118,213,396,0.538,64,83,0.771,157,282,439,117,36,104,76,174,496,2.1,1.8,3.9,2016
Daniel Ochefu,C,23,19,75,12,27,0.444,0,0,0.0,12,27,0.444,0,2,0.0,5,17,22,3,2,0,3,17,24,-0.1,0.1,0.0,2016
Jahlil Okafor,C,21,50,1134,242,471,0.514,0,0,0.0,242,471,0.514,106,158,0.671,81,159,240,58,20,49,91,122,590,0.1,1.1,1.2,2016
Victor Oladipo,SG,24,67,2222,412,932,0.442,127,352,0.361,285,580,0.491,116,154,0.753,39,252,291,176,78,21,119,155,1067,1.7,2.3,4.0,2016
Kelly Olynyk,C,25,75,1538,260,508,0.512,68,192,0.354,192,316,0.608,90,123,0.732,73,288,361,148,43,29,96,207,678,2.2,1.9,4.1,2016
Arinze Onuaku,C,29,8,28,2,4,0.5,0,0,0.0,2,4,0.5,0,0,0.0,2,4,6,2,0,1,2,3,4,0.0,0.0,0.0,2016
Chinanu Onuaku,C,20,5,52,5,7,0.714,0,0,0.0,5,7,0.714,4,4,1.0,2,8,10,3,3,1,4,6,14,0.1,0.1,0.1,2016
Kelly Oubre Jr.,SF,21,79,1605,186,442,0.421,54,188,0.287,132,254,0.52,75,99,0.758,61,200,261,47,58,17,50,195,501,0.6,1.5,2.0,2016
Zaza Pachulia,C,32,70,1268,164,307,0.534,0,2,0.0,164,305,0.538,98,126,0.778,140,270,410,132,59,33,87,166,426,2.3,2.5,4.7,2016
Georgios Papagiannis,C,19,22,355,56,102,0.549,0,2,0.0,56,100,0.56,12,14,0.857,24,62,86,20,3,17,24,44,124,0.1,0.3,0.4,2016
Jabari Parker,PF,21,51,1728,399,814,0.49,65,178,0.365,334,636,0.525,162,218,0.743,79,235,314,142,50,22,93,111,1025,2.6,1.5,4.0,2016
Tony Parker*,PG,34,63,1587,265,569,0.466,23,69,0.333,242,500,0.484,85,117,0.726,9,104,113,285,34,2,89,92,638,1.4,1.7,3.0,2016
Chandler Parsons,SF,28,34,675,75,222,0.338,25,93,0.269,50,129,0.388,35,43,0.814,6,78,84,55,20,5,24,52,210,-0.5,0.7,0.2,2016
Lamar Patterson,SG,25,5,40,3,15,0.2,1,6,0.167,2,9,0.222,2,3,0.667,1,6,7,6,1,0,4,6,9,-0.2,0.0,-0.1,2016
Patrick Patterson,PF,27,65,1599,154,384,0.401,94,253,0.372,60,131,0.458,43,60,0.717,62,231,293,76,40,23,38,120,445,1.7,1.6,3.3,2016
Chris Paul,PG,31,61,1921,374,785,0.476,124,302,0.411,250,483,0.518,232,260,0.892,40,264,304,563,119,8,147,146,1104,7.9,2.6,10.6,2016
Adreian Payne,PF,25,18,135,23,54,0.426,3,15,0.2,20,39,0.513,14,19,0.737,9,24,33,7,8,7,8,32,63,0.0,0.2,0.2,2016
Cameron Payne,PG,22,31,462,64,193,0.332,27,86,0.314,37,107,0.346,5,8,0.625,3,45,48,55,14,4,29,52,160,-0.8,0.4,-0.3,2016
Elfrid Payton,PG,22,82,2412,430,912,0.471,40,146,0.274,390,766,0.509,146,211,0.692,89,298,387,529,88,40,178,177,1046,2.4,2.0,4.4,2016
Gary Payton II,PG,24,6,99,8,22,0.364,1,9,0.111,7,13,0.538,3,5,0.6,0,12,12,13,3,4,10,9,20,-0.3,0.1,-0.2,2016
Paul Pierce*,SF,39,25,277,28,70,0.4,15,43,0.349,13,27,0.481,10,13,0.769,1,47,48,10,4,5,16,40,81,-0.2,0.3,0.1,2016
Marshall Plumlee,C,24,21,170,16,30,0.533,0,0,0.0,16,30,0.533,8,19,0.421,23,28,51,10,4,4,12,23,40,0.0,0.1,0.2,2016
Mason Plumlee,C,26,81,2148,334,623,0.536,0,6,0.0,334,617,0.541,174,300,0.58,170,435,605,284,69,92,134,226,842,3.6,2.4,6.0,2016
Miles Plumlee,C,28,45,484,44,92,0.478,0,0,0.0,44,92,0.478,25,39,0.641,38,57,95,21,18,13,30,73,113,-0.1,0.5,0.5,2016
Jakob Poeltl,C,21,54,626,67,115,0.583,0,0,0.0,67,115,0.583,31,57,0.544,78,87,165,12,17,20,29,113,165,0.9,0.7,1.6,2016
Otto Porter Jr.,SF,23,80,2605,414,803,0.516,148,341,0.434,266,462,0.576,99,119,0.832,118,396,514,121,116,42,44,193,1075,6.4,3.0,9.4,2016
Bobby Portis,PF,21,64,1000,183,375,0.488,32,96,0.333,151,279,0.541,39,59,0.661,75,221,296,35,16,11,37,94,437,1.1,1.2,2.4,2016
Kristaps Porziņģis,PF,21,66,2164,443,985,0.45,112,314,0.357,331,671,0.493,198,252,0.786,111,364,475,97,47,129,118,244,1196,2.4,2.1,4.5,2016
Dwight Powell,C,25,77,1333,194,377,0.515,21,74,0.284,173,303,0.571,107,141,0.759,93,213,306,49,61,39,34,135,516,2.7,1.9,4.6,2016
Norman Powell,SG,23,76,1368,227,506,0.449,56,173,0.324,171,333,0.514,126,159,0.792,26,143,169,82,52,14,70,127,636,1.4,1.4,2.8,2016
Alex Poythress,PF,23,6,157,25,54,0.463,6,19,0.316,19,35,0.543,8,10,0.8,11,18,29,5,3,2,3,14,64,0.2,0.1,0.3,2016
Ronnie Price,PG,33,14,134,4,24,0.167,3,17,0.176,1,7,0.143,3,4,0.75,3,8,11,18,11,1,3,14,14,-0.1,0.1,0.0,2016
Taurean Prince,SF,22,59,981,114,285,0.4,33,102,0.324,81,183,0.443,74,94,0.787,25,132,157,55,43,27,61,96,335,-0.4,1.5,1.1,2016
Tim Quarterman,SG,22,16,80,13,29,0.448,5,13,0.385,8,16,0.5,0,3,0.0,4,10,14,11,2,3,11,6,31,-0.1,0.1,-0.1,2016
Chasson Randle,PG,23,26,299,40,98,0.408,16,47,0.34,24,51,0.471,41,43,0.953,6,26,32,34,9,2,19,39,137,0.5,0.1,0.7,2016
Julius Randle,PF,22,74,2132,377,773,0.488,17,63,0.27,360,710,0.507,204,282,0.723,150,486,636,264,49,37,173,248,975,2.0,1.5,3.5,2016
Zach Randolph,PF,35,73,1786,433,964,0.449,21,94,0.223,412,870,0.474,141,193,0.731,182,416,598,122,38,10,99,136,1028,0.8,2.4,3.2,2016
JJ Redick,SG,32,78,2198,396,890,0.445,201,468,0.429,195,422,0.462,180,202,0.891,11,160,171,110,54,13,98,125,1173,3.3,1.5,4.8,2016
Willie Reed,C,26,71,1031,162,285,0.568,1,4,0.25,161,281,0.573,49,88,0.557,129,203,332,26,18,47,31,137,374,2.1,1.5,3.6,2016
Josh Richardson,SG,23,53,1614,202,513,0.394,75,227,0.33,127,286,0.444,60,77,0.779,35,133,168,140,60,39,65,132,539,0.3,1.9,2.2,2016
Malachi Richardson,SG,21,22,198,28,68,0.412,8,28,0.286,20,40,0.5,15,19,0.789,3,20,23,11,5,1,8,23,79,0.0,0.1,0.1,2016
Austin Rivers,SG,24,74,2054,323,731,0.442,111,299,0.371,212,432,0.491,132,191,0.691,20,141,161,204,48,10,115,187,889,1.2,1.3,2.5,2016
Andre Roberson,SF,25,79,2376,215,463,0.464,45,184,0.245,170,279,0.609,47,111,0.423,98,305,403,79,94,79,51,204,522,1.1,3.1,4.2,2016
Brian Roberts,PG,31,41,416,46,122,0.377,17,44,0.386,29,78,0.372,33,39,0.846,5,34,39,52,9,1,26,18,142,0.0,0.3,0.2,2016
Glenn Robinson III,SF,23,69,1427,158,338,0.467,49,125,0.392,109,213,0.512,54,76,0.711,57,189,246,47,41,20,37,63,419,1.3,1.2,2.5,2016
Thomas Robinson,PF,25,48,560,105,196,0.536,0,1,0.0,105,195,0.538,31,66,0.47,84,139,223,31,26,9,46,76,241,0.3,0.6,0.9,2016
Sergio Rodríguez,PG,30,68,1518,210,536,0.392,92,252,0.365,118,284,0.415,18,27,0.667,21,136,157,344,49,4,128,95,530,-0.3,1.0,0.7,2016
Rajon Rondo,PG,30,69,1843,229,561,0.408,50,133,0.376,179,428,0.418,30,50,0.6,73,282,355,461,99,11,169,144,538,-0.4,2.7,2.3,2016
Derrick Rose,PG,28,64,2082,460,977,0.471,13,60,0.217,447,917,0.487,221,253,0.874,66,180,246,283,44,17,147,84,1154,2.4,0.6,3.0,2016
Terrence Ross,SF,25,78,1955,326,746,0.437,142,391,0.363,184,355,0.518,64,77,0.831,18,188,206,88,87,33,68,143,858,1.5,2.0,3.5,2016
Terry Rozier,PG,22,74,1263,151,411,0.367,57,179,0.318,94,232,0.405,51,66,0.773,40,187,227,131,46,11,47,69,410,0.0,1.4,1.4,2016
Ricky Rubio,PG,26,75,2469,261,650,0.402,60,196,0.306,201,454,0.443,254,285,0.891,68,237,305,682,128,10,195,202,836,4.5,1.7,6.1,2016
Damjan Rudež,SF,30,45,314,31,88,0.352,20,64,0.313,11,24,0.458,0,0,0.0,5,20,25,20,12,1,9,31,82,-0.1,0.2,0.1,2016
Brandon Rush,SG,31,47,1030,70,187,0.374,44,114,0.386,26,73,0.356,13,18,0.722,16,83,99,45,22,23,28,42,197,0.1,0.3,0.4,2016
D'Angelo Russell,PG,20,63,1811,351,867,0.405,135,384,0.352,216,483,0.447,147,188,0.782,31,190,221,303,87,16,176,130,984,0.3,1.0,1.3,2016
Domantas Sabonis,PF,20,81,1632,192,481,0.399,51,159,0.321,141,322,0.438,44,67,0.657,46,242,288,82,39,32,83,200,479,-1.0,1.8,0.8,2016
Larry Sanders,C,28,5,13,1,4,0.25,0,0,0.0,1,4,0.25,2,2,1.0,3,1,4,0,1,1,2,5,4,0.0,0.0,0.0,2016
Dario Šarić,PF,22,81,2129,381,927,0.411,106,341,0.311,275,586,0.469,172,220,0.782,112,401,513,182,57,30,183,162,1040,-1.2,2.2,1.0,2016
Tomáš Satoranský,SG,25,57,719,61,147,0.415,9,37,0.243,52,110,0.473,23,33,0.697,25,58,83,92,26,6,38,60,154,0.1,0.5,0.6,2016
Dennis Schröder,PG,23,79,2485,548,1214,0.451,100,294,0.34,448,920,0.487,218,255,0.855,42,206,248,499,74,16,258,149,1414,1.2,2.5,3.7,2016
Luis Scola,PF,36,36,461,71,151,0.47,17,50,0.34,54,101,0.535,25,37,0.676,51,88,139,37,14,4,34,63,184,0.4,0.4,0.8,2016
Mike Scott,PF,28,18,195,17,59,0.288,4,27,0.148,13,32,0.406,7,8,0.875,10,27,37,17,4,3,8,12,45,-0.3,0.2,-0.1,2016
Thabo Sefolosha,SF,32,62,1596,174,395,0.441,41,120,0.342,133,275,0.484,55,75,0.733,54,216,270,107,96,31,58,97,444,0.6,2.7,3.3,2016
Wayne Selden,SG,22,14,236,25,58,0.431,7,28,0.25,18,30,0.6,14,22,0.636,1,15,16,13,6,1,12,18,71,-0.1,0.2,0.1,2016
Kevin Séraphin,PF,27,49,559,109,198,0.551,0,2,0.0,109,196,0.556,14,22,0.636,41,101,142,23,7,20,29,66,232,0.4,0.6,1.0,2016
Ramon Sessions,PG,30,50,811,100,263,0.38,21,62,0.339,79,201,0.393,91,118,0.771,11,62,73,129,27,3,46,43,312,0.3,0.6,0.9,2016
Iman Shumpert,SG,26,76,1937,201,489,0.411,94,261,0.36,107,228,0.469,71,90,0.789,39,179,218,109,62,27,78,150,567,0.7,1.4,2.0,2016
Pascal Siakam,PF,22,55,859,103,205,0.502,1,7,0.143,102,198,0.515,22,32,0.688,64,121,185,17,26,45,33,109,229,0.4,1.2,1.6,2016
Jonathon Simmons,SG,27,78,1392,177,421,0.42,30,102,0.294,147,319,0.461,99,132,0.75,20,140,160,126,47,25,76,146,483,-0.1,2.1,2.0,2016
Kyle Singler,SF,28,32,385,34,83,0.41,7,37,0.189,27,46,0.587,13,17,0.765,8,40,48,9,7,5,11,29,88,0.0,0.3,0.3,2016
Marcus Smart,SG,22,79,2399,269,749,0.359,94,332,0.283,175,417,0.42,203,250,0.812,78,227,305,364,125,34,159,192,835,0.5,2.7,3.2,2016
Ish Smith,PG,28,81,1955,329,749,0.439,28,105,0.267,301,644,0.467,72,102,0.706,21,214,235,418,61,33,112,127,758,0.9,2.2,3.1,2016
J.R. Smith,SG,31,41,1187,123,356,0.346,95,271,0.351,28,85,0.329,10,15,0.667,17,96,113,62,40,11,26,77,351,0.1,0.8,0.8,2016
Jason Smith,C,30,74,1068,174,329,0.529,37,78,0.474,137,251,0.546,35,51,0.686,64,194,258,37,21,54,58,168,420,1.0,1.3,2.3,2016
Tony Snell,SG,25,80,2336,246,541,0.455,144,355,0.406,102,186,0.548,47,58,0.81,22,226,248,96,55,14,55,125,683,2.1,1.3,3.4,2016
Marreese Speights,C,29,82,1286,244,548,0.445,103,277,0.372,141,271,0.52,120,137,0.876,88,285,373,65,23,41,69,229,711,2.5,1.7,4.2,2016
Tiago Splitter,C,32,8,76,14,31,0.452,2,6,0.333,12,25,0.48,9,11,0.818,8,14,22,4,1,1,6,8,39,0.1,0.1,0.1,2016
Nik Stauskas,SG,23,80,2188,251,634,0.396,132,359,0.368,119,275,0.433,122,150,0.813,21,205,226,188,45,32,128,144,756,0.1,1.4,1.4,2016
Lance Stephenson,SG,26,18,361,54,120,0.45,6,20,0.3,48,100,0.48,8,13,0.615,4,48,52,59,5,3,26,32,122,-0.2,0.2,0.1,2016
Jarnell Stokes,C,23,2,7,1,1,1.0,0,0,0.0,1,1,1.0,1,2,0.5,1,1,2,2,1,0,0,3,3,0.1,0.0,0.1,2016
Diamond Stone,C,19,7,24,3,13,0.231,0,0,0.0,3,13,0.231,4,4,1.0,1,5,6,0,0,1,2,5,10,-0.1,0.0,-0.1,2016
Rodney Stuckey,PG,30,39,696,91,244,0.373,19,60,0.317,72,184,0.391,80,107,0.748,6,78,84,84,16,0,53,44,281,-0.5,0.4,-0.1,2016
Jared Sullinger,PF,24,11,118,15,47,0.319,3,18,0.167,12,29,0.414,4,8,0.5,10,17,27,3,4,1,4,17,37,-0.2,0.1,-0.1,2016
Edy Tavares,C,24,2,28,4,5,0.8,0,0,0.0,4,5,0.8,0,3,0.0,4,7,11,1,0,6,2,3,8,0.0,0.1,0.1,2016
Isaiah Taylor,PG,22,4,52,1,7,0.143,0,2,0.0,1,5,0.2,1,2,0.5,1,2,3,3,1,1,0,6,3,-0.1,0.0,0.0,2016
Jeff Teague,PG,28,82,2657,402,909,0.442,90,252,0.357,312,657,0.475,360,415,0.867,33,297,330,639,100,32,216,165,1254,5.7,2.4,8.1,2016
Mirza Teletović,PF,31,70,1133,156,418,0.373,104,305,0.341,52,113,0.46,35,45,0.778,11,151,162,48,12,13,37,109,451,-0.1,0.7,0.6,2016
Garrett Temple,SG,30,65,1728,183,432,0.424,82,220,0.373,101,212,0.476,58,74,0.784,32,152,184,168,84,28,78,141,506,0.9,1.3,2.2,2016
Jason Terry,SG,39,74,1365,105,243,0.432,73,171,0.427,32,72,0.444,24,29,0.828,15,91,106,98,46,20,36,95,307,1.2,0.9,2.1,2016
Isaiah Thomas,PG,27,76,2569,682,1473,0.463,245,646,0.379,437,827,0.528,590,649,0.909,43,162,205,448,70,13,210,167,2199,10.9,1.6,12.5,2016
Lance Thomas,PF,28,46,968,97,244,0.398,38,85,0.447,59,159,0.371,43,51,0.843,32,110,142,35,21,5,25,85,275,0.6,0.4,0.9,2016
Hollis Thompson,SG,25,40,752,77,200,0.385,32,95,0.337,45,105,0.429,19,29,0.655,19,93,112,35,20,6,11,69,205,0.1,0.6,0.7,2016
Klay Thompson,SG,26,78,2649,644,1376,0.468,268,647,0.414,376,729,0.516,186,218,0.853,49,236,285,160,66,40,128,139,1742,4.2,2.9,7.1,2016
Tristan Thompson,C,25,78,2336,262,437,0.6,0,3,0.0,262,434,0.604,106,213,0.498,286,429,715,77,39,84,64,176,630,5.0,2.3,7.3,2016
Marcus Thornton,SG,29,33,575,84,210,0.4,28,80,0.35,56,130,0.431,23,27,0.852,22,54,76,41,19,3,25,48,219,0.1,0.4,0.5,2016
Mike Tobey,C,22,2,25,1,4,0.25,0,0,0.0,1,4,0.25,0,0,0.0,2,1,3,1,0,0,1,2,2,0.0,0.0,0.0,2016
Anthony Tolliver,PF,31,65,1477,155,351,0.442,90,230,0.391,65,121,0.537,61,82,0.744,51,186,237,77,34,20,56,109,461,1.5,0.8,2.3,2016
Axel Toupane,SF,24,4,47,5,9,0.556,1,4,0.25,4,5,0.8,0,0,0.0,0,1,1,0,1,1,0,6,11,0.0,0.0,0.1,2016
Karl-Anthony Towns,C,21,82,3030,802,1480,0.542,101,275,0.367,701,1205,0.582,356,428,0.832,296,711,1007,220,56,103,212,241,2061,9.9,2.8,12.7,2016
P.J. Tucker,SF,31,81,2236,199,482,0.413,70,196,0.357,129,286,0.451,72,93,0.774,117,354,471,99,116,19,66,196,540,1.4,2.2,3.6,2016
Evan Turner,SF,28,65,1658,235,552,0.426,31,118,0.263,204,434,0.47,85,103,0.825,36,211,247,205,53,24,100,121,586,0.0,1.2,1.2,2016
Myles Turner,C,20,81,2541,444,869,0.511,40,115,0.348,404,754,0.536,245,303,0.809,139,450,589,106,74,172,105,262,1173,4.3,3.7,8.0,2016
Beno Udrih,PG,34,39,560,92,197,0.467,11,32,0.344,81,165,0.491,32,34,0.941,6,51,57,131,13,0,36,29,227,0.8,0.5,1.3,2016
Tyler Ulis,PG,21,61,1123,184,437,0.421,21,79,0.266,163,358,0.455,55,71,0.775,20,75,95,226,48,5,77,73,444,0.3,0.4,0.7,2016
Jarrod Uthoff,PF,23,9,115,16,38,0.421,3,9,0.333,13,29,0.448,5,7,0.714,8,14,22,9,2,4,3,8,40,0.1,0.1,0.2,2016
Jonas Valančiūnas,C,24,80,2066,391,702,0.557,1,2,0.5,390,700,0.557,176,217,0.811,226,533,759,57,37,63,106,216,959,4.9,3.0,7.9,2016
Denzel Valentine,SG,23,57,976,102,288,0.354,73,208,0.351,29,80,0.363,14,18,0.778,11,140,151,63,30,7,49,86,291,-0.5,1.1,0.6,2016
Fred VanVleet,PG,22,37,294,39,111,0.351,11,29,0.379,28,82,0.341,18,22,0.818,4,38,42,35,16,3,15,36,107,-0.1,0.4,0.2,2016
Anderson Varejão,C,34,14,92,5,14,0.357,0,0,0.0,5,14,0.357,8,11,0.727,12,15,27,10,3,3,8,16,18,0.0,0.1,0.2,2016
Greivis Vásquez,PG,30,3,39,2,8,0.25,1,3,0.333,1,5,0.2,2,3,0.667,0,2,2,5,1,1,1,6,7,0.0,0.0,0.0,2016
Rashad Vaughn,SG,20,41,458,57,156,0.365,26,81,0.321,31,75,0.413,2,5,0.4,4,45,49,23,19,10,14,32,142,-0.5,0.4,0.0,2016
Noah Vonleh,PF,21,74,1265,130,270,0.481,7,20,0.35,123,250,0.492,60,94,0.638,131,256,387,31,30,27,64,154,327,0.6,1.2,1.8,2016
Nikola Vučević,C,26,75,2163,483,1031,0.468,23,75,0.307,460,956,0.481,107,160,0.669,176,603,779,208,76,74,117,180,1096,0.8,3.1,4.0,2016
Sasha Vujačić,SG,32,42,408,42,136,0.309,23,74,0.311,19,62,0.306,17,24,0.708,12,47,59,52,13,2,16,38,124,-0.1,0.2,0.1,2016
Dwyane Wade*,SG,35,60,1792,414,955,0.434,45,145,0.31,369,810,0.456,223,281,0.794,63,207,270,228,86,41,138,112,1096,0.9,2.5,3.4,2016
Dion Waiters,SG,25,46,1384,281,663,0.424,85,215,0.395,196,448,0.438,82,127,0.646,18,135,153,200,42,20,103,95,729,0.2,1.5,1.6,2016
Kemba Walker,PG,26,79,2739,643,1449,0.444,240,602,0.399,403,847,0.476,304,359,0.847,45,263,308,434,85,22,168,119,1830,5.9,2.2,8.1,2016
John Wall,PG,26,78,2836,647,1435,0.451,89,272,0.327,558,1163,0.48,422,527,0.801,59,267,326,831,157,49,322,151,1805,5.8,3.0,8.8,2016
T.J. Warren,SF,23,66,2048,403,814,0.495,26,98,0.265,377,716,0.527,119,154,0.773,125,214,339,75,76,39,57,175,951,3.0,1.1,4.1,2016
C.J. Watson,PG,32,62,1012,96,248,0.387,32,105,0.305,64,143,0.448,57,66,0.864,16,73,89,114,43,2,47,84,281,0.2,0.6,0.9,2016
Briante Weber,PG,24,20,205,25,60,0.417,1,10,0.1,24,50,0.48,11,16,0.688,8,18,26,21,12,1,8,16,62,0.0,0.2,0.3,2016
David West,C,36,68,854,135,252,0.536,3,8,0.375,132,244,0.541,43,56,0.768,47,156,203,151,42,48,78,105,316,0.9,1.7,2.6,2016
Russell Westbrook,PG,28,81,2802,824,1941,0.425,200,583,0.343,624,1358,0.459,710,840,0.845,137,727,864,840,132,31,438,190,2558,8.5,4.6,13.1,2016
Okaro White,PF,24,35,471,33,87,0.379,12,34,0.353,21,53,0.396,20,22,0.909,25,57,82,21,10,10,18,52,98,0.1,0.5,0.6,2016
Isaiah Whitehead,PG,21,73,1643,204,508,0.402,44,149,0.295,160,359,0.446,91,113,0.805,32,152,184,192,42,36,142,175,543,-1.7,0.9,-0.8,2016
Hassan Whiteside,C,27,77,2513,542,973,0.557,0,0,0.0,542,973,0.557,225,358,0.628,293,795,1088,57,57,161,154,226,1309,4.2,5.3,9.5,2016
Andrew Wiggins,SF,21,82,3048,709,1570,0.452,103,289,0.356,606,1281,0.473,412,542,0.76,102,226,328,189,82,30,187,183,1933,3.3,0.9,4.2,2016
C.J. Wilcox,SG,26,22,108,8,31,0.258,3,15,0.2,5,16,0.313,2,2,1.0,4,8,12,12,2,1,6,8,21,-0.2,0.0,-0.2,2016
Alan Williams,C,24,47,708,138,267,0.517,0,1,0.0,138,266,0.519,70,112,0.625,94,198,292,23,27,32,37,125,346,1.1,0.9,2.1,2016
Deron Williams,PG,32,64,1657,263,600,0.438,85,234,0.363,178,366,0.486,90,109,0.826,14,133,147,360,31,8,138,138,701,1.5,0.9,2.4,2016
Derrick Williams,PF,25,50,804,108,244,0.443,30,97,0.309,78,147,0.531,58,89,0.652,19,111,130,28,14,7,28,60,304,0.4,0.6,1.1,2016
Lou Williams,SG,30,81,1994,428,998,0.429,163,446,0.365,265,552,0.48,402,457,0.88,26,176,202,239,80,20,160,92,1421,5.1,1.0,6.1,2016
Marvin Williams,PF,30,76,2295,297,704,0.422,124,354,0.35,173,350,0.494,131,150,0.873,89,411,500,106,58,53,60,134,849,2.4,2.6,5.0,2016
Reggie Williams,SF,30,6,79,8,23,0.348,5,11,0.455,3,12,0.25,6,7,0.857,2,4,6,4,3,0,0,2,27,0.1,0.1,0.2,2016
Troy Williams,SF,22,30,557,73,167,0.437,18,62,0.29,55,105,0.524,21,32,0.656,15,54,69,25,27,10,32,60,185,-0.3,0.7,0.4,2016
Kyle Wiltjer,PF,24,14,44,4,14,0.286,4,13,0.308,0,1,0.0,1,2,0.5,4,6,10,2,3,1,5,4,13,-0.1,0.1,0.0,2016
Justise Winslow,SF,20,18,625,80,225,0.356,7,35,0.2,73,190,0.384,29,47,0.617,23,71,94,66,26,6,33,52,196,-0.9,0.8,-0.1,2016
Jeff Withey,C,26,51,432,55,103,0.534,0,1,0.0,55,102,0.539,36,48,0.75,52,69,121,7,16,32,14,52,146,1.0,0.9,1.8,2016
Christian Wood,PF,21,13,107,12,23,0.522,0,5,0.0,12,18,0.667,11,15,0.733,14,15,29,2,3,6,7,11,35,0.1,0.1,0.3,2016
Metta World Peace,SF,37,25,160,19,68,0.279,9,38,0.237,10,30,0.333,10,16,0.625,5,15,20,11,10,2,7,18,57,-0.3,0.1,-0.2,2016
Brandan Wright,PF,29,28,447,83,135,0.615,0,1,0.0,83,134,0.619,23,35,0.657,31,47,78,15,11,20,10,42,189,1.1,0.5,1.6,2016
Delon Wright,PG,24,27,446,49,116,0.422,10,30,0.333,39,86,0.453,42,55,0.764,16,32,48,57,27,11,25,31,150,0.5,0.6,1.1,2016
James Young,SG,21,29,220,25,58,0.431,12,35,0.343,13,23,0.565,6,9,0.667,6,20,26,4,10,2,4,15,68,0.1,0.2,0.3,2016
Joe Young,PG,24,33,135,26,72,0.361,5,23,0.217,21,49,0.429,11,15,0.733,1,16,17,15,4,0,5,5,68,-0.2,0.1,-0.1,2016
Nick Young,SG,31,60,1556,272,633,0.43,170,421,0.404,102,212,0.481,77,90,0.856,25,113,138,58,37,14,36,137,791,3.0,0.2,3.2,2016
Thaddeus Young,PF,28,74,2237,362,687,0.527,45,118,0.381,317,569,0.557,45,86,0.523,131,317,448,122,113,29,95,135,814,2.0,2.7,4.6,2016
Cody Zeller,C,24,62,1725,253,443,0.571,0,1,0.0,253,442,0.572,133,196,0.679,135,270,405,99,62,58,65,189,639,3.4,2.2,5.6,2016
Tyler Zeller,C,27,51,525,78,158,0.494,0,1,0.0,78,157,0.497,22,39,0.564,43,81,124,42,7,21,20,61,178,0.5,0.6,1.0,2016
Stephen Zimmerman,C,20,19,108,10,31,0.323,0,0,0.0,10,31,0.323,3,5,0.6,11,24,35,4,2,5,3,17,23,-0.1,0.1,0.0,2016
Paul Zipser,SF,22,44,843,88,221,0.398,33,99,0.333,55,122,0.451,31,40,0.775,15,110,125,36,15,16,40,78,240,-0.3,0.8,0.5,2016
Ivica Zubac,C,19,38,609,126,238,0.529,0,3,0.0,126,235,0.536,32,49,0.653,41,118,159,30,14,33,30,66,284,0.6,0.5,1.1,2016
Álex Abrines,SG,24,75,1134,115,291,0.395,84,221,0.38,31,70,0.443,39,46,0.848,26,88,114,28,38,8,25,124,353,1.3,1.0,2.2,2017
Quincy Acy,PF,27,70,1359,130,365,0.356,102,292,0.349,28,73,0.384,49,60,0.817,40,217,257,57,33,29,60,149,411,-0.1,1.1,1.0,2017
Steven Adams,C,24,76,2487,448,712,0.629,0,2,0.0,448,710,0.631,160,286,0.559,384,301,685,88,92,78,128,215,1056,6.7,3.0,9.7,2017
Bam Adebayo,C,20,69,1368,174,340,0.512,0,7,0.0,174,333,0.523,129,179,0.721,118,263,381,101,32,41,66,138,477,2.3,1.9,4.2,2017
Arron Afflalo,SG,32,53,682,65,162,0.401,27,70,0.386,38,92,0.413,22,26,0.846,4,62,66,30,4,9,21,56,179,-0.1,0.2,0.1,2017
Cole Aldrich,C,29,21,49,5,15,0.333,0,0,0.0,5,15,0.333,2,6,0.333,3,12,15,3,2,1,1,11,12,-0.1,0.1,0.0,2017
LaMarcus Aldridge,C,32,75,2509,687,1347,0.51,27,92,0.293,660,1255,0.526,334,399,0.837,246,389,635,152,43,90,111,161,1735,7.4,3.5,10.9,2017
Jarrett Allen,C,19,72,1441,234,397,0.589,5,15,0.333,229,382,0.599,114,147,0.776,144,244,388,49,28,88,82,147,587,2.7,1.5,4.2,2017
Kadeem Allen,PG,25,18,107,6,22,0.273,0,11,0.0,6,11,0.545,7,9,0.778,4,7,11,12,3,2,9,15,19,-0.2,0.1,-0.1,2017
Tony Allen,SF,36,22,273,44,91,0.484,4,12,0.333,40,79,0.506,11,21,0.524,20,27,47,9,11,3,19,49,103,-0.2,0.2,0.1,2017
Al-Farouq Aminu,PF,27,69,2072,230,582,0.395,125,339,0.369,105,243,0.432,59,80,0.738,97,428,525,84,79,40,79,136,644,0.9,3.2,4.2,2017
Justin Anderson,SF,24,38,519,87,202,0.431,34,103,0.33,53,99,0.535,28,38,0.737,25,68,93,25,15,7,16,54,236,0.6,0.7,1.2,2017
Kyle Anderson,SF,24,74,1978,231,438,0.527,19,57,0.333,212,381,0.556,104,146,0.712,84,312,396,202,115,60,94,114,585,2.4,3.8,6.2,2017
Ryan Anderson,PF,29,66,1725,207,480,0.431,131,339,0.386,76,141,0.539,72,93,0.774,94,237,331,60,24,21,42,126,617,3.1,1.7,4.8,2017
Ike Anigbogu,C,19,11,30,4,9,0.444,0,0,0.0,4,9,0.444,5,6,0.833,5,4,9,0,1,3,2,1,13,0.1,0.0,0.1,2017
Giannis Antetokounmpo,PF,23,75,2756,742,1402,0.529,43,140,0.307,699,1262,0.554,487,641,0.76,156,597,753,361,109,106,223,231,2014,8.3,3.6,11.9,2017
Carmelo Anthony,PF,33,78,2501,472,1168,0.404,169,474,0.357,303,694,0.437,148,193,0.767,67,386,453,103,47,49,99,197,1261,1.2,2.5,3.7,2017
OG Anunoby,SF,20,74,1481,163,346,0.471,73,197,0.371,90,149,0.604,39,62,0.629,44,140,184,55,52,14,45,130,438,1.4,1.6,3.0,2017
Ryan Arcidiacono,PG,23,24,304,17,41,0.415,9,31,0.29,8,10,0.8,5,6,0.833,1,24,25,35,13,0,13,18,48,0.1,0.2,0.3,2017
Trevor Ariza,SF,32,67,2269,268,651,0.412,170,462,0.368,98,189,0.519,76,89,0.854,33,261,294,105,98,13,52,132,782,2.6,2.8,5.3,2017
Darrell Arthur,PF,29,19,141,22,47,0.468,8,23,0.348,14,24,0.583,2,3,0.667,3,12,15,9,8,3,15,22,54,-0.2,0.1,0.0,2017
Jamel Artis,SG,25,15,279,31,79,0.392,8,29,0.276,23,50,0.46,7,12,0.583,4,34,38,18,2,3,8,11,77,-0.1,0.1,0.0,2017
Ömer Aşık,C,31,18,182,9,22,0.409,0,0,0.0,9,22,0.409,4,13,0.308,9,38,47,3,2,4,9,20,22,-0.2,0.2,-0.1,2017
D.J. Augustin,PG,30,75,1760,244,540,0.452,114,272,0.419,130,268,0.485,164,189,0.868,30,130,160,287,54,0,123,94,766,3.3,0.8,4.1,2017
Luke Babbitt,SF,28,50,715,91,215,0.423,60,156,0.385,31,59,0.525,17,22,0.773,7,89,96,31,8,7,19,54,259,0.5,0.4,0.9,2017
Dwayne Bacon,SG,22,53,713,72,192,0.375,11,43,0.256,61,149,0.409,20,25,0.8,4,120,124,38,16,2,23,46,175,-0.7,0.6,-0.1,2017
Ron Baker,SG,24,29,385,20,59,0.339,11,33,0.333,9,26,0.346,20,26,0.769,5,25,30,47,26,6,18,33,71,0.1,0.4,0.5,2017
Wade Baldwin,PG,21,7,80,14,21,0.667,4,5,0.8,10,16,0.625,6,10,0.6,1,7,8,5,2,1,4,12,38,0.2,0.1,0.3,2017
Lonzo Ball,PG,20,52,1780,203,564,0.36,90,295,0.305,113,269,0.42,32,71,0.451,69,291,360,376,88,43,136,117,528,-0.5,2.5,2.0,2017
J.J. Barea,PG,33,69,1603,303,690,0.439,115,313,0.367,188,377,0.499,80,102,0.784,15,186,201,434,35,3,143,83,801,2.3,1.0,3.3,2017
Harrison Barnes,PF,25,77,2634,537,1208,0.445,119,333,0.357,418,875,0.478,259,313,0.827,77,391,468,152,49,14,118,94,1452,2.0,1.9,3.8,2017
Will Barton,SG,27,81,2683,465,1028,0.452,156,422,0.37,309,606,0.51,182,226,0.805,70,339,409,331,82,52,149,168,1268,4.4,1.8,6.2,2017
Nicolas Batum,SG,29,64,1981,270,650,0.415,92,274,0.336,178,376,0.473,108,130,0.831,57,249,306,349,65,23,131,72,740,1.7,1.8,3.5,2017
Jerryd Bayless,SG,29,39,925,109,262,0.416,54,146,0.37,55,116,0.474,35,44,0.795,15,65,80,54,23,6,46,91,307,0.2,0.9,1.1,2017
Aron Baynes,C,31,81,1485,210,446,0.471,3,21,0.143,207,425,0.487,59,78,0.756,130,304,434,93,22,51,80,200,482,0.5,2.5,3.0,2017
Kent Bazemore,SG,28,65,1789,284,676,0.42,108,274,0.394,176,402,0.438,160,201,0.796,25,223,248,228,100,45,157,147,836,0.2,2.0,2.2,2017
Bradley Beal,SG,24,82,2977,683,1484,0.46,199,530,0.375,484,954,0.507,292,369,0.791,61,302,363,373,96,36,214,160,1857,4.4,2.5,6.9,2017
Malik Beasley,SG,21,62,583,73,178,0.41,28,82,0.341,45,96,0.469,22,33,0.667,14,57,71,31,15,7,24,36,196,0.1,0.3,0.3,2017
Michael Beasley,PF,29,74,1653,409,807,0.507,34,86,0.395,375,721,0.52,124,159,0.78,97,317,414,123,36,43,143,145,976,0.9,1.5,2.4,2017
Marco Belinelli,SG,31,80,1947,337,764,0.441,149,395,0.377,188,369,0.509,148,163,0.908,20,131,151,148,66,12,94,91,971,2.4,1.3,3.7,2017
Jordan Bell,C,23,57,809,116,185,0.627,0,4,0.0,116,181,0.641,30,44,0.682,60,147,207,102,35,56,51,92,262,1.6,1.4,2.9,2017
DeAndre' Bembry,SF,23,26,455,53,128,0.414,11,30,0.367,42,98,0.429,19,33,0.576,8,64,72,49,21,12,47,38,136,-0.9,0.5,-0.4,2017
Dragan Bender,PF,20,82,2069,187,484,0.386,118,322,0.366,69,162,0.426,39,51,0.765,40,321,361,130,22,53,112,166,531,-0.7,0.8,0.1,2017
Dāvis Bertāns,PF,25,77,1086,161,366,0.44,94,252,0.373,67,114,0.588,40,49,0.816,18,135,153,74,26,28,36,93,456,1.6,1.4,3.1,2017
Patrick Beverley,SG,29,11,334,48,119,0.403,24,60,0.4,24,59,0.407,14,17,0.824,16,29,45,32,19,5,25,34,134,0.1,0.3,0.4,2017
Khem Birch,C,25,42,578,68,126,0.54,0,0,0.0,68,126,0.54,42,61,0.689,70,110,180,34,15,21,21,56,178,1.2,0.6,1.8,2017
Jabari Bird,SG,23,13,115,15,26,0.577,3,7,0.429,12,19,0.632,6,13,0.462,6,13,19,8,3,1,8,7,39,0.1,0.2,0.2,2017
Bismack Biyombo,C,25,82,1495,183,352,0.52,0,1,0.0,183,351,0.521,102,157,0.65,144,324,468,66,21,95,84,158,468,1.1,1.8,2.9,2017
Nemanja Bjelica,PF,29,67,1371,171,371,0.461,76,183,0.415,95,188,0.505,36,45,0.8,53,221,274,86,50,16,52,141,454,1.7,1.1,2.8,2017
Tarik Black,C,26,51,536,75,127,0.591,1,11,0.091,74,116,0.638,29,63,0.46,63,100,163,13,21,30,35,107,180,0.5,1.0,1.5,2017
Antonio Blakeney,SG,21,19,314,53,143,0.371,15,52,0.288,38,91,0.418,30,39,0.769,4,29,33,20,7,1,11,19,151,-0.2,0.1,0.0,2017
Eric Bledsoe,PG,28,74,2322,468,989,0.473,125,360,0.347,343,629,0.545,252,317,0.795,51,233,284,370,149,42,216,185,1313,3.1,2.5,5.6,2017
Vander Blue,SG,25,5,45,1,5,0.2,0,2,0.0,1,3,0.333,1,2,0.5,0,1,1,3,1,0,3,2,3,-0.1,0.0,-0.1,2017
Bogdan Bogdanović,SG,25,78,2175,344,772,0.446,129,329,0.392,215,443,0.485,100,119,0.84,31,192,223,258,72,16,125,172,917,1.8,1.1,2.9,2017
Bojan Bogdanović,SF,28,80,2464,404,852,0.474,155,386,0.402,249,466,0.534,178,205,0.868,30,240,270,119,55,8,106,129,1141,3.8,1.6,5.4,2017
Andrew Bogut,C,33,24,216,17,25,0.68,0,0,0.0,17,25,0.68,2,2,1.0,26,52,78,15,4,13,19,40,36,0.1,0.3,0.4,2017
Joel Bolomboy,PF,24,6,38,3,6,0.5,0,1,0.0,3,5,0.6,3,6,0.5,6,4,10,0,2,0,2,3,9,0.0,0.0,0.1,2017
Devin Booker,SG,21,54,1865,455,1054,0.432,147,384,0.383,308,670,0.46,289,329,0.878,26,218,244,253,47,14,194,168,1346,1.9,0.6,2.4,2017
Trevor Booker,PF,30,68,1158,177,343,0.516,8,33,0.242,169,310,0.545,66,93,0.71,117,201,318,82,28,21,59,119,428,1.6,1.3,2.9,2017
Chris Boucher,PF,25,1,1,0,1,0.0,0,1,0.0,0,0,0.0,0,0,0.0,0,1,1,0,0,0,0,0,0,0.0,0.0,0.0,2017
Avery Bradley,SG,27,46,1433,259,625,0.414,75,203,0.369,184,422,0.436,63,82,0.768,22,94,116,94,51,8,101,92,656,-1.4,1.2,-0.2,2017
Tony Bradley,C,20,9,29,3,11,0.273,0,1,0.0,3,10,0.3,2,2,1.0,4,7,11,1,0,0,0,1,8,0.0,0.0,0.0,2017
Corey Brewer,SF,31,72,1208,142,316,0.449,31,110,0.282,111,206,0.539,65,90,0.722,43,111,154,65,79,14,49,139,380,0.7,1.6,2.3,2017
Malcolm Brogdon,PG,25,48,1436,244,503,0.485,62,161,0.385,182,342,0.532,75,85,0.882,23,133,156,152,41,13,66,128,625,2.0,0.7,2.7,2017
Aaron Brooks,PG,33,32,189,28,69,0.406,11,31,0.355,17,38,0.447,8,11,0.727,7,10,17,20,6,0,11,28,75,0.1,0.1,0.1,2017
Dillon Brooks,SF,22,82,2350,340,772,0.44,94,264,0.356,246,508,0.484,124,166,0.747,49,208,257,135,73,17,124,233,898,0.1,1.1,1.2,2017
MarShon Brooks,SG,29,7,193,51,102,0.5,19,32,0.594,32,70,0.457,20,23,0.87,8,13,21,25,11,3,16,6,141,0.6,0.2,0.7,2017
Anthony Brown,SF,25,1,4,1,1,1.0,1,1,1.0,0,0,0.0,0,0,0.0,0,0,0,1,0,0,0,0,3,0.0,0.0,0.0,2017
Bobby Brown,PG,33,20,115,19,58,0.328,11,40,0.275,8,18,0.444,1,2,0.5,0,7,7,11,4,0,9,6,50,-0.3,0.1,-0.2,2017
Jaylen Brown,SG,21,70,2152,373,803,0.465,121,306,0.395,252,497,0.507,150,233,0.644,66,280,346,114,70,26,124,181,1017,1.2,3.2,4.5,2017
Lorenzo Brown,PG,27,14,139,14,34,0.412,2,12,0.167,12,22,0.545,2,2,1.0,1,14,15,13,5,0,3,7,32,0.0,0.1,0.2,2017
Markel Brown,SG,26,4,31,2,7,0.286,1,5,0.2,1,2,0.5,0,0,0.0,1,4,5,2,0,0,2,6,5,-0.1,0.0,0.0,2017
Sterling Brown,SG,22,54,776,82,205,0.4,32,91,0.352,50,114,0.439,21,24,0.875,27,116,143,25,31,13,25,80,217,0.0,0.7,0.7,2017
Nicolás Brussino,SF,24,4,10,0,2,0.0,0,2,0.0,0,0,0.0,0,0,0.0,0,3,3,0,0,0,0,0,0,0.0,0.0,0.0,2017
Thomas Bryant,C,20,15,72,8,21,0.381,1,10,0.1,7,11,0.636,5,9,0.556,3,14,17,6,1,2,2,6,22,0.0,0.1,0.1,2017
Reggie Bullock,SF,26,62,1732,267,546,0.489,125,281,0.445,142,265,0.536,39,49,0.796,27,127,154,95,47,13,47,70,698,2.8,1.4,4.2,2017
Trey Burke,PG,25,36,785,193,384,0.503,38,105,0.362,155,279,0.556,37,57,0.649,13,58,71,170,24,4,43,43,461,2.0,0.3,2.4,2017
Alec Burks,SG,26,64,1059,170,414,0.411,47,142,0.331,123,272,0.452,107,124,0.863,19,173,192,67,37,8,60,75,494,0.2,1.6,1.9,2017
Jimmy Butler,SG,28,59,2164,437,921,0.474,70,200,0.35,367,721,0.509,363,425,0.854,79,235,314,288,116,24,108,78,1307,7.1,1.8,8.9,2017
Dwight Buycks,PG,28,29,427,82,198,0.414,15,45,0.333,67,153,0.438,36,41,0.878,12,29,41,59,19,2,39,39,215,-0.2,0.4,0.2,2017
Bruno Caboclo,SF,22,12,107,9,31,0.29,3,17,0.176,6,14,0.429,5,6,0.833,7,15,22,4,3,4,4,8,26,-0.1,0.1,0.0,2017
José Calderón,PG,36,57,914,93,185,0.503,45,97,0.464,48,88,0.545,24,30,0.8,14,70,84,117,27,2,41,81,255,1.5,0.3,1.8,2017
Kentavious Caldwell-Pope,SG,24,74,2458,340,798,0.426,159,415,0.383,181,383,0.473,153,194,0.789,60,327,387,162,106,16,97,145,992,2.6,2.7,5.3,2017
Isaiah Canaan,PG,26,20,422,52,137,0.38,22,66,0.333,30,71,0.423,46,51,0.902,6,39,45,76,16,1,29,36,172,0.5,0.1,0.6,2017
Clint Capela,C,23,74,2034,441,676,0.652,0,1,0.0,441,675,0.653,144,257,0.56,241,561,802,68,58,137,103,185,1026,6.2,4.1,10.2,2017
DeMarre Carroll,PF,31,73,2180,325,785,0.414,145,391,0.371,180,394,0.457,188,246,0.764,105,374,479,147,59,30,103,165,983,2.3,1.8,4.1,2017
Vince Carter*,SF,41,58,1026,114,283,0.403,57,165,0.345,57,118,0.483,28,37,0.757,18,130,148,69,42,26,36,96,313,0.3,0.9,1.2,2017
Michael Carter-Williams,PG,26,52,835,76,229,0.332,14,59,0.237,62,170,0.365,73,89,0.82,37,101,138,116,44,23,52,99,239,-0.2,1.1,0.9,2017
Alex Caruso,PG,23,37,562,50,116,0.431,13,43,0.302,37,73,0.507,21,30,0.7,15,50,65,75,23,10,42,52,134,-0.1,0.6,0.5,2017
Omri Casspi,SF,29,53,740,120,207,0.58,10,22,0.455,110,185,0.595,50,69,0.725,30,170,200,51,18,19,37,71,300,1.2,1.0,2.2,2017
Willie Cauley-Stein,C,24,73,2044,388,773,0.502,3,12,0.25,385,761,0.506,153,247,0.619,131,379,510,172,77,67,109,185,932,1.7,2.2,3.9,2017
Tyler Cavanaugh,PF,23,39,518,67,152,0.441,32,89,0.36,35,63,0.556,17,21,0.81,45,82,127,27,9,4,14,61,183,0.9,0.3,1.2,2017
Mario Chalmers,PG,31,66,1421,168,443,0.379,53,191,0.277,115,252,0.456,118,138,0.855,13,144,157,197,79,14,117,179,507,-0.6,1.3,0.6,2017
Tyson Chandler,C,35,46,1151,121,187,0.647,0,0,0.0,121,187,0.647,58,93,0.624,134,284,418,53,16,27,59,106,300,1.9,0.8,2.7,2017
Wilson Chandler,SF,30,74,2346,281,631,0.445,88,246,0.358,193,385,0.501,88,114,0.772,102,296,398,159,43,39,92,156,738,2.1,1.2,3.3,2017
Marquese Chriss,PF,20,72,1527,202,477,0.423,56,190,0.295,146,287,0.509,96,158,0.608,76,319,395,83,51,70,107,205,556,-0.8,1.5,0.7,2017
Ian Clark,SG,26,74,1455,222,495,0.448,62,195,0.318,160,300,0.533,45,59,0.763,10,117,127,110,33,10,57,120,551,0.3,0.8,1.1,2017
Jordan Clarkson,SG,25,81,1888,430,954,0.451,112,318,0.352,318,636,0.5,152,190,0.8,57,160,217,221,58,6,127,107,1124,1.9,1.2,3.0,2017
Gian Clavell,SG,24,7,64,6,18,0.333,6,15,0.4,0,3,0.0,2,2,1.0,1,6,7,3,2,0,2,8,20,0.0,0.0,0.1,2017
Antonius Cleveland,SG,23,17,123,8,21,0.381,3,4,0.75,5,17,0.294,4,6,0.667,3,11,14,2,7,5,7,23,23,-0.2,0.2,0.0,2017
John Collins,PF,20,74,1785,314,545,0.576,16,47,0.34,298,498,0.598,133,186,0.715,176,365,541,98,47,80,105,215,777,3.4,2.0,5.4,2017
Zach Collins,C,20,66,1045,115,289,0.398,35,113,0.31,80,176,0.455,27,42,0.643,45,176,221,52,17,31,58,133,292,-0.7,1.3,0.6,2017
Kyle Collinsworth,SF,26,32,480,38,99,0.384,4,17,0.235,34,82,0.415,21,40,0.525,32,75,107,56,17,9,24,44,101,-0.1,0.5,0.5,2017
Darren Collison,PG,30,69,2018,316,638,0.495,96,205,0.468,220,433,0.508,127,144,0.882,37,141,178,368,92,15,86,122,855,5.8,1.8,7.6,2017
Nick Collison,PF,37,15,75,13,19,0.684,0,0,0.0,13,19,0.684,5,13,0.385,7,13,20,4,0,0,7,7,31,0.1,0.0,0.1,2017
Mike Conley,PG,30,12,373,64,168,0.381,24,77,0.312,40,91,0.44,53,66,0.803,0,27,27,49,12,3,18,24,205,0.4,0.2,0.6,2017
Pat Connaughton,SG,25,82,1488,165,390,0.423,74,210,0.352,91,180,0.506,37,44,0.841,36,125,161,91,23,22,43,120,441,1.2,1.3,2.5,2017
Quinn Cook,PG,24,33,740,122,252,0.484,46,104,0.442,76,148,0.514,22,25,0.88,10,72,82,89,12,1,32,59,312,1.1,0.4,1.6,2017
Charles Cooke,SG,23,13,38,2,14,0.143,1,8,0.125,1,6,0.167,1,2,0.5,0,2,2,1,1,0,1,0,6,-0.2,0.0,-0.2,2017
Jack Cooley,PF,26,7,87,13,27,0.481,0,0,0.0,13,27,0.481,14,19,0.737,14,16,30,6,1,0,3,13,40,0.3,0.0,0.3,2017
Matt Costello,C,24,4,32,2,4,0.5,0,0,0.0,2,4,0.5,0,0,0.0,1,8,9,2,2,2,1,7,4,0.0,0.1,0.1,2017
DeMarcus Cousins,C,27,48,1737,406,864,0.47,104,294,0.354,302,570,0.53,294,394,0.746,105,512,617,257,79,76,242,183,1210,1.5,3.2,4.7,2017
Robert Covington,SF,27,80,2532,345,836,0.413,203,550,0.369,142,286,0.497,116,136,0.853,55,378,433,156,137,72,126,238,1009,1.6,4.5,6.1,2017
Allen Crabbe,SG,25,75,2197,337,827,0.407,201,532,0.378,136,295,0.461,115,135,0.852,28,296,324,117,47,35,78,168,990,1.8,1.4,3.2,2017
Torrey Craig,SF,27,39,629,62,137,0.453,17,58,0.293,45,79,0.57,22,35,0.629,40,87,127,25,12,15,20,63,163,0.5,0.4,0.9,2017
Jamal Crawford,SG,37,80,1653,308,742,0.415,104,314,0.331,204,428,0.477,102,113,0.903,21,78,99,185,40,9,95,85,822,0.9,0.3,1.3,2017
Jordan Crawford,SG,29,5,53,12,27,0.444,8,14,0.571,4,13,0.308,1,1,1.0,2,2,4,13,1,1,5,7,33,0.1,0.0,0.2,2017
Jae Crowder,SF,27,80,2090,271,671,0.404,110,341,0.323,161,330,0.488,121,148,0.818,59,216,275,99,64,21,74,187,773,1.0,1.6,2.6,2017
Dante Cunningham,SF,30,73,1562,164,364,0.451,58,168,0.345,106,196,0.541,31,52,0.596,78,220,298,48,39,30,33,111,417,1.1,1.3,2.4,2017
Stephen Curry,PG,29,51,1631,428,864,0.495,212,501,0.423,216,363,0.595,278,302,0.921,36,225,261,310,80,8,153,114,1346,7.2,1.9,9.1,2017
Troy Daniels,SG,26,79,1622,232,575,0.403,183,458,0.4,49,117,0.419,56,64,0.875,12,115,127,48,26,5,56,137,703,1.4,0.0,1.4,2017
Anthony Davis,PF,24,75,2727,780,1462,0.534,55,162,0.34,725,1300,0.558,495,598,0.828,187,645,832,174,115,193,162,159,2110,8.8,4.9,13.7,2017
Deyonta Davis,C,21,62,943,161,265,0.608,0,0,0.0,161,265,0.608,38,57,0.667,75,175,250,40,15,39,32,125,360,1.9,0.8,2.7,2017
Ed Davis,C,28,78,1471,170,292,0.582,0,1,0.0,170,291,0.584,74,111,0.667,183,392,575,40,32,52,66,188,414,2.5,2.5,5.0,2017
Dewayne Dedmon,C,28,62,1542,250,477,0.524,50,141,0.355,200,336,0.595,67,86,0.779,100,389,489,90,40,51,86,162,617,1.8,1.9,3.7,2017
Sam Dekker,PF,23,73,883,128,259,0.494,10,60,0.167,118,199,0.593,37,56,0.661,44,130,174,38,24,9,33,71,303,0.6,0.6,1.2,2017
Malcolm Delaney,PG,28,54,1014,109,285,0.382,46,124,0.371,63,161,0.391,74,92,0.804,9,91,100,163,35,6,66,82,338,0.4,0.6,1.0,2017
Matthew Dellavedova,PG,27,38,712,55,152,0.362,29,78,0.372,26,74,0.351,25,27,0.926,14,50,64,145,14,0,49,67,164,0.3,0.2,0.5,2017
Luol Deng,SF,32,1,13,1,2,0.5,0,0,0.0,1,2,0.5,0,0,0.0,0,0,0,1,1,0,1,0,2,0.0,0.0,0.0,2017
DeMar DeRozan,SG,28,80,2711,645,1413,0.456,89,287,0.31,556,1126,0.494,461,559,0.825,59,256,315,417,85,22,175,151,1840,6.8,2.8,9.6,2017
Cheick Diallo,PF,21,52,581,102,176,0.58,0,0,0.0,102,176,0.58,50,66,0.758,47,164,211,19,11,21,28,82,254,1.1,0.8,1.9,2017
Gorgui Dieng,C,28,79,1333,186,388,0.479,19,61,0.311,167,327,0.511,79,102,0.775,106,254,360,71,45,39,59,147,470,1.6,1.4,2.9,2017
Spencer Dinwiddie,PG,24,80,2306,324,838,0.387,141,433,0.326,183,405,0.452,218,268,0.813,40,219,259,524,68,23,128,186,1007,4.3,1.4,5.7,2017
Tyler Dorsey,SG,21,56,974,144,382,0.377,72,199,0.362,72,183,0.393,45,63,0.714,17,113,130,79,17,5,37,63,405,0.0,0.4,0.4,2017
Damyean Dotson,SG,23,44,474,72,161,0.447,22,68,0.324,50,93,0.538,16,23,0.696,9,75,84,31,12,2,17,34,182,0.3,0.3,0.6,2017
Milton Doyle,SG,24,10,125,13,47,0.277,4,23,0.174,9,24,0.375,4,8,0.5,3,15,18,10,6,2,2,13,34,-0.3,0.1,-0.1,2017
PJ Dozier,PG,21,2,3,1,2,0.5,0,0,0.0,1,2,0.5,0,0,0.0,0,1,1,0,0,0,1,1,2,0.0,0.0,0.0,2017
Goran Dragić,PG,31,75,2378,484,1075,0.45,111,300,0.37,373,775,0.481,217,271,0.801,54,252,306,359,63,12,166,180,1296,2.9,2.3,5.3,2017
Larry Drew II,PG,27,10,70,7,24,0.292,3,9,0.333,4,15,0.267,0,0,0.0,3,0,3,10,0,0,3,6,17,-0.1,0.0,-0.1,2017
Andre Drummond,C,24,78,2625,466,881,0.529,0,11,0.0,466,870,0.536,239,395,0.605,399,848,1247,237,114,127,200,250,1171,4.6,5.7,10.3,2017
Jared Dudley,PF,32,48,686,48,122,0.393,29,80,0.363,19,42,0.452,27,35,0.771,8,86,94,78,24,11,28,85,152,0.5,0.4,0.8,2017
Kris Dunn,PG,23,52,1525,286,666,0.429,43,134,0.321,243,532,0.457,84,114,0.737,24,197,221,310,104,27,150,174,699,-1.0,1.9,0.9,2017
Kevin Durant,SF,29,68,2325,630,1222,0.516,173,413,0.419,457,809,0.565,359,404,0.889,31,433,464,366,50,119,207,133,1792,7.5,2.9,10.4,2017
Jarell Eddie,SF,26,3,9,0,2,0.0,0,2,0.0,0,0,0.0,0,0,0.0,0,1,1,0,1,0,0,0,0,0.0,0.0,0.0,2017
Henry Ellenson,PF,21,38,329,53,146,0.363,20,60,0.333,33,86,0.384,25,29,0.862,10,71,81,20,5,0,18,22,151,-0.2,0.4,0.1,2017
Wayne Ellington,SG,30,77,2041,285,700,0.407,227,579,0.392,58,121,0.479,67,78,0.859,23,195,218,79,53,8,52,94,864,2.6,1.9,4.5,2017
Joel Embiid,C,23,63,1912,510,1056,0.483,66,214,0.308,444,842,0.527,359,467,0.769,143,547,690,199,40,111,234,209,1445,2.3,3.8,6.2,2017
James Ennis III,SF,27,72,1604,182,384,0.474,51,153,0.333,131,231,0.567,97,116,0.836,73,151,224,71,47,18,56,134,512,2.0,1.1,3.1,2017
Tyler Ennis,PG,23,54,683,94,224,0.42,14,56,0.25,80,168,0.476,22,29,0.759,19,76,95,105,30,10,38,75,224,0.1,0.7,0.8,2017
Jawun Evans,PG,21,48,778,89,253,0.352,15,54,0.278,74,199,0.372,38,49,0.776,9,75,84,100,36,6,44,97,231,-0.8,0.6,-0.2,2017
Jeremy Evans,SF,30,1,5,1,1,1.0,0,0,0.0,1,1,1.0,0,0,0.0,1,0,1,0,0,0,1,1,2,0.0,0.0,0.0,2017
Tyreke Evans,PG,28,52,1607,366,809,0.452,114,286,0.399,252,523,0.482,164,209,0.785,44,221,265,269,57,17,117,96,1010,3.1,1.2,4.2,2017
Dante Exum,PG,22,14,235,42,87,0.483,5,18,0.278,37,69,0.536,25,31,0.806,4,22,26,43,8,3,20,20,114,0.3,0.3,0.7,2017
Kenneth Faried,PF,28,32,461,76,148,0.514,0,1,0.0,76,147,0.517,36,51,0.706,68,85,153,18,12,13,23,51,188,0.9,0.4,1.3,2017
Derrick Favors,C,26,77,2153,395,702,0.563,14,63,0.222,381,639,0.596,140,215,0.651,198,354,552,102,54,82,88,164,944,4.5,3.5,8.0,2017
Kay Felder,PG,22,16,140,21,70,0.3,4,19,0.211,17,51,0.333,11,12,0.917,3,15,18,20,3,1,16,11,57,-0.6,0.1,-0.5,2017
Cristiano Felício,C,25,55,977,127,215,0.591,0,2,0.0,127,213,0.596,54,81,0.667,83,150,233,55,16,11,54,104,308,1.2,0.5,1.7,2017
Raymond Felton,PG,33,82,1365,224,552,0.406,81,230,0.352,143,322,0.444,36,44,0.818,25,131,156,203,49,16,76,91,565,0.9,1.3,2.2,2017
Terrance Ferguson,SG,19,61,763,70,169,0.414,40,120,0.333,30,49,0.612,9,10,0.9,19,28,47,19,24,10,11,83,189,0.7,0.5,1.2,2017
Yogi Ferrell,SG,24,82,2282,311,730,0.426,134,359,0.373,177,371,0.477,82,103,0.796,26,223,249,201,64,9,78,153,838,1.5,1.5,3.0,2017
Dorian Finney-Smith,PF,24,21,448,46,121,0.38,20,67,0.299,26,54,0.481,11,15,0.733,22,53,75,26,10,4,21,43,123,-0.2,0.3,0.1,2017
Bryn Forbes,SG,24,80,1517,209,497,0.421,89,228,0.39,120,269,0.446,48,72,0.667,12,98,110,80,28,2,37,108,555,0.8,1.3,2.1,2017
Evan Fournier,SF,25,57,1837,368,802,0.459,127,335,0.379,241,467,0.516,150,173,0.867,23,157,180,165,47,16,95,138,1013,2.4,0.9,3.3,2017
De'Aaron Fox,PG,20,73,2026,328,797,0.412,47,153,0.307,281,644,0.436,141,195,0.723,33,171,204,320,70,20,173,163,844,-1.7,1.1,-0.6,2017
Tim Frazier,PG,27,59,838,68,172,0.395,17,56,0.304,51,116,0.44,23,30,0.767,18,97,115,194,47,7,57,97,176,0.4,1.0,1.4,2017
Enes Freedom,C,25,71,1830,422,713,0.592,0,2,0.0,422,711,0.594,156,184,0.848,273,507,780,105,36,37,122,187,1000,5.5,2.1,7.6,2017
Channing Frye,C,34,53,695,104,212,0.491,39,115,0.339,65,97,0.67,17,19,0.895,12,123,135,38,18,13,21,69,264,0.9,0.6,1.5,2017
Markelle Fultz,SG,19,14,253,45,111,0.405,0,1,0.0,45,110,0.409,10,21,0.476,11,32,43,53,12,4,17,22,100,-0.2,0.4,0.2,2017
Danilo Gallinari,SF,29,21,671,102,256,0.398,36,111,0.324,66,145,0.455,81,87,0.931,9,92,101,41,12,10,26,30,321,0.8,0.4,1.2,2017
Langston Galloway,SG,26,58,863,126,340,0.371,75,218,0.344,51,122,0.418,33,41,0.805,13,79,92,58,35,5,18,39,360,0.5,0.9,1.4,2017
Marc Gasol,C,33,73,2408,434,1033,0.42,109,320,0.341,325,713,0.456,281,337,0.834,78,514,592,305,54,101,194,185,1258,1.5,2.6,4.0,2017
Pau Gasol*,C,37,77,1812,287,627,0.458,43,120,0.358,244,507,0.481,158,209,0.756,129,490,619,238,24,79,108,121,775,2.7,3.3,6.0,2017
Rudy Gay,PF,31,57,1231,253,537,0.471,37,118,0.314,216,419,0.516,112,145,0.772,76,215,291,73,46,38,78,98,655,1.0,2.1,3.1,2017
Paul George,SF,27,79,2891,576,1340,0.43,244,609,0.401,332,731,0.454,338,411,0.822,72,375,447,263,161,39,212,233,1734,5.0,3.9,8.9,2017
Marcus Georges-Hunt,SG,23,42,224,21,48,0.438,4,15,0.267,17,33,0.515,13,21,0.619,7,9,16,7,6,0,3,32,59,0.2,0.0,0.2,2017
Jonathan Gibson,PG,30,4,40,14,23,0.609,6,12,0.5,8,11,0.727,0,0,0.0,0,3,3,4,0,0,3,5,34,0.1,0.0,0.2,2017
Taj Gibson,PF,32,82,2726,425,737,0.577,7,35,0.2,418,702,0.595,142,185,0.768,194,390,584,99,62,59,89,218,999,5.4,1.7,7.2,2017
Manu Ginóbili*,SG,40,65,1299,201,463,0.434,64,192,0.333,137,271,0.506,110,131,0.84,19,123,142,163,43,16,105,126,576,0.6,1.6,2.2,2017
Rudy Gobert,C,25,56,1816,276,444,0.622,0,0,0.0,276,444,0.622,204,299,0.682,165,436,601,80,44,129,107,153,756,4.2,3.9,8.1,2017
Aaron Gordon,PF,22,58,1909,375,865,0.434,115,342,0.336,260,523,0.497,157,225,0.698,87,370,457,136,59,45,107,111,1022,0.9,2.0,2.9,2017
Eric Gordon,SG,29,69,2154,415,970,0.428,218,608,0.359,197,362,0.544,195,241,0.809,25,145,170,154,44,27,130,116,1243,2.9,1.8,4.7,2017
Marcin Gortat,C,33,82,2075,290,560,0.518,0,0,0.0,290,560,0.518,110,163,0.675,181,442,623,151,40,61,99,175,690,2.4,2.4,4.9,2017
Treveon Graham,SG,24,63,1050,96,221,0.434,40,97,0.412,56,124,0.452,41,59,0.695,42,79,121,59,33,2,27,109,273,1.1,0.7,1.8,2017
Jerami Grant,PF,23,81,1647,244,456,0.535,32,110,0.291,212,346,0.613,162,240,0.675,86,233,319,57,31,77,54,155,682,3.5,1.9,5.4,2017
Jerian Grant,PG,25,74,1686,209,503,0.416,61,187,0.326,148,316,0.468,140,188,0.745,31,141,172,342,63,8,89,132,619,2.3,1.0,3.3,2017
Josh Gray,PG,24,5,86,11,41,0.268,3,13,0.231,8,28,0.286,7,11,0.636,2,8,10,12,8,2,7,8,32,-0.3,0.1,-0.2,2017
Danny Green,SG,30,70,1791,217,561,0.387,116,320,0.363,101,241,0.419,50,65,0.769,41,208,249,110,63,80,74,122,600,0.1,2.9,2.9,2017
Draymond Green,PF,27,70,2287,281,619,0.454,77,256,0.301,204,363,0.562,134,173,0.775,75,460,535,508,95,91,202,185,773,2.6,3.4,6.1,2017
Gerald Green,SG,32,41,929,168,413,0.407,110,298,0.369,58,115,0.504,51,60,0.85,15,118,133,25,24,15,31,87,497,1.0,1.0,2.1,2017
JaMychal Green,PF,27,55,1542,223,488,0.457,43,127,0.339,180,361,0.499,80,111,0.721,147,317,464,79,32,25,76,153,569,1.3,1.3,2.6,2017
Jeff Green,PF,31,78,1828,295,618,0.477,53,170,0.312,242,448,0.54,203,234,0.868,60,186,246,99,41,34,75,149,846,3.1,0.8,3.9,2017
Blake Griffin,PF,28,58,1970,436,996,0.438,111,322,0.345,325,674,0.482,259,330,0.785,73,355,428,334,41,18,165,139,1242,3.2,1.8,4.9,2017
Daniel Hamilton,SG,22,6,28,5,11,0.455,2,5,0.4,3,6,0.5,0,0,0.0,0,5,5,8,1,0,2,2,12,0.1,0.0,0.1,2017
Tim Hardaway Jr.,SG,25,57,1885,360,856,0.421,130,410,0.317,230,446,0.516,146,179,0.816,32,192,224,155,62,10,92,123,996,1.6,1.1,2.6,2017
James Harden,SG,28,72,2551,651,1449,0.449,265,722,0.367,386,727,0.531,624,727,0.858,41,348,389,630,126,50,315,169,2191,11.6,3.8,15.4,2017
Maurice Harkless,SF,24,59,1264,147,297,0.495,49,118,0.415,98,179,0.547,42,59,0.712,46,116,162,53,48,43,40,103,385,1.6,1.7,3.2,2017
Montrezl Harrell,C,24,76,1293,348,548,0.635,1,7,0.143,347,541,0.641,139,222,0.626,103,203,306,74,36,52,68,143,836,4.3,1.3,5.5,2017
Devin Harris,PG,34,71,1340,187,454,0.412,79,227,0.348,108,227,0.476,142,170,0.835,12,115,127,152,47,12,76,158,595,1.6,0.9,2.5,2017
Gary Harris,SG,23,67,2304,440,908,0.485,156,394,0.396,284,514,0.553,134,162,0.827,37,139,176,194,122,15,119,119,1170,3.9,1.5,5.5,2017
Joe Harris,SG,26,78,1975,305,621,0.491,150,358,0.419,155,263,0.589,86,104,0.827,51,209,260,128,35,20,91,153,846,3.0,0.9,4.0,2017
Tobias Harris,PF,25,80,2668,562,1221,0.46,183,445,0.411,379,776,0.488,179,216,0.829,58,379,437,192,71,35,105,164,1486,4.2,2.5,6.7,2017
Aaron Harrison,SG,23,9,233,19,69,0.275,9,43,0.209,10,26,0.385,13,17,0.765,4,20,24,11,9,2,3,27,60,-0.3,0.2,-0.1,2017
Andrew Harrison,PG,23,56,1326,181,429,0.422,47,142,0.331,134,287,0.467,124,159,0.78,23,108,131,177,38,26,81,138,533,1.0,0.7,1.7,2017
Shaquille Harrison,PG,24,23,384,59,124,0.476,6,26,0.231,53,98,0.541,28,38,0.737,9,52,61,55,26,7,22,42,152,0.4,0.4,0.8,2017
Josh Hart,SG,22,63,1461,176,375,0.469,78,197,0.396,98,178,0.551,66,94,0.702,42,221,263,80,47,16,47,107,496,1.9,1.5,3.4,2017
Udonis Haslem,C,37,14,72,3,15,0.2,1,8,0.125,2,7,0.286,1,2,0.5,3,7,10,5,0,2,2,3,8,-0.1,0.1,-0.1,2017
Nigel Hayes,SF,23,9,122,11,33,0.333,4,16,0.25,7,17,0.412,1,3,0.333,4,18,22,6,2,3,2,8,27,-0.2,0.1,-0.1,2017
Gordon Hayward,SF,27,1,5,1,2,0.5,0,1,0.0,1,1,1.0,0,0,0.0,0,1,1,0,0,0,0,1,2,0.0,0.0,0.0,2017
Reggie Hearn,SG,26,3,7,1,2,0.5,1,2,0.5,0,0,0.0,0,0,0.0,0,0,0,0,0,0,0,0,3,0.0,0.0,0.0,2017
Myke Henry,SF,25,20,378,41,109,0.376,19,58,0.328,22,51,0.431,6,10,0.6,10,28,38,22,31,6,19,28,107,-0.3,0.4,0.1,2017
John Henson,C,27,76,1970,287,502,0.572,1,7,0.143,286,495,0.578,90,158,0.57,150,363,513,114,45,109,84,202,665,2.8,2.2,4.9,2017
Juancho Hernangómez,PF,22,25,277,29,75,0.387,14,50,0.28,15,25,0.6,10,12,0.833,18,36,54,12,6,3,9,25,82,0.2,0.1,0.4,2017
Willy Hernangómez,C,23,48,495,91,164,0.555,5,12,0.417,86,152,0.566,59,90,0.656,61,122,183,33,18,16,35,64,246,1.1,0.7,1.8,2017
Mario Hezonja,SF,22,75,1657,273,617,0.442,90,267,0.337,183,350,0.523,86,105,0.819,41,240,281,106,81,31,86,134,722,0.5,1.8,2.3,2017
Isaiah Hicks,PF,23,18,240,33,72,0.458,2,9,0.222,31,63,0.492,12,18,0.667,10,31,41,16,2,4,16,45,80,-0.1,0.1,0.0,2017
Buddy Hield,SG,25,80,2024,416,933,0.446,176,408,0.431,240,525,0.457,71,81,0.877,55,252,307,155,85,22,124,148,1079,1.3,1.5,2.8,2017
Nenê,C,35,52,758,136,239,0.569,0,2,0.0,136,237,0.574,68,107,0.636,54,122,176,45,28,14,38,123,340,1.5,1.1,2.6,2017
George Hill,PG,31,67,1812,236,513,0.46,85,205,0.415,151,308,0.49,110,140,0.786,42,139,181,186,61,27,88,128,667,2.3,0.9,3.2,2017
Solomon Hill,SF,26,12,187,11,41,0.268,4,21,0.19,7,20,0.35,3,6,0.5,9,27,36,22,7,1,9,22,29,-0.2,0.2,-0.1,2017
Darrun Hilliard,SG,24,14,95,5,19,0.263,0,6,0.0,5,13,0.385,6,7,0.857,0,7,7,11,2,0,4,7,16,-0.1,0.1,0.0,2017
Jrue Holiday,SG,27,81,2927,615,1244,0.494,120,356,0.337,495,888,0.557,187,238,0.786,62,303,365,486,123,64,213,201,1537,4.2,2.9,7.1,2017
Justin Holiday,SG,28,72,2265,290,782,0.371,161,449,0.359,129,333,0.387,135,164,0.823,31,260,291,153,80,31,93,134,876,0.1,1.6,1.7,2017
John Holland,SF,29,24,174,17,59,0.288,11,36,0.306,6,23,0.261,9,13,0.692,6,18,24,5,7,2,8,10,54,-0.3,0.1,-0.2,2017
Rondae Hollis-Jefferson,SF,23,68,1920,342,724,0.472,13,54,0.241,329,670,0.491,249,316,0.788,101,358,459,167,65,48,121,145,946,2.1,2.0,4.1,2017
Richaun Holmes,C,24,48,746,135,241,0.56,4,31,0.129,131,210,0.624,37,56,0.661,57,154,211,61,20,29,25,97,311,1.6,1.3,2.8,2017
Rodney Hood,SG,25,60,1616,322,751,0.429,127,333,0.381,195,418,0.467,111,129,0.86,22,143,165,95,45,12,70,105,882,1.2,1.5,2.7,2017
Scotty Hopson,SG,28,1,8,0,1,0.0,0,0,0.0,0,1,0.0,1,2,0.5,0,0,0,1,0,0,1,0,1,0.0,0.0,0.0,2017
Al Horford,C,31,72,2277,368,753,0.489,97,226,0.429,271,527,0.514,94,120,0.783,103,427,530,339,43,78,132,138,927,4.0,3.8,7.8,2017
Danuel House Jr.,SG,24,23,403,56,129,0.434,15,58,0.259,41,71,0.577,25,31,0.806,13,63,76,25,7,6,11,23,152,0.4,0.1,0.6,2017
Dwight Howard,C,32,81,2463,506,911,0.555,1,7,0.143,505,904,0.559,334,582,0.574,255,757,1012,105,48,131,208,249,1347,2.9,3.9,6.8,2017
Josh Huestis,PF,26,69,982,60,182,0.33,33,115,0.287,27,67,0.403,6,20,0.3,42,119,161,20,15,43,26,82,159,-0.5,1.0,0.5,2017
R.J. Hunter,SG,24,5,45,7,20,0.35,3,14,0.214,4,6,0.667,2,2,1.0,0,5,5,3,3,0,2,7,19,0.0,0.1,0.0,2017
Vince Hunter,PF,23,4,7,3,5,0.6,0,0,0.0,3,5,0.6,0,0,0.0,2,1,3,0,0,1,1,0,6,0.0,0.0,0.0,2017
Serge Ibaka,PF,28,76,2093,379,784,0.483,107,297,0.36,272,487,0.559,94,118,0.797,78,400,478,62,29,99,90,209,959,2.1,3.0,5.1,2017
Andre Iguodala,SF,34,64,1622,148,320,0.463,33,117,0.282,115,203,0.567,55,87,0.632,50,196,246,210,54,38,67,99,384,1.6,1.6,3.2,2017
Ersan İlyasova,PF,30,69,1729,277,613,0.452,91,253,0.36,186,360,0.517,105,135,0.778,118,287,405,90,61,26,72,157,750,2.2,1.9,4.0,2017
Joe Ingles,SF,30,82,2578,335,718,0.467,204,464,0.44,131,254,0.516,66,83,0.795,24,320,344,392,90,20,159,178,940,4.0,3.6,7.6,2017
Andre Ingram,SG,32,2,64,8,17,0.471,5,9,0.556,3,8,0.375,3,3,1.0,1,5,6,7,3,3,3,3,24,0.1,0.1,0.2,2017
Brandon Ingram,SF,20,59,1975,358,761,0.47,41,105,0.39,317,656,0.483,192,282,0.681,57,257,314,230,45,43,149,163,949,1.0,1.8,2.8,2017
Kyrie Irving,PG,25,60,1931,534,1087,0.491,166,407,0.408,368,680,0.541,232,261,0.889,33,194,227,306,65,17,140,122,1466,6.3,2.7,8.9,2017
Jonathan Isaac,PF,20,27,536,55,145,0.379,16,46,0.348,39,99,0.394,19,25,0.76,16,83,99,18,33,30,27,48,145,-0.6,0.8,0.2,2017
Wes Iwundu,SF,23,62,1020,93,218,0.427,9,46,0.196,84,172,0.488,34,47,0.723,36,101,137,57,33,12,30,81,229,0.0,0.7,0.7,2017
Jarrett Jack,PG,34,62,1548,189,443,0.427,25,86,0.291,164,357,0.459,63,75,0.84,22,169,191,348,35,4,115,98,466,0.5,0.7,1.2,2017
Aaron Jackson,PG,31,1,35,3,9,0.333,1,4,0.25,2,5,0.4,1,2,0.5,2,1,3,1,0,0,1,4,8,0.0,0.0,0.0,2017
Demetrius Jackson,PG,23,15,80,7,18,0.389,1,7,0.143,6,11,0.545,1,2,0.5,5,7,12,9,5,1,10,7,16,-0.2,0.1,-0.1,2017
Josh Jackson,SF,20,77,1959,389,932,0.417,57,217,0.263,332,715,0.464,177,279,0.634,95,256,351,119,80,35,146,218,1012,-2.0,1.2,-0.7,2017
Justin Jackson,SF,22,68,1506,185,419,0.442,57,185,0.308,128,234,0.547,26,36,0.722,27,160,187,74,28,13,40,81,453,0.4,0.5,1.0,2017
Reggie Jackson,PG,27,45,1201,246,577,0.426,52,169,0.308,194,408,0.475,112,134,0.836,29,96,125,238,27,4,99,87,656,1.1,0.9,2.0,2017
LeBron James,PF,33,82,3026,857,1580,0.542,149,406,0.367,708,1174,0.603,388,531,0.731,97,612,709,747,116,71,347,136,2251,11.0,3.0,14.0,2017
Mike James,PG,27,36,687,123,321,0.383,26,98,0.265,97,223,0.435,64,84,0.762,13,77,90,126,28,7,49,48,336,-0.1,0.3,0.2,2017
Al Jefferson,C,33,36,484,111,208,0.534,0,3,0.0,111,205,0.541,30,36,0.833,30,113,143,30,16,23,21,66,252,0.8,0.8,1.6,2017
Richard Jefferson,SF,37,20,163,12,27,0.444,2,7,0.286,10,20,0.5,4,7,0.571,2,15,17,15,2,1,5,11,30,0.1,0.0,0.1,2017
Brandon Jennings,PG,28,14,205,27,72,0.375,9,33,0.273,18,39,0.462,10,10,1.0,5,26,31,44,6,4,18,11,73,0.0,0.1,0.1,2017
Jonas Jerebko,PF,30,74,1134,159,341,0.466,65,157,0.414,94,184,0.511,46,57,0.807,53,193,246,42,24,12,27,127,429,1.8,1.6,3.4,2017
Amir Johnson,C,30,74,1171,140,260,0.538,10,32,0.313,130,228,0.57,52,85,0.612,123,207,330,118,45,44,55,192,342,2.1,2.0,4.1,2017
Brice Johnson,PF,23,18,98,20,42,0.476,0,1,0.0,20,41,0.488,3,5,0.6,9,22,31,2,9,6,5,13,43,0.0,0.2,0.2,2017
Dakari Johnson,C,22,31,161,22,39,0.564,0,0,0.0,22,39,0.564,11,20,0.55,16,18,34,8,6,8,3,27,55,0.4,0.2,0.6,2017
James Johnson,PF,30,73,1943,309,614,0.503,57,185,0.308,252,429,0.587,113,162,0.698,61,297,358,280,70,51,141,192,788,2.2,2.8,5.0,2017
Joe Johnson,SF,36,55,1205,146,360,0.406,40,145,0.276,106,215,0.493,40,45,0.889,14,158,172,83,18,7,49,67,372,-0.3,1.3,1.0,2017
Omari Johnson,PF,28,4,75,9,21,0.429,4,12,0.333,5,9,0.556,0,0,0.0,4,7,11,7,2,0,3,6,22,0.1,0.0,0.1,2017
Stanley Johnson,SF,21,69,1894,210,560,0.375,67,234,0.286,143,326,0.439,112,145,0.772,33,219,252,112,95,14,77,169,599,-0.6,2.4,1.8,2017
Tyler Johnson,PG,25,72,2052,309,711,0.435,119,324,0.367,190,387,0.491,106,129,0.822,34,214,248,165,60,34,81,148,843,1.9,2.3,4.2,2017
Wesley Johnson,SF,30,74,1486,150,368,0.408,60,177,0.339,90,191,0.471,43,58,0.741,29,187,216,61,76,62,55,146,403,-0.1,1.7,1.7,2017
Nikola Jokić,C,22,75,2443,504,1010,0.499,111,280,0.396,393,730,0.538,266,313,0.85,195,608,803,458,90,61,210,212,1385,7.8,2.9,10.7,2017
Damian Jones,C,22,15,89,11,22,0.5,0,0,0.0,11,22,0.5,3,5,0.6,5,9,14,2,1,3,4,14,25,0.0,0.1,0.1,2017
Derrick Jones Jr.,SF,20,20,245,21,53,0.396,3,18,0.167,18,35,0.514,16,24,0.667,21,17,38,9,4,13,7,24,61,0.1,0.2,0.4,2017
Jalen Jones,SF,24,16,181,26,68,0.382,10,26,0.385,16,42,0.381,12,19,0.632,13,25,38,4,5,1,7,22,74,0.0,0.2,0.1,2017
Tyus Jones,PG,21,82,1467,150,328,0.457,45,129,0.349,105,199,0.528,71,81,0.877,16,116,132,232,95,6,59,110,416,2.3,1.2,3.6,2017
DeAndre Jordan,C,29,77,2424,373,578,0.645,0,0,0.0,373,578,0.645,181,312,0.58,329,842,1171,117,39,71,137,203,927,6.0,3.4,9.4,2017
Cory Joseph,PG,26,82,2210,256,604,0.424,67,190,0.353,189,414,0.457,70,94,0.745,39,224,263,260,80,18,87,141,649,1.2,2.0,3.1,2017
Frank Kaminsky,PF,24,79,1835,307,716,0.429,104,274,0.38,203,442,0.459,155,194,0.799,46,242,288,129,36,19,66,95,873,2.3,1.3,3.6,2017
Luke Kennard,SG,21,73,1463,206,465,0.443,81,195,0.415,125,270,0.463,65,76,0.855,21,155,176,124,44,13,69,86,558,1.1,1.4,2.6,2017
Michael Kidd-Gilchrist,SF,24,74,1850,282,560,0.504,0,2,0.0,282,558,0.505,117,171,0.684,84,218,302,71,51,32,53,143,681,1.7,1.6,3.3,2017
Sean Kilpatrick,SG,28,52,640,110,294,0.374,46,144,0.319,64,150,0.427,64,72,0.889,5,82,87,46,13,5,38,33,330,-0.2,0.3,0.1,2017
Maxi Kleber,PF,26,72,1206,151,309,0.489,40,128,0.313,111,181,0.613,44,59,0.746,71,163,234,51,26,47,30,114,386,1.6,1.2,2.8,2017
Furkan Korkmaz,SG,20,14,80,8,28,0.286,5,17,0.294,3,11,0.273,2,4,0.5,2,9,11,4,2,1,2,12,23,-0.1,0.1,0.0,2017
Luke Kornet,C,22,20,326,49,125,0.392,28,79,0.354,21,46,0.457,8,11,0.727,11,53,64,26,6,16,12,28,134,0.2,0.3,0.5,2017
Kyle Korver,SG,36,73,1574,222,484,0.459,164,376,0.436,58,108,0.537,64,72,0.889,9,156,165,88,31,27,55,130,672,2.8,0.6,3.4,2017
Kosta Koufos,C,28,71,1391,222,389,0.571,0,0,0.0,222,389,0.571,33,74,0.446,149,323,472,87,47,32,49,146,477,2.3,1.5,3.9,2017
Kyle Kuzma,PF,22,77,2401,468,1039,0.45,159,434,0.366,309,605,0.511,147,208,0.707,88,395,483,141,49,34,140,160,1242,1.5,2.3,3.8,2017
Mindaugas Kuzminskas,SF,28,1,2,0,2,0.0,0,0,0.0,0,2,0.0,0,0,0.0,0,0,0,0,0,0,0,0,0,0.0,0.0,0.0,2017
Skal Labissière,PF,21,60,1240,205,458,0.448,18,51,0.353,187,407,0.459,95,118,0.805,99,189,288,72,25,49,73,132,523,0.4,1.0,1.4,2017
Jeremy Lamb,SG,25,80,1967,380,832,0.457,94,254,0.37,286,578,0.495,179,208,0.861,49,275,324,186,61,32,93,138,1033,3.0,1.9,4.9,2017
Shane Larkin,PG,25,54,775,84,219,0.384,31,86,0.36,53,133,0.398,32,37,0.865,15,77,92,98,29,2,33,58,231,0.3,1.1,1.4,2017
Joffrey Lauvergne,C,26,55,534,98,190,0.516,0,5,0.0,98,185,0.53,30,47,0.638,63,108,171,41,9,3,33,45,226,0.6,0.7,1.3,2017
Zach LaVine,SG,22,24,656,136,355,0.383,42,123,0.341,94,232,0.405,87,107,0.813,9,85,94,72,24,4,43,55,401,-0.1,0.5,0.3,2017
Jake Layman,SF,23,35,160,14,47,0.298,4,20,0.2,10,27,0.37,2,3,0.667,4,12,16,11,6,4,5,13,34,-0.3,0.2,-0.1,2017
T.J. Leaf,PF,20,53,459,64,136,0.471,18,42,0.429,46,94,0.489,10,16,0.625,29,53,82,9,5,4,10,45,156,0.5,0.3,0.8,2017
Courtney Lee,SG,32,76,2310,343,755,0.454,113,278,0.406,230,477,0.482,114,124,0.919,30,194,224,180,80,17,84,109,913,2.7,1.2,3.9,2017
Damion Lee,SG,25,15,404,62,152,0.408,15,60,0.25,47,92,0.511,22,29,0.759,11,60,71,29,19,1,14,25,161,0.0,0.4,0.4,2017
Walt Lemon Jr.,PG,25,5,35,7,16,0.438,1,1,1.0,6,15,0.4,2,3,0.667,0,2,2,5,0,1,4,5,17,-0.1,0.0,-0.1,2017
Alex Len,C,24,69,1395,214,378,0.566,1,3,0.333,213,375,0.568,158,231,0.684,175,343,518,82,27,61,78,158,587,3.2,1.3,4.5,2017
Kawhi Leonard,SF,26,9,210,52,111,0.468,11,35,0.314,41,76,0.539,31,38,0.816,6,36,42,21,18,9,16,9,146,0.3,0.5,0.9,2017
Meyers Leonard,C,25,33,254,46,78,0.59,11,26,0.423,35,52,0.673,9,11,0.818,12,58,70,17,7,0,10,36,112,0.7,0.3,1.1,2017
Jon Leuer,PF,28,8,136,15,36,0.417,0,3,0.0,15,33,0.455,13,15,0.867,7,25,32,5,1,3,7,16,43,0.0,0.1,0.1,2017
Caris LeVert,SF,23,71,1864,320,735,0.435,85,245,0.347,235,490,0.48,133,187,0.711,53,207,260,299,82,22,153,159,858,0.7,1.6,2.3,2017
DeAndre Liggins,SG,29,58,724,40,106,0.377,19,53,0.358,21,53,0.396,2,5,0.4,7,68,75,48,37,14,20,81,101,-0.2,0.7,0.5,2017
Damian Lillard,PG,27,73,2670,621,1415,0.439,227,629,0.361,394,786,0.501,493,538,0.916,62,263,325,481,77,27,206,117,1962,9.9,2.7,12.6,2017
Jeremy Lin,PG,29,1,25,5,12,0.417,1,2,0.5,4,10,0.4,7,7,1.0,0,0,0,4,0,0,3,3,18,0.0,0.0,0.0,2017
Shaun Livingston,PG,32,71,1129,172,343,0.501,0,5,0.0,172,338,0.509,50,61,0.82,32,99,131,140,35,21,58,117,394,0.9,0.9,1.8,2017
Kevon Looney,C,21,66,910,112,193,0.58,1,5,0.2,111,188,0.59,42,77,0.545,83,132,215,42,34,56,31,106,267,1.5,1.3,2.8,2017
Brook Lopez,C,29,74,1735,369,793,0.465,112,325,0.345,257,468,0.549,111,158,0.703,74,220,294,126,30,98,98,195,961,1.9,1.9,3.8,2017
Robin Lopez,C,29,64,1690,342,645,0.53,4,14,0.286,338,631,0.536,68,90,0.756,134,156,290,124,14,53,107,109,756,1.2,0.7,1.9,2017
Kevin Love,C,29,59,1651,334,729,0.458,137,330,0.415,197,399,0.494,234,266,0.88,101,445,546,103,43,24,90,120,1039,4.7,1.6,6.4,2017
Kyle Lowry,PG,31,78,2510,403,944,0.427,238,596,0.399,165,348,0.474,223,261,0.854,66,368,434,537,85,19,183,192,1267,7.0,3.1,10.2,2017
Timothé Luwawu-Cabarrot,SF,22,52,807,100,267,0.375,53,158,0.335,47,109,0.431,46,58,0.793,14,58,72,54,12,5,38,97,299,0.1,0.7,0.8,2017
Tyler Lydon,PF,21,1,2,0,0,0.0,0,0,0.0,0,0,0.0,0,0,0.0,0,0,0,0,0,0,0,0,0,0.0,0.0,0.0,2017
Trey Lyles,PF,22,73,1391,270,550,0.491,83,218,0.381,187,332,0.563,101,143,0.706,55,292,347,91,30,34,61,111,724,2.7,1.2,3.9,2017
Shelvin Mack,PG,27,69,1365,178,414,0.43,48,139,0.345,130,275,0.473,69,97,0.711,23,143,166,272,54,8,89,91,473,1.0,1.0,1.9,2017
Josh Magette,PG,28,18,216,15,46,0.326,8,22,0.364,7,24,0.292,8,8,1.0,2,17,19,57,8,1,9,16,46,0.3,0.1,0.4,2017
Ian Mahinmi,C,31,77,1145,138,248,0.556,0,2,0.0,138,246,0.561,90,128,0.703,135,177,312,53,38,42,100,230,366,0.8,1.4,2.2,2017
Thon Maker,C,20,74,1238,130,316,0.411,31,104,0.298,99,212,0.467,65,93,0.699,75,150,225,46,38,53,44,162,356,0.3,1.1,1.5,2017
Boban Marjanović,C,29,39,337,79,148,0.534,0,0,0.0,79,148,0.534,77,97,0.794,48,96,144,22,10,11,36,51,235,1.0,0.5,1.5,2017
Lauri Markkanen,PF,20,68,2020,374,862,0.434,145,401,0.362,229,461,0.497,140,166,0.843,79,429,508,79,39,40,83,103,1033,1.7,1.6,3.3,2017
Jarell Martin,PF,23,73,1661,221,496,0.446,34,98,0.347,187,398,0.47,89,116,0.767,97,221,318,73,39,49,86,211,565,0.1,1.2,1.3,2017
Frank Mason III,PG,23,52,984,144,380,0.379,31,86,0.36,113,294,0.384,94,115,0.817,30,100,130,147,34,10,65,72,413,0.0,0.6,0.5,2017
Mangok Mathiang,C,25,4,20,4,7,0.571,0,0,0.0,4,7,0.571,0,1,0.0,3,7,10,0,1,0,0,5,8,0.0,0.0,0.1,2017
Wesley Matthews,SF,31,63,2131,283,697,0.406,153,402,0.381,130,295,0.441,83,101,0.822,28,170,198,172,76,16,83,140,802,1.0,1.6,2.6,2017
Luc Mbah a Moute,PF,31,61,1564,166,345,0.481,63,173,0.364,103,172,0.599,65,95,0.684,22,164,186,55,72,25,68,100,460,0.8,2.1,2.8,2017
James Michael McAdoo,PF,25,3,18,2,7,0.286,2,7,0.286,0,0,0.0,2,2,1.0,0,2,2,0,0,1,1,1,8,0.0,0.0,0.0,2017
Patrick McCaw,SG,22,57,961,92,225,0.409,19,80,0.238,73,145,0.503,26,34,0.765,16,66,82,81,43,10,41,67,229,-0.3,0.8,0.6,2017
CJ McCollum,SG,26,81,2923,667,1505,0.443,189,476,0.397,478,1029,0.465,209,250,0.836,53,268,321,272,77,35,151,168,1732,3.7,2.9,6.6,2017
T.J. McConnell,PG,25,76,1706,210,421,0.499,27,62,0.435,183,359,0.51,31,39,0.795,37,189,226,303,92,13,112,122,478,1.3,2.5,3.8,2017
Erik McCree,SF,24,4,8,0,2,0.0,0,1,0.0,0,1,0.0,0,0,0.0,0,1,1,0,1,0,1,0,0,-0.1,0.0,-0.1,2017
Chris McCullough,PF,22,19,90,18,42,0.429,1,8,0.125,17,34,0.5,9,14,0.643,7,18,25,4,0,5,2,8,46,0.1,0.1,0.2,2017
Doug McDermott,SF,26,81,1768,237,508,0.467,92,216,0.426,145,292,0.497,64,81,0.79,40,160,200,79,19,16,56,122,630,1.7,0.6,2.3,2017
JaVale McGee,C,30,65,615,136,219,0.621,0,6,0.0,136,213,0.638,38,52,0.731,59,110,169,33,21,57,27,91,310,1.7,1.1,2.7,2017
Rodney McGruder,SG,26,18,299,36,73,0.493,15,35,0.429,21,38,0.553,4,8,0.5,11,22,33,17,8,3,4,21,91,0.5,0.3,0.8,2017
Trey McKinney-Jones,SG,27,1,1,0,0,0.0,0,0,0.0,0,0,0.0,0,0,0.0,0,0,0,0,0,0,0,0,0,0.0,0.0,0.0,2017
Alfonzo McKinnie,SF,25,14,53,8,15,0.533,3,9,0.333,5,6,0.833,2,3,0.667,1,6,7,1,1,1,3,8,21,0.0,0.1,0.1,2017
Ben McLemore,SG,24,56,1091,157,373,0.421,55,159,0.346,102,214,0.477,53,64,0.828,34,105,139,51,38,15,61,139,422,-0.2,0.7,0.5,2017
Josh McRoberts,PF,30,2,6,0,1,0.0,0,1,0.0,0,0,0.0,0,0,0.0,0,0,0,0,0,0,0,2,0,0.0,0.0,0.0,2017
Jodie Meeks,SG,30,77,1119,157,393,0.399,72,210,0.343,85,183,0.464,101,117,0.863,15,111,126,70,29,4,37,55,487,1.3,0.8,2.0,2017
Salah Mejri,C,31,61,729,88,137,0.642,0,3,0.0,88,134,0.657,38,66,0.576,85,161,246,35,22,67,39,121,214,1.3,1.3,2.7,2017
Jordan Mickey,PF,23,23,284,39,82,0.476,2,16,0.125,37,66,0.561,13,19,0.684,18,63,81,9,6,10,18,36,93,-0.1,0.4,0.3,2017
Khris Middleton,SF,26,82,2982,593,1272,0.466,146,407,0.359,447,865,0.517,320,362,0.884,45,384,429,328,119,21,191,270,1652,4.6,2.3,6.9,2017
C.J. Miles,SF,30,70,1337,227,599,0.379,164,454,0.361,63,145,0.434,81,97,0.835,18,134,152,55,37,21,39,134,699,1.4,1.5,2.9,2017
Darius Miller,SF,27,82,1944,216,487,0.444,147,358,0.411,69,129,0.535,58,67,0.866,18,146,164,111,28,17,58,160,637,2.1,0.9,3.0,2017
Malcolm Miller,SF,24,15,126,13,28,0.464,8,21,0.381,5,7,0.714,4,4,1.0,4,11,15,3,1,2,5,10,38,0.1,0.1,0.2,2017
Patty Mills,PG,29,82,2107,280,682,0.411,154,414,0.372,126,268,0.47,105,118,0.89,26,128,154,229,55,11,106,128,819,2.0,2.1,4.1,2017
Paul Millsap,PF,32,38,1143,202,435,0.464,39,113,0.345,163,322,0.506,112,161,0.696,65,180,245,105,39,44,73,99,555,1.4,1.1,2.5,2017
Nikola Mirotić,PF,26,55,1494,306,684,0.447,135,358,0.377,171,326,0.525,112,137,0.818,59,346,405,80,44,39,62,108,859,2.2,1.8,4.0,2017
Donovan Mitchell,SG,21,79,2638,595,1362,0.437,187,550,0.34,408,812,0.502,239,297,0.805,52,244,296,291,118,27,215,213,1616,1.4,3.8,5.2,2017
Naz Mitrou-Long,SG,24,1,1,1,1,1.0,1,1,1.0,0,0,0.0,0,0,0.0,0,0,0,0,0,0,0,0,3,0.1,0.0,0.1,2017
Malik Monk,SG,19,63,854,153,425,0.36,83,243,0.342,70,182,0.385,32,38,0.842,8,58,66,91,20,9,49,60,421,-0.5,0.5,0.0,2017
Greg Monroe,C,27,51,1040,218,386,0.565,0,0,0.0,218,386,0.565,88,119,0.739,109,241,350,114,44,23,94,95,524,1.8,1.6,3.4,2017
Luis Montero,SG,24,2,8,0,1,0.0,0,0,0.0,0,1,0.0,0,0,0.0,0,2,2,0,0,0,2,0,0,-0.1,0.0,-0.1,2017
Ben Moore,PF,22,2,9,0,0,0.0,0,0,0.0,0,0,0.0,0,0,0.0,0,1,1,1,0,0,0,4,0,0.0,0.0,0.0,2017
E'Twaun Moore,SG,28,82,2586,423,832,0.508,128,301,0.425,295,531,0.556,48,68,0.706,57,181,238,187,79,12,102,182,1022,2.8,1.6,4.4,2017
Eric Moreland,PF,26,67,805,66,122,0.541,0,0,0.0,66,122,0.541,11,29,0.379,81,197,278,78,31,51,42,116,143,0.7,1.6,2.3,2017
Jaylen Morris,SG,22,6,98,13,32,0.406,2,10,0.2,11,22,0.5,0,0,0.0,2,14,16,7,2,1,6,2,28,-0.2,0.1,-0.1,2017
Marcus Morris,PF,28,54,1442,262,611,0.429,86,234,0.368,176,377,0.467,124,154,0.805,43,246,289,72,35,12,65,100,734,1.1,2.2,3.2,2017
Markieff Morris,PF,28,73,1968,330,687,0.48,76,207,0.367,254,480,0.529,105,128,0.82,75,334,409,142,56,38,127,216,841,1.2,2.1,3.3,2017
Monte Morris,PG,22,3,25,4,6,0.667,0,1,0.0,4,5,0.8,2,2,1.0,0,2,2,7,3,0,1,1,10,0.1,0.0,0.2,2017
Johnathan Motley,PF,22,11,176,40,75,0.533,1,6,0.167,39,69,0.565,15,28,0.536,14,35,49,7,3,2,9,18,96,0.1,0.2,0.3,2017
Timofey Mozgov,C,31,31,359,52,93,0.559,4,18,0.222,48,75,0.64,23,30,0.767,32,66,98,11,5,13,33,39,131,0.1,0.3,0.4,2017
Emmanuel Mudiay,PG,21,64,1245,204,526,0.388,47,148,0.318,157,378,0.415,98,129,0.76,26,126,152,206,41,11,113,80,553,-0.8,0.7,0.0,2017
Shabazz Muhammad,SF,25,43,418,84,188,0.447,7,27,0.259,77,161,0.478,39,50,0.78,23,53,76,14,9,3,6,30,214,0.5,0.2,0.7,2017
Xavier Munford,SG,25,6,21,1,6,0.167,0,2,0.0,1,4,0.25,1,2,0.5,1,0,1,4,1,0,2,4,3,-0.1,0.0,-0.1,2017
Dejounte Murray,PG,21,81,1743,270,609,0.443,9,34,0.265,261,575,0.454,105,148,0.709,110,349,459,231,97,31,134,151,654,-0.2,3.4,3.2,2017
Jamal Murray,PG,20,81,2565,479,1062,0.451,165,436,0.378,314,626,0.502,229,253,0.905,82,215,297,274,79,28,172,173,1352,4.3,1.2,5.5,2017
Mike Muscala,C,26,53,1060,143,312,0.458,62,167,0.371,81,145,0.559,57,62,0.919,56,174,230,51,31,27,42,80,405,1.5,0.9,2.4,2017
Abdel Nader,SF,24,48,522,50,149,0.336,23,65,0.354,27,84,0.321,23,39,0.59,13,58,71,26,15,10,34,45,146,-0.9,0.8,-0.1,2017
Larry Nance Jr.,C,25,66,1421,240,413,0.581,2,12,0.167,238,401,0.594,91,137,0.664,161,291,452,82,88,38,51,172,573,3.5,2.3,5.8,2017
Shabazz Napier,PG,26,74,1535,223,531,0.42,82,218,0.376,141,313,0.45,116,138,0.841,26,144,170,150,81,14,90,84,644,1.2,2.0,3.2,2017
Jameer Nelson,PG,35,50,1013,95,244,0.389,41,124,0.331,54,120,0.45,16,20,0.8,13,91,104,179,27,4,67,81,247,-0.1,0.7,0.6,2017
Raul Neto,PG,25,41,498,69,151,0.457,19,47,0.404,50,104,0.481,26,35,0.743,7,42,49,75,13,4,36,38,183,0.3,0.6,0.9,2017
Georges Niang,PF,24,9,32,4,11,0.364,0,4,0.0,4,7,0.571,1,2,0.5,3,6,9,3,2,0,3,1,9,-0.1,0.1,0.0,2017
Joakim Noah,C,32,7,40,5,10,0.5,0,0,0.0,5,10,0.5,2,4,0.5,6,8,14,4,2,2,4,5,12,0.0,0.1,0.1,2017
Nerlens Noel,C,23,30,472,55,105,0.524,0,1,0.0,55,104,0.529,21,28,0.75,48,120,168,20,31,22,26,59,131,0.4,1.0,1.3,2017
Lucas Nogueira,C,25,49,418,49,80,0.613,5,19,0.263,44,61,0.721,19,28,0.679,18,69,87,22,23,43,16,49,122,0.7,1.0,1.6,2017
Dirk Nowitzki*,C,39,77,1900,346,758,0.456,138,337,0.409,208,421,0.494,97,108,0.898,22,416,438,120,43,45,51,146,927,2.6,2.2,4.8,2017
Frank Ntilikina,PG,19,78,1706,182,500,0.364,50,157,0.318,132,343,0.385,49,68,0.721,37,140,177,250,65,18,131,181,463,-2.0,1.1,-0.9,2017
Jusuf Nurkić,C,23,79,2088,480,951,0.505,0,7,0.0,480,944,0.508,172,273,0.63,189,519,708,143,64,111,183,247,1132,0.8,3.9,4.7,2017
David Nwaba,SG,25,70,1646,202,423,0.478,18,52,0.346,184,371,0.496,133,203,0.655,89,237,326,104,59,29,77,158,555,1.1,1.4,2.4,2017
Johnny O'Bryant,PF,24,36,379,68,171,0.398,14,43,0.326,54,128,0.422,21,25,0.84,29,64,93,14,9,6,15,45,171,-0.1,0.4,0.3,2017
Royce O'Neale,SF,24,69,1150,120,284,0.423,42,118,0.356,78,166,0.47,61,76,0.803,25,211,236,95,36,16,55,105,343,0.5,1.8,2.4,2017
Kyle O'Quinn,C,27,77,1387,224,384,0.583,4,17,0.235,220,367,0.599,98,127,0.772,121,349,470,158,36,98,100,192,550,2.7,2.1,4.8,2017
Semi Ojeleye,PF,23,73,1150,65,188,0.346,40,125,0.32,25,63,0.397,25,41,0.61,37,124,161,20,21,4,25,91,195,-0.2,1.3,1.2,2017
Emeka Okafor,C,35,26,353,48,95,0.505,0,0,0.0,48,95,0.505,18,22,0.818,47,73,120,8,8,25,13,30,114,0.5,0.5,1.0,2017
Jahlil Okafor,C,22,28,353,77,138,0.558,1,4,0.25,76,134,0.567,21,29,0.724,21,64,85,12,3,18,21,51,176,0.3,0.3,0.6,2017
Victor Oladipo,SG,25,75,2552,640,1342,0.477,161,434,0.371,479,908,0.528,294,368,0.799,47,343,390,323,177,57,219,175,1735,4.3,4.0,8.2,2017
Kelly Olynyk,PF,26,76,1779,316,636,0.497,106,280,0.379,210,356,0.59,134,174,0.77,89,342,431,207,62,35,147,222,872,2.8,2.7,5.5,2017
Chinanu Onuaku,C,21,1,22,2,5,0.4,0,0,0.0,2,5,0.4,0,0,0.0,1,3,4,1,0,0,3,4,4,-0.1,0.0,-0.1,2017
Cedi Osman,SF,22,61,672,90,186,0.484,32,87,0.368,58,99,0.586,26,46,0.565,19,101,120,41,22,3,32,78,238,0.5,0.4,0.9,2017
Kelly Oubre Jr.,SF,22,81,2231,318,790,0.403,126,369,0.341,192,421,0.456,191,233,0.82,59,304,363,98,80,35,90,234,953,1.4,2.3,3.7,2017
Zaza Pachulia,C,33,69,972,149,264,0.564,0,1,0.0,149,263,0.567,75,93,0.806,89,232,321,109,38,17,72,122,373,1.8,1.4,3.3,2017
Marcus Paige,PG,24,5,28,4,14,0.286,2,8,0.25,2,6,0.333,2,2,1.0,0,4,4,3,0,0,0,0,12,0.0,0.0,0.0,2017
Georgios Papagiannis,C,20,17,122,18,42,0.429,0,0,0.0,18,42,0.429,0,0,0.0,13,24,37,9,4,6,8,12,36,-0.1,0.1,0.0,2017
Jabari Parker,PF,22,31,743,160,332,0.482,31,81,0.383,129,251,0.514,40,54,0.741,42,109,151,59,25,10,45,50,391,0.6,0.6,1.2,2017
Tony Parker*,PG,35,55,1071,178,388,0.459,10,37,0.27,168,351,0.479,55,78,0.705,7,88,95,195,28,1,68,52,421,0.4,1.1,1.4,2017
Chandler Parsons,SF,29,36,691,108,234,0.462,51,121,0.421,57,113,0.504,17,27,0.63,14,76,90,69,18,11,35,53,284,0.7,0.4,1.1,2017
Patrick Patterson,PF,28,82,1270,106,266,0.398,66,171,0.386,40,95,0.421,40,46,0.87,32,161,193,57,48,23,33,87,318,1.2,1.4,2.6,2017
Justin Patton,C,20,1,4,1,2,0.5,0,0,0.0,1,2,0.5,0,0,0.0,0,0,0,0,1,0,0,1,2,0.0,0.0,0.0,2017
Brandon Paul,SG,26,64,576,55,127,0.433,15,54,0.278,40,73,0.548,22,43,0.512,6,62,68,37,25,7,29,58,147,-0.3,0.8,0.5,2017
Chris Paul,PG,32,58,1847,367,798,0.46,144,379,0.38,223,419,0.532,203,221,0.919,37,276,313,457,96,14,128,141,1081,7.5,2.7,10.2,2017
Adreian Payne,PF,26,5,43,7,10,0.7,2,3,0.667,5,7,0.714,5,6,0.833,2,7,9,0,2,0,2,6,21,0.1,0.0,0.2,2017
Cameron Payne,PG,23,25,582,87,215,0.405,35,91,0.385,52,124,0.419,12,16,0.75,18,51,69,113,26,9,36,44,221,0.3,0.4,0.8,2017
Elfrid Payton,PG,23,63,1808,329,667,0.493,30,92,0.326,299,575,0.52,109,168,0.649,64,210,274,393,83,22,168,147,797,1.4,1.4,2.8,2017
Gary Payton II,PG,25,23,221,30,74,0.405,6,25,0.24,24,49,0.49,3,9,0.333,13,31,44,21,7,3,7,30,69,0.0,0.2,0.2,2017
Kendrick Perkins,C,33,1,15,1,2,0.5,0,0,0.0,1,2,0.5,1,2,0.5,0,1,1,2,1,0,1,1,3,0.0,0.0,0.0,2017
London Perrantes,PG,23,14,66,2,13,0.154,0,3,0.0,2,10,0.2,3,5,0.6,1,3,4,5,2,1,1,6,7,-0.1,0.0,-0.1,2017
Alec Peters,PF,22,20,225,28,74,0.378,18,58,0.31,10,16,0.625,8,10,0.8,8,29,37,12,2,2,4,13,82,0.2,0.0,0.3,2017
Marshall Plumlee,C,25,8,52,1,3,0.333,0,0,0.0,1,3,0.333,12,16,0.75,4,13,17,2,0,1,3,10,14,0.1,0.0,0.2,2017
Mason Plumlee,C,27,74,1439,221,368,0.601,0,1,0.0,221,367,0.602,82,179,0.458,132,268,400,142,49,81,103,184,524,1.8,1.8,3.6,2017
Miles Plumlee,C,29,55,918,105,180,0.583,0,0,0.0,105,180,0.583,27,60,0.45,77,151,228,45,17,30,63,79,237,0.1,0.7,0.9,2017
Jakob Poeltl,C,22,82,1524,253,384,0.659,1,2,0.5,252,382,0.66,60,101,0.594,165,228,393,57,39,100,85,212,567,3.1,2.4,5.6,2017
Quincy Pondexter,SF,29,23,196,14,49,0.286,3,22,0.136,11,27,0.407,14,17,0.824,8,19,27,9,8,2,11,24,45,-0.3,0.1,-0.2,2017
Otto Porter Jr.,SF,24,77,2432,445,885,0.503,138,313,0.441,307,572,0.537,106,128,0.828,103,389,492,157,116,41,75,151,1134,5.0,3.1,8.1,2017
Bobby Portis,PF,22,73,1643,382,811,0.471,80,223,0.359,302,588,0.514,120,156,0.769,159,339,498,123,50,23,103,130,964,2.0,1.5,3.5,2017
Kristaps Porziņģis,PF,22,48,1553,390,889,0.439,90,228,0.395,300,661,0.454,218,275,0.793,62,254,316,57,36,115,93,141,1088,1.4,1.8,3.2,2017
Dwight Powell,C,26,79,1672,255,430,0.593,28,84,0.333,227,346,0.656,133,185,0.719,135,309,444,91,67,32,59,186,671,4.6,2.1,6.6,2017
Norman Powell,SG,24,70,1062,150,374,0.401,53,186,0.285,97,188,0.516,32,39,0.821,14,105,119,89,37,16,66,111,385,-0.6,1.2,0.6,2017
Alex Poythress,PF,24,25,104,11,26,0.423,4,11,0.364,7,15,0.467,0,0,0.0,7,10,17,2,3,1,2,16,26,0.1,0.1,0.1,2017
Taurean Prince,SF,23,82,2464,415,975,0.426,176,457,0.385,239,518,0.461,152,180,0.844,50,339,389,214,85,42,191,168,1158,0.0,2.0,2.0,2017
Jacob Pullen,PG,28,3,6,1,2,0.5,0,1,0.0,1,1,1.0,0,0,0.0,0,0,0,0,0,0,1,0,2,0.0,0.0,0.0,2017
Rodney Purvis,SG,23,16,290,35,107,0.327,13,52,0.25,22,55,0.4,13,15,0.867,1,26,27,17,3,3,10,26,96,-0.4,0.1,-0.3,2017
Zhou Qi,C,22,18,124,6,32,0.188,2,19,0.105,4,13,0.308,8,12,0.667,6,16,22,2,2,14,10,14,22,-0.5,0.2,-0.3,2017
Tim Quarterman,SG,23,3,13,1,3,0.333,0,2,0.0,1,1,1.0,2,2,1.0,0,3,3,1,0,0,2,1,4,0.0,0.0,0.0,2017
Ivan Rabb,PF,20,36,516,86,152,0.566,0,0,0.0,86,152,0.566,29,36,0.806,53,105,158,32,12,13,35,55,201,0.7,0.5,1.2,2017
Julius Randle,C,23,82,2190,504,904,0.558,10,45,0.222,494,859,0.575,305,425,0.718,181,473,654,210,43,45,213,274,1323,4.0,2.6,6.6,2017
Zach Randolph,PF,36,59,1508,361,763,0.473,51,147,0.347,310,616,0.503,84,107,0.785,97,300,397,127,42,10,116,119,857,0.3,1.2,1.5,2017
Xavier Rathan-Mayes,SG,23,5,118,12,42,0.286,1,14,0.071,11,28,0.393,4,9,0.444,0,5,5,18,6,3,11,18,29,-0.5,0.1,-0.4,2017
JJ Redick,SG,33,70,2116,404,879,0.46,193,460,0.42,211,419,0.504,197,218,0.904,9,169,178,210,35,6,103,123,1198,4.8,1.8,6.6,2017
Davon Reed,SG,22,21,242,22,76,0.289,11,38,0.289,11,38,0.289,8,12,0.667,2,37,39,13,10,2,10,17,63,-0.5,0.2,-0.3,2017
Willie Reed,C,27,42,428,81,121,0.669,1,2,0.5,80,119,0.672,32,55,0.582,35,86,121,10,9,22,19,56,195,1.0,0.5,1.5,2017
Josh Richardson,SF,24,81,2689,399,885,0.451,127,336,0.378,272,549,0.495,120,142,0.845,69,216,285,231,121,75,140,199,1045,1.8,3.5,5.4,2017
Malachi Richardson,SG,22,26,324,30,90,0.333,12,40,0.3,18,50,0.36,17,22,0.773,5,29,34,13,10,1,10,27,89,-0.2,0.1,-0.1,2017
Austin Rivers,SG,25,61,2057,341,805,0.424,136,360,0.378,205,445,0.461,102,159,0.642,27,118,145,242,74,16,109,152,920,1.4,1.0,2.4,2017
Andre Roberson,SG,26,39,1037,87,162,0.537,8,36,0.222,79,126,0.627,12,38,0.316,75,110,185,46,45,35,30,89,194,0.8,1.3,2.2,2017
Devin Robinson,SF,22,1,13,1,3,0.333,0,0,0.0,1,3,0.333,0,0,0.0,2,3,5,0,1,0,0,2,2,0.0,0.0,0.0,2017
Glenn Robinson III,SF,24,23,338,36,85,0.424,14,34,0.412,22,51,0.431,9,11,0.818,11,26,37,17,13,1,5,14,95,0.4,0.3,0.6,2017
Rajon Rondo,PG,31,65,1705,231,494,0.468,50,150,0.333,181,344,0.526,25,46,0.543,31,232,263,533,70,10,151,119,537,1.9,1.7,3.6,2017
Derrick Rose,PG,29,25,420,81,186,0.435,7,30,0.233,74,156,0.474,40,46,0.87,13,22,35,37,7,4,35,16,209,-0.2,0.1,-0.2,2017
Terrence Ross,SG,26,24,600,76,191,0.398,30,93,0.323,46,98,0.469,27,36,0.75,10,63,73,38,27,11,29,45,209,-0.2,0.5,0.3,2017
Terry Rozier,PG,23,80,2068,316,800,0.395,153,402,0.381,163,398,0.41,115,149,0.772,63,313,376,232,80,19,80,123,900,2.2,3.4,5.6,2017
Ricky Rubio,PG,27,77,2254,346,827,0.418,96,273,0.352,250,554,0.451,220,254,0.866,44,307,351,410,121,11,207,206,1008,1.5,3.8,5.3,2017
D'Angelo Russell,PG,21,48,1234,278,672,0.414,90,278,0.324,188,394,0.477,97,131,0.74,30,159,189,249,36,17,147,93,743,-0.5,0.9,0.4,2017
Domantas Sabonis,C,21,74,1810,340,661,0.514,13,37,0.351,327,624,0.524,168,224,0.75,165,407,572,151,40,32,137,220,861,2.5,2.2,4.7,2017
JaKarr Sampson,SF,24,22,344,44,81,0.543,5,10,0.5,39,71,0.549,10,16,0.625,21,57,78,9,8,22,8,48,103,0.4,0.4,0.8,2017
Dario Šarić,PF,23,78,2310,403,890,0.453,157,399,0.393,246,491,0.501,178,207,0.86,154,366,520,202,51,20,148,160,1141,3.8,2.8,6.6,2017
Tomáš Satoranský,SG,26,73,1643,201,384,0.523,47,101,0.465,154,283,0.544,75,96,0.781,72,161,233,286,52,15,83,131,524,3.7,1.3,5.0,2017
Dennis Schröder,PG,24,67,2078,500,1146,0.436,76,262,0.29,424,884,0.48,225,265,0.849,44,164,208,417,72,6,183,147,1301,1.5,1.0,2.6,2017
Mike Scott,PF,29,76,1406,276,524,0.527,66,163,0.405,210,361,0.582,50,76,0.658,50,197,247,80,23,10,79,148,668,1.4,1.0,2.5,2017
Thabo Sefolosha,SF,33,38,806,118,240,0.492,32,84,0.381,86,156,0.551,44,54,0.815,29,132,161,33,52,12,30,59,312,1.0,1.6,2.6,2017
Wayne Selden,SG,23,35,692,116,269,0.431,49,122,0.402,67,147,0.456,44,59,0.746,16,40,56,66,18,5,54,59,325,0.1,0.2,0.3,2017
Ramon Sessions,PG,31,28,392,42,117,0.359,8,26,0.308,34,91,0.374,44,57,0.772,6,32,38,77,14,2,30,29,136,0.1,0.3,0.3,2017
Iman Shumpert,SG,27,14,276,22,58,0.379,7,26,0.269,15,32,0.469,11,15,0.733,7,34,41,17,9,4,16,22,62,-0.2,0.2,0.0,2017
Pascal Siakam,PF,23,81,1679,253,498,0.508,29,132,0.22,224,366,0.612,54,87,0.621,79,285,364,159,62,42,67,166,589,2.1,2.5,4.7,2017
Xavier Silas,SG,30,2,7,0,3,0.0,0,2,0.0,0,1,0.0,0,0,0.0,1,1,2,0,1,0,0,1,0,-0.1,0.0,0.0,2017
Ben Simmons,PG,21,81,2732,544,998,0.545,0,11,0.0,544,987,0.551,191,341,0.56,145,514,659,661,140,70,278,211,1279,4.2,5.0,9.2,2017
Jonathon Simmons,SG,28,69,2029,354,761,0.465,69,204,0.338,285,557,0.512,185,241,0.768,61,178,239,171,58,16,146,175,962,0.8,1.1,1.9,2017
Kobi Simmons,PG,20,32,643,80,189,0.423,11,39,0.282,69,150,0.46,25,25,1.0,14,36,50,68,18,5,44,61,196,-0.4,0.2,-0.2,2017
Kyle Singler,SF,29,12,59,7,21,0.333,2,5,0.4,5,16,0.313,7,13,0.538,1,9,10,2,1,0,3,4,23,-0.1,0.0,0.0,2017
Marcus Smart,SG,23,54,1614,189,515,0.367,75,249,0.301,114,266,0.429,97,133,0.729,43,146,189,259,71,23,129,133,550,-0.6,2.5,1.9,2017
Dennis Smith Jr.,PG,20,69,2049,404,1024,0.395,106,339,0.313,298,685,0.435,134,193,0.694,50,210,260,358,71,18,194,152,1048,-2.4,1.7,-0.7,2017
Ish Smith,PG,29,82,2043,389,801,0.486,35,101,0.347,354,700,0.506,81,116,0.698,27,197,224,360,64,20,108,140,894,2.4,2.0,4.4,2017
J.R. Smith,SG,32,80,2244,240,595,0.403,143,381,0.375,97,214,0.453,39,56,0.696,29,206,235,141,68,11,81,161,662,0.6,0.9,1.4,2017
Jason Smith,C,31,33,285,45,115,0.391,4,32,0.125,41,83,0.494,19,21,0.905,18,35,53,14,3,13,16,44,113,-0.2,0.3,0.0,2017
Josh Smith,PF,32,3,12,1,4,0.25,0,0,0.0,1,4,0.25,0,0,0.0,3,1,4,0,0,0,0,3,2,0.0,0.0,0.0,2017
Tony Snell,SG,26,75,2053,185,425,0.435,108,268,0.403,77,157,0.49,38,48,0.792,9,132,141,98,47,28,36,115,516,1.6,0.7,2.4,2017
Marreese Speights,C,30,52,675,138,349,0.395,86,233,0.369,52,116,0.448,40,55,0.727,21,112,133,40,8,22,40,106,402,0.1,0.5,0.6,2017
Nik Stauskas,SG,24,41,523,60,154,0.39,40,100,0.4,20,54,0.37,21,29,0.724,4,60,64,39,9,4,26,24,181,0.1,0.3,0.3,2017
Lance Stephenson,SG,27,82,1850,303,709,0.427,67,232,0.289,236,477,0.495,84,127,0.661,62,362,424,235,46,17,131,177,757,-0.2,2.0,1.8,2017
David Stockton,PG,26,3,9,2,3,0.667,2,3,0.667,0,0,0.0,4,4,1.0,0,0,0,0,0,0,1,3,10,0.1,0.0,0.1,2017
Julyan Stone,SG,29,23,175,6,13,0.462,6,13,0.462,0,0,0.0,1,2,0.5,1,28,29,26,4,2,7,21,19,0.2,0.2,0.3,2017
Edmond Sumner,PG,22,1,2,1,1,1.0,0,0,0.0,1,1,1.0,0,0,0.0,0,1,1,0,0,0,0,1,2,0.0,0.0,0.0,2017
Caleb Swanigan,PF,20,27,189,24,60,0.4,1,8,0.125,23,52,0.442,12,18,0.667,15,39,54,14,5,3,18,37,61,-0.3,0.3,0.0,2017
Jayson Tatum,SF,19,80,2443,397,835,0.475,105,242,0.434,292,593,0.492,213,258,0.826,50,352,402,128,83,58,114,170,1112,3.0,4.0,7.1,2017
Isaiah Taylor,PG,23,67,1167,163,390,0.418,20,80,0.25,143,310,0.461,99,141,0.702,22,72,94,206,34,10,84,116,445,0.2,0.5,0.6,2017
Jeff Teague,PG,29,70,2311,354,794,0.446,84,228,0.368,270,566,0.477,202,239,0.845,24,185,209,492,102,23,177,171,994,3.4,1.4,4.9,2017
Marquis Teague,PG,24,3,74,4,16,0.25,1,4,0.25,3,12,0.25,2,5,0.4,1,5,6,13,4,0,3,5,11,-0.1,0.0,-0.1,2017
Mirza Teletović,PF,32,10,159,25,57,0.439,21,45,0.467,4,12,0.333,0,0,0.0,3,20,23,10,4,1,7,14,71,0.2,0.1,0.3,2017
Garrett Temple,SG,31,65,1615,199,476,0.418,89,227,0.392,110,249,0.442,60,78,0.769,22,130,152,124,57,27,79,135,547,0.3,0.9,1.2,2017
Miloš Teodosić,PG,30,45,1134,151,360,0.419,88,232,0.379,63,128,0.492,39,46,0.848,16,110,126,209,23,5,97,103,429,0.9,0.5,1.4,2017
Jason Terry,SG,40,51,814,59,154,0.383,40,115,0.348,19,39,0.487,8,9,0.889,5,43,48,59,42,13,25,52,166,0.1,0.6,0.7,2017
Daniel Theis,C,25,63,936,126,233,0.541,18,58,0.31,108,175,0.617,61,81,0.753,90,184,274,56,30,48,56,157,331,1.6,1.9,3.5,2017
Isaiah Thomas,PG,28,32,862,157,421,0.373,55,188,0.293,102,233,0.438,117,131,0.893,17,50,67,153,15,3,95,58,486,-0.1,0.3,0.2,2017
Lance Thomas,PF,29,73,1353,102,267,0.382,50,124,0.403,52,143,0.364,44,53,0.83,44,131,175,44,30,14,40,134,298,0.3,0.6,0.9,2017
Klay Thompson,SG,27,73,2506,575,1179,0.488,229,521,0.44,346,658,0.526,82,98,0.837,31,246,277,185,55,34,128,117,1461,3.1,1.8,4.9,2017
Tristan Thompson,C,26,53,1072,132,235,0.562,0,0,0.0,132,235,0.562,43,79,0.544,126,226,352,33,16,17,36,102,307,1.8,0.7,2.5,2017
Sindarius Thornwell,SG,23,73,1156,100,233,0.429,23,61,0.377,77,172,0.448,59,88,0.67,33,107,140,68,48,25,53,125,282,0.1,0.9,1.0,2017
Anthony Tolliver,PF,32,79,1757,219,472,0.464,159,365,0.436,60,107,0.561,106,133,0.797,50,191,241,90,32,21,58,144,703,3.8,1.5,5.3,2017
Karl-Anthony Towns,C,22,82,2918,639,1172,0.545,120,285,0.421,519,887,0.585,345,402,0.858,238,774,1012,199,64,115,159,285,1743,10.6,3.4,14.0,2017
P.J. Tucker,PF,32,82,2281,172,441,0.39,115,310,0.371,57,131,0.435,43,60,0.717,93,364,457,77,78,26,74,205,502,1.0,3.0,3.9,2017
Evan Turner,SF,29,79,2034,258,577,0.447,42,132,0.318,216,445,0.485,91,107,0.85,30,214,244,173,47,29,99,163,649,0.5,2.1,2.6,2017
Myles Turner,C,21,65,1836,306,639,0.479,56,157,0.357,250,482,0.519,160,206,0.777,93,324,417,87,38,118,96,186,828,2.2,2.5,4.7,2017
Ekpe Udoh,C,30,63,810,60,120,0.5,0,1,0.0,60,119,0.504,42,56,0.75,68,82,150,53,43,74,20,105,162,1.3,1.8,3.2,2017
Tyler Ulis,PG,22,71,1658,214,551,0.388,42,146,0.288,172,405,0.425,84,101,0.832,24,104,128,311,70,7,127,120,554,-0.7,0.5,-0.2,2017
Jonas Valančiūnas,C,25,77,1727,390,687,0.568,30,74,0.405,360,613,0.587,170,211,0.806,183,477,660,81,29,69,115,192,980,4.6,3.0,7.6,2017
Denzel Valentine,SG,24,77,2095,301,721,0.417,143,370,0.386,158,351,0.45,38,51,0.745,48,345,393,244,65,11,99,185,783,1.0,1.5,2.5,2017
Fred VanVleet,PG,23,76,1520,232,545,0.426,108,261,0.414,124,284,0.437,84,101,0.832,25,159,184,243,68,19,74,130,656,2.7,2.0,4.7,2017
Rashad Vaughn,SG,21,28,212,23,56,0.411,14,37,0.378,9,19,0.474,4,6,0.667,3,18,21,13,5,3,6,15,64,0.1,0.1,0.2,2017
Noah Vonleh,PF,22,54,875,104,234,0.444,20,66,0.303,84,168,0.5,36,58,0.621,70,241,311,34,19,17,31,68,264,0.5,1.2,1.6,2017
Nikola Vučević,C,27,57,1683,399,840,0.475,64,204,0.314,335,636,0.527,77,94,0.819,101,422,523,191,56,62,109,144,939,1.3,2.3,3.6,2017
Dwyane Wade*,SG,36,67,1536,299,682,0.438,32,111,0.288,267,571,0.468,135,189,0.714,50,202,252,228,61,47,140,124,765,-0.4,1.6,1.1,2017
Dion Waiters,SG,26,30,918,163,410,0.398,52,170,0.306,111,240,0.463,51,69,0.739,8,69,77,113,23,9,70,61,429,-0.7,0.8,0.1,2017
Kemba Walker,PG,27,80,2736,588,1363,0.431,231,601,0.384,357,762,0.469,363,420,0.864,32,216,248,444,91,24,179,98,1770,6.5,2.0,8.6,2017
John Wall,PG,27,41,1410,280,667,0.42,62,167,0.371,218,500,0.436,175,241,0.726,22,128,150,393,57,45,158,80,797,1.2,1.5,2.7,2017
Tyrone Wallace,PG,23,30,851,110,247,0.445,10,40,0.25,100,207,0.483,61,78,0.782,21,84,105,71,27,13,46,83,291,0.2,0.5,0.7,2017
Derrick Walton,PG,22,16,147,8,25,0.32,7,17,0.412,1,8,0.125,6,6,1.0,2,14,16,16,7,3,2,7,29,0.2,0.2,0.4,2017
Jameel Warney,PF,24,3,27,7,12,0.583,0,0,0.0,7,12,0.583,3,5,0.6,4,5,9,0,0,0,1,2,17,0.1,0.0,0.1,2017
T.J. Warren,SF,24,65,2142,529,1063,0.498,20,90,0.222,509,973,0.523,193,255,0.757,125,208,333,85,65,41,85,149,1271,2.6,0.8,3.4,2017
Travis Wear,SF,27,17,228,25,72,0.347,17,47,0.362,8,25,0.32,8,8,1.0,0,38,38,7,4,5,6,30,75,0.0,0.2,0.2,2017
James Webb III,SF,24,10,120,6,24,0.25,4,19,0.211,2,5,0.4,0,0,0.0,8,16,24,4,1,0,4,10,16,-0.1,0.0,-0.1,2017
Briante Weber,PG,25,18,237,19,43,0.442,4,11,0.364,15,32,0.469,8,10,0.8,8,27,35,22,18,5,15,28,50,0.0,0.4,0.4,2017
David West,C,37,73,999,216,378,0.571,3,8,0.375,213,370,0.576,60,79,0.759,64,174,238,138,47,75,80,120,495,1.8,1.7,3.5,2017
Russell Westbrook,PG,29,80,2914,757,1687,0.449,97,326,0.298,660,1361,0.485,417,566,0.737,152,652,804,820,147,20,381,200,2028,5.5,4.5,10.1,2017
Andrew White,SF,24,15,209,25,73,0.342,18,49,0.367,7,24,0.292,1,4,0.25,4,30,34,6,3,1,8,12,69,-0.2,0.1,-0.1,2017
Derrick White,PG,23,17,139,16,33,0.485,8,13,0.615,8,20,0.4,14,20,0.7,5,21,26,9,4,3,6,8,54,0.3,0.2,0.5,2017
Okaro White,PF,25,6,80,7,16,0.438,4,11,0.364,3,5,0.6,2,3,0.667,3,8,11,2,1,1,1,6,20,0.1,0.1,0.2,2017
Isaiah Whitehead,PG,22,16,180,40,86,0.465,7,18,0.389,33,68,0.485,13,19,0.684,4,22,26,20,8,2,24,23,100,-0.3,0.2,-0.1,2017
Hassan Whiteside,C,28,54,1364,312,578,0.54,2,2,1.0,310,576,0.538,128,182,0.703,174,444,618,54,37,94,92,131,754,2.3,3.0,5.3,2017
Andrew Wiggins,SF,22,82,2979,569,1300,0.438,112,338,0.331,457,962,0.475,202,314,0.643,82,276,358,160,91,51,138,163,1452,0.5,1.6,2.1,2017
Jacob Wiley,PF,23,5,33,1,4,0.25,1,2,0.5,0,2,0.0,1,2,0.5,2,9,11,2,1,0,0,4,4,0.0,0.0,0.1,2017
Damien Wilkins,SF,38,19,152,13,39,0.333,4,18,0.222,9,21,0.429,3,4,0.75,5,11,16,9,2,1,5,7,33,-0.1,0.1,-0.1,2017
Alan Williams,PF,25,5,70,7,18,0.389,0,0,0.0,7,18,0.389,6,9,0.667,3,19,22,8,5,1,7,13,20,-0.1,0.1,0.0,2017
C.J. Williams,SG,27,38,707,87,197,0.442,22,78,0.282,65,119,0.546,13,16,0.813,12,44,56,43,31,13,20,63,209,0.3,0.5,0.7,2017
Derrick Williams,PF,26,2,9,1,4,0.25,0,2,0.0,1,2,0.5,0,0,0.0,0,1,1,0,0,0,0,0,2,0.0,0.0,0.0,2017
Lou Williams,SG,31,79,2589,582,1337,0.435,186,518,0.359,396,819,0.484,432,491,0.88,40,158,198,417,85,19,234,106,1782,5.5,1.2,6.7,2017
Marvin Williams,PF,31,78,2006,258,563,0.458,126,305,0.413,132,258,0.512,102,123,0.829,74,296,370,96,56,38,66,116,744,3.1,1.9,5.0,2017
Matt Williams,SG,24,3,11,2,6,0.333,1,5,0.2,1,1,1.0,0,0,0.0,0,1,1,0,0,0,1,1,5,-0.1,0.0,0.0,2017
Troy Williams,SF,23,21,307,51,109,0.468,11,38,0.289,40,71,0.563,20,30,0.667,22,41,63,16,20,4,19,34,133,0.2,0.4,0.5,2017
D.J. Wilson,PF,21,22,71,9,16,0.563,2,5,0.4,7,11,0.636,1,2,0.5,2,8,10,3,3,1,4,7,21,0.0,0.1,0.1,2017
Jamil Wilson,SF,27,15,274,38,81,0.469,27,63,0.429,11,18,0.611,2,4,0.5,3,29,32,10,5,8,8,34,105,0.4,0.2,0.5,2017
Justise Winslow,PF,21,68,1680,207,488,0.424,49,129,0.38,158,359,0.44,66,104,0.635,64,306,370,148,54,33,77,140,529,0.2,2.4,2.6,2017
Jeff Withey,C,27,9,39,6,16,0.375,2,10,0.2,4,6,0.667,1,2,0.5,1,9,10,0,0,3,2,3,15,-0.1,0.1,0.0,2017
Nate Wolters,PG,26,5,19,1,6,0.167,0,0,0.0,1,6,0.167,0,0,0.0,1,1,2,1,0,0,0,1,2,-0.1,0.0,-0.1,2017
Brandan Wright,PF,30,28,381,59,102,0.578,0,0,0.0,59,102,0.578,21,33,0.636,33,62,95,13,13,26,8,32,139,0.8,0.5,1.3,2017
Delon Wright,PG,25,69,1433,201,432,0.465,56,153,0.366,145,279,0.52,97,117,0.829,45,153,198,200,72,33,78,81,555,2.5,2.1,4.5,2017
Guerschon Yabusele,PF,22,33,235,26,61,0.426,12,37,0.324,14,24,0.583,15,22,0.682,17,35,52,16,4,5,12,23,79,0.3,0.3,0.6,2017
James Young,SG,22,6,61,5,14,0.357,3,10,0.3,2,4,0.5,4,6,0.667,0,2,2,2,0,0,1,4,17,0.0,0.0,0.1,2017
Joe Young,PG,25,53,558,80,186,0.43,25,66,0.379,55,120,0.458,22,29,0.759,12,51,63,39,14,1,26,39,207,0.1,0.4,0.5,2017
Nick Young,SG,32,80,1393,201,488,0.412,123,326,0.377,78,162,0.481,56,65,0.862,20,105,125,36,38,7,39,100,581,0.8,0.9,1.7,2017
Thaddeus Young,PF,29,81,2607,421,864,0.487,58,181,0.32,363,683,0.531,55,92,0.598,184,328,512,152,135,36,105,175,955,2.3,3.2,5.5,2017
Cody Zeller,C,25,33,627,85,156,0.545,2,3,0.667,83,153,0.542,61,85,0.718,67,110,177,31,14,21,33,81,233,1.2,0.7,1.9,2017
Tyler Zeller,C,28,66,1109,187,334,0.56,10,28,0.357,177,306,0.578,57,79,0.722,110,195,305,47,15,35,47,126,441,2.0,0.9,2.9,2017
Paul Zipser,SF,23,54,824,81,234,0.346,37,110,0.336,44,124,0.355,19,25,0.76,13,118,131,46,20,15,43,86,218,-1.1,0.6,-0.6,2017
Ante Žižić,C,21,32,214,49,67,0.731,0,0,0.0,49,67,0.731,21,29,0.724,24,36,60,5,2,13,11,30,119,0.9,0.2,1.0,2017
Ivica Zubac,C,20,43,410,61,122,0.5,0,1,0.0,61,121,0.504,39,51,0.765,45,78,123,25,8,15,26,47,161,0.5,0.5,1.0,2017
Álex Abrines,SG,25,31,588,56,157,0.357,41,127,0.323,15,30,0.5,12,13,0.923,5,43,48,20,17,6,14,53,165,0.1,0.6,0.6,2018
Quincy Acy,PF,28,10,123,4,18,0.222,2,15,0.133,2,3,0.667,7,10,0.7,3,22,25,8,1,4,4,24,17,-0.1,0.0,-0.1,2018
Jaylen Adams,PG,22,34,428,38,110,0.345,25,74,0.338,13,36,0.361,7,9,0.778,11,49,60,65,14,5,28,45,108,-0.1,0.2,0.1,2018
Steven Adams,C,25,80,2669,481,809,0.595,0,2,0.0,481,807,0.596,146,292,0.5,391,369,760,124,117,76,135,204,1108,5.1,4.0,9.1,2018
Bam Adebayo,C,21,82,1913,280,486,0.576,3,15,0.2,277,471,0.588,166,226,0.735,165,432,597,184,71,65,121,203,729,3.4,3.4,6.8,2018
Deng Adel,SF,21,19,194,11,36,0.306,6,23,0.261,5,13,0.385,4,4,1.0,3,16,19,5,1,4,6,13,32,-0.2,0.0,-0.2,2018
DeVaughn Akoon-Purcell,SG,25,7,22,3,10,0.3,0,4,0.0,3,6,0.5,1,2,0.5,1,3,4,6,2,0,2,4,7,-0.1,0.0,0.0,2018
LaMarcus Aldridge,C,33,81,2687,684,1319,0.519,10,42,0.238,674,1277,0.528,349,412,0.847,251,493,744,194,43,107,144,179,1727,6.4,2.9,9.3,2018
Rawle Alkins,SG,21,10,120,13,39,0.333,3,12,0.25,10,27,0.37,8,12,0.667,11,15,26,13,1,0,8,7,37,-0.1,0.0,-0.1,2018
Grayson Allen,SG,23,38,416,67,178,0.376,32,99,0.323,35,79,0.443,45,60,0.75,3,20,23,25,6,6,33,47,211,-0.4,0.4,0.0,2018
Jarrett Allen,C,20,80,2096,335,568,0.59,6,45,0.133,329,523,0.629,197,278,0.709,191,481,672,110,43,120,103,184,873,4.4,3.3,7.6,2018
Kadeem Allen,PG,26,19,416,65,141,0.461,17,36,0.472,48,105,0.457,42,54,0.778,8,43,51,76,16,4,26,46,189,0.7,0.2,1.0,2018
Al-Farouq Aminu,PF,28,81,2292,257,593,0.433,96,280,0.343,161,313,0.514,150,173,0.867,112,498,610,104,68,33,72,143,760,3.0,2.8,5.8,2018
Justin Anderson,SF,25,48,463,64,157,0.408,24,77,0.312,40,80,0.5,26,35,0.743,24,60,84,23,22,13,23,48,178,0.1,0.4,0.4,2018
Kyle Anderson,SF,25,43,1281,150,276,0.543,9,34,0.265,141,242,0.583,37,64,0.578,48,203,251,128,54,37,58,112,346,0.8,1.8,2.7,2018
Ryan Anderson,PF,30,25,322,21,69,0.304,9,40,0.225,12,29,0.414,12,16,0.75,18,36,54,19,4,1,14,25,63,-0.3,0.0,-0.2,2018
Ike Anigbogu,C,20,3,6,0,3,0.0,0,0,0.0,0,3,0.0,0,0,0.0,1,2,3,1,0,1,1,0,0,-0.1,0.0,-0.1,2018
Giannis Antetokounmpo,PF,24,72,2358,721,1247,0.578,52,203,0.256,669,1044,0.641,500,686,0.729,159,739,898,424,92,110,268,232,1994,8.9,5.5,14.4,2018
Kostas Antetokounmpo,PF,21,2,11,0,3,0.0,0,0,0.0,0,3,0.0,2,4,0.5,0,1,1,0,2,0,1,0,2,-0.1,0.0,-0.1,2018
Carmelo Anthony,PF,34,10,294,49,121,0.405,21,64,0.328,28,57,0.491,15,22,0.682,9,45,54,5,4,7,8,32,134,0.1,0.2,0.3,2018
OG Anunoby,SF,21,67,1352,183,404,0.453,67,202,0.332,116,202,0.574,36,62,0.581,58,139,197,47,46,22,55,140,469,0.3,1.7,2.0,2018
Ryan Arcidiacono,PG,24,81,1961,187,418,0.447,81,217,0.373,106,201,0.527,89,102,0.873,27,192,219,269,65,4,63,171,544,2.8,0.9,3.7,2018
Trevor Ariza,SF,33,69,2349,294,736,0.399,145,434,0.334,149,302,0.493,130,164,0.793,50,321,371,252,91,21,106,130,863,1.3,1.2,2.5,2018
D.J. Augustin,PG,31,81,2269,318,677,0.47,131,311,0.421,187,366,0.511,181,209,0.866,41,162,203,426,52,4,128,115,948,5.0,1.9,6.9,2018
Deandre Ayton,C,20,71,2183,509,870,0.585,0,4,0.0,509,866,0.588,141,189,0.746,223,506,729,125,61,67,126,209,1159,4.1,1.7,5.8,2018
Dwayne Bacon,SG,23,43,759,122,257,0.475,38,87,0.437,84,170,0.494,34,46,0.739,8,81,89,47,12,5,18,72,316,0.9,0.3,1.2,2018
Marvin Bagley III,PF,19,62,1567,356,706,0.504,30,96,0.313,326,610,0.534,181,262,0.691,162,309,471,62,33,59,98,120,923,2.0,1.6,3.6,2018
Ron Baker,SG,25,15,152,4,20,0.2,1,13,0.077,3,7,0.429,5,6,0.833,1,10,11,15,6,1,5,18,14,-0.2,0.1,-0.1,2018
Wade Baldwin,PG,22,16,94,10,33,0.303,2,9,0.222,8,24,0.333,8,11,0.727,2,13,15,12,1,2,14,11,30,-0.4,0.1,-0.3,2018
Lonzo Ball,PG,21,47,1423,185,456,0.406,75,228,0.329,110,228,0.482,20,48,0.417,54,197,251,255,69,19,103,114,465,-0.2,1.7,1.6,2018
Mo Bamba,C,20,47,766,117,243,0.481,21,70,0.3,96,173,0.555,37,63,0.587,64,169,233,39,13,64,43,102,292,0.3,1.4,1.7,2018
J.J. Barea,PG,34,38,752,161,385,0.418,38,128,0.297,123,257,0.479,55,78,0.705,13,82,95,211,22,1,72,50,415,0.4,0.6,1.0,2018
Harrison Barnes,PF,26,77,2533,431,1027,0.42,174,441,0.395,257,586,0.439,229,278,0.824,57,304,361,115,50,13,98,122,1265,2.0,1.6,3.6,2018
Will Barton,SF,28,43,1189,185,460,0.402,67,196,0.342,118,264,0.447,57,74,0.77,32,167,199,124,18,22,65,82,494,0.1,1.1,1.2,2018
Keita Bates-Diop,SF,23,30,503,60,142,0.423,13,52,0.25,47,90,0.522,18,28,0.643,16,67,83,17,18,14,14,29,151,0.0,0.4,0.3,2018
Nicolas Batum,SF,30,75,2354,253,562,0.45,116,298,0.389,137,264,0.519,77,89,0.865,71,319,390,247,71,43,117,140,699,2.0,1.7,3.7,2018
Jerryd Bayless,PG,30,34,657,82,230,0.357,29,98,0.296,53,132,0.402,16,28,0.571,11,51,62,119,18,2,32,56,209,-0.2,0.2,0.0,2018
Aron Baynes,C,32,51,821,105,223,0.471,21,61,0.344,84,162,0.519,53,62,0.855,88,152,240,57,12,34,40,125,284,1.3,1.1,2.3,2018
Kent Bazemore,SG,29,67,1643,278,691,0.402,96,300,0.32,182,391,0.465,127,175,0.726,37,224,261,152,89,42,121,170,779,-0.7,1.4,0.7,2018
Bradley Beal,SG,25,82,3028,764,1609,0.475,209,596,0.351,555,1013,0.548,362,448,0.808,89,322,411,448,121,58,224,226,2099,5.9,1.7,7.6,2018
Malik Beasley,SG,22,81,1879,349,737,0.474,163,405,0.402,186,332,0.56,56,66,0.848,35,165,200,97,55,10,55,116,917,2.9,1.6,4.5,2018
Michael Beasley,PF,30,26,277,75,153,0.49,3,17,0.176,72,136,0.529,28,39,0.718,13,47,60,25,9,10,27,42,181,-0.1,0.4,0.2,2018
Marco Belinelli,SG,32,79,1815,285,690,0.413,147,395,0.372,138,295,0.468,112,124,0.903,16,182,198,132,35,8,72,121,829,1.4,1.1,2.5,2018
Jordan Bell,C,24,68,788,99,192,0.516,0,2,0.0,99,190,0.521,25,41,0.61,55,129,184,76,20,51,42,80,223,0.5,1.1,1.6,2018
DeAndre' Bembry,SG,24,82,1931,275,616,0.446,50,173,0.289,225,443,0.508,87,136,0.64,54,304,358,202,105,41,142,190,687,-0.9,1.7,0.9,2018
Dragan Bender,PF,21,46,826,88,197,0.447,22,101,0.218,66,96,0.688,32,54,0.593,34,149,183,56,18,22,37,90,230,0.0,0.4,0.5,2018
Dairis Bertāns,SG,29,12,167,12,47,0.255,10,34,0.294,2,13,0.154,0,0,0.0,2,7,9,10,1,0,2,7,34,-0.2,0.0,-0.2,2018
Dāvis Bertāns,PF,26,76,1632,204,453,0.45,145,338,0.429,59,115,0.513,53,60,0.883,23,241,264,100,35,33,43,133,606,2.6,1.5,4.0,2018
Patrick Beverley,PG,30,78,2137,194,477,0.407,112,282,0.397,82,195,0.421,96,123,0.78,76,312,388,300,67,43,85,265,596,2.8,2.0,4.8,2018
Khem Birch,C,26,50,643,91,151,0.603,0,1,0.0,91,150,0.607,58,83,0.699,79,111,190,38,18,29,20,72,240,1.8,1.0,2.8,2018
Bismack Biyombo,C,26,54,783,89,156,0.571,0,0,0.0,89,156,0.571,58,91,0.637,81,166,247,33,11,41,34,103,236,1.2,0.8,2.0,2018
Nemanja Bjelica,PF,30,77,1788,284,593,0.479,103,257,0.401,181,336,0.539,70,92,0.761,125,319,444,147,54,56,82,197,741,2.7,1.9,4.5,2018
Antonio Blakeney,SG,22,57,829,166,396,0.419,36,91,0.396,130,305,0.426,50,76,0.658,7,99,106,42,12,9,35,41,418,-0.8,0.3,-0.5,2018
Eric Bledsoe,PG,29,78,2272,470,971,0.484,124,377,0.329,346,594,0.582,177,236,0.75,82,280,362,430,116,29,165,156,1241,4.4,3.7,8.2,2018
Jaron Blossomgame,SF,25,27,439,47,106,0.443,10,39,0.256,37,67,0.552,10,13,0.769,26,72,98,13,7,8,11,20,114,0.2,0.1,0.3,2018
Bogdan Bogdanović,SG,26,70,1947,361,863,0.418,134,372,0.36,227,491,0.462,134,162,0.827,40,203,243,267,72,15,117,142,990,1.3,1.4,2.7,2018
Bojan Bogdanović,SF,29,81,2573,522,1051,0.497,164,386,0.425,358,665,0.538,246,305,0.807,33,300,333,161,69,1,134,138,1454,3.9,2.8,6.8,2018
Andrew Bogut,C,34,11,134,18,36,0.5,0,0,0.0,18,36,0.5,3,3,1.0,12,43,55,11,3,8,8,22,39,0.1,0.2,0.3,2018
Jonah Bolden,PF,23,44,639,80,162,0.494,34,96,0.354,46,66,0.697,13,27,0.481,47,118,165,40,17,39,36,99,207,0.5,0.9,1.4,2018
Isaac Bonga,PG,19,22,120,5,33,0.152,0,8,0.0,5,25,0.2,9,15,0.6,9,16,25,15,9,4,6,9,19,-0.3,0.2,-0.1,2018
Devin Booker,SG,22,64,2242,586,1255,0.467,135,414,0.326,451,841,0.536,393,454,0.866,39,226,265,433,56,13,264,200,1700,3.3,0.3,3.5,2018
Chris Boucher,PF,26,28,163,34,76,0.447,12,37,0.324,22,39,0.564,13,15,0.867,16,40,56,2,6,24,7,31,93,0.2,0.4,0.7,2018
Avery Bradley,SG,28,63,1905,248,608,0.408,86,245,0.351,162,363,0.446,43,50,0.86,43,132,175,152,41,16,89,167,625,-0.6,1.0,0.3,2018
Tony Bradley,C,21,3,36,8,16,0.5,0,0,0.0,8,16,0.5,1,2,0.5,9,6,15,1,2,2,3,6,17,0.0,0.1,0.1,2018
Corey Brewer,SF,32,31,492,53,123,0.431,14,44,0.318,39,79,0.494,31,43,0.721,26,50,76,39,32,7,19,63,151,0.4,0.6,1.0,2018
Mikal Bridges,SF,22,82,2417,242,563,0.43,105,313,0.335,137,250,0.548,95,118,0.805,56,208,264,173,129,38,70,201,684,1.7,1.2,2.9,2018
Miles Bridges,SF,20,80,1696,237,511,0.464,65,200,0.325,172,311,0.553,58,77,0.753,67,256,323,95,55,49,50,111,597,1.4,1.5,2.9,2018
Isaiah Briscoe,PG,22,39,559,55,138,0.399,11,34,0.324,44,104,0.423,15,26,0.577,5,69,74,87,11,2,31,66,136,-0.3,0.5,0.3,2018
Ryan Broekhoff,SG,28,42,453,57,126,0.452,38,93,0.409,19,33,0.576,15,19,0.789,8,55,63,22,6,4,16,35,167,0.5,0.3,0.8,2018
Malcolm Brogdon,SG,26,64,1832,378,748,0.505,104,244,0.426,274,504,0.544,141,152,0.928,65,223,288,205,46,13,91,102,1001,4.2,2.3,6.5,2018
Dillon Brooks,SF,23,18,330,49,122,0.402,15,40,0.375,34,82,0.415,22,30,0.733,9,22,31,16,10,4,19,50,135,-0.3,0.3,0.0,2018
MarShon Brooks,SG,30,29,387,76,169,0.45,15,54,0.278,61,115,0.53,23,33,0.697,12,33,45,25,9,4,21,33,190,-0.2,0.3,0.1,2018
Bruce Brown,SG,22,74,1449,125,314,0.398,24,93,0.258,101,221,0.457,45,60,0.75,48,137,185,91,40,36,46,178,319,-0.1,1.6,1.5,2018
Jaylen Brown,SG,22,74,1913,368,792,0.465,95,276,0.344,273,516,0.529,133,202,0.658,65,248,313,100,69,32,99,186,964,0.7,2.3,2.9,2018
Lorenzo Brown,PG,28,26,212,23,71,0.324,6,28,0.214,17,43,0.395,3,3,1.0,5,26,31,28,12,5,16,22,55,-0.5,0.3,-0.1,2018
Sterling Brown,SG,23,58,1034,145,312,0.465,53,147,0.361,92,165,0.558,29,42,0.69,29,155,184,84,25,8,46,88,372,0.7,1.4,2.1,2018
Troy Brown Jr.,SF,19,52,730,97,234,0.415,22,69,0.319,75,165,0.455,32,47,0.681,35,110,145,80,21,5,30,56,248,0.2,0.4,0.6,2018
Jalen Brunson,PG,22,73,1591,264,565,0.467,63,181,0.348,201,384,0.523,87,120,0.725,25,144,169,230,37,4,88,127,678,1.5,1.0,2.6,2018
Thomas Bryant,C,21,72,1496,309,502,0.616,33,99,0.333,276,403,0.685,107,137,0.781,113,341,454,92,25,67,60,126,758,4.3,1.3,5.6,2018
Reggie Bullock,SG,27,63,1879,245,594,0.412,148,393,0.377,97,201,0.483,73,85,0.859,22,151,173,129,40,12,65,109,711,1.6,1.4,3.1,2018
Trey Burke,PG,26,58,1125,236,548,0.431,56,159,0.352,180,389,0.463,103,124,0.831,28,71,99,159,33,7,49,58,631,1.4,0.5,1.9,2018
Alec Burks,SG,27,64,1375,192,474,0.405,61,168,0.363,131,306,0.428,116,141,0.823,30,205,235,128,39,21,65,91,561,0.7,0.8,1.5,2018
Deonte Burton,SG,25,32,240,33,82,0.402,8,27,0.296,25,55,0.455,8,12,0.667,4,24,28,9,6,8,9,31,82,-0.2,0.3,0.1,2018
Jimmy Butler,SF,29,65,2185,418,904,0.462,67,193,0.347,351,711,0.494,312,365,0.855,121,221,342,263,123,39,95,111,1215,5.4,2.5,7.9,2018
Bruno Caboclo,PF,23,34,800,96,225,0.427,48,130,0.369,48,95,0.505,42,50,0.84,42,116,158,50,14,33,38,81,282,0.6,0.9,1.5,2018
José Calderón,PG,37,49,632,45,120,0.375,14,57,0.246,31,63,0.492,9,11,0.818,11,49,60,115,16,3,35,64,113,0.0,0.5,0.6,2018
Kentavious Caldwell-Pope,SG,25,82,2035,325,756,0.43,151,435,0.347,174,321,0.542,137,158,0.867,48,190,238,110,73,13,65,137,938,2.3,1.8,4.0,2018
Isaiah Canaan,PG,27,30,629,64,164,0.39,34,96,0.354,30,68,0.441,19,24,0.792,6,52,58,84,14,2,35,52,181,0.0,0.1,0.1,2018
Clint Capela,C,24,67,2249,474,732,0.648,0,0,0.0,474,732,0.648,166,261,0.636,298,550,848,96,44,102,94,168,1114,7.8,3.0,10.8,2018
DeMarre Carroll,PF,32,67,1703,227,575,0.395,106,310,0.342,121,265,0.457,184,242,0.76,68,281,349,85,31,10,73,114,744,1.5,1.6,3.1,2018
Jevon Carter,PG,23,39,577,56,185,0.303,34,102,0.333,22,83,0.265,26,32,0.813,14,52,66,69,26,11,33,55,172,-0.7,0.7,0.0,2018
Vince Carter*,PF,42,76,1330,196,468,0.419,123,316,0.389,73,152,0.48,47,66,0.712,31,163,194,87,44,27,48,141,562,1.2,0.7,1.9,2018
Wendell Carter Jr.,C,19,44,1110,180,371,0.485,6,32,0.188,174,339,0.513,89,112,0.795,87,220,307,78,26,58,65,152,455,0.7,1.2,1.9,2018
Michael Carter-Williams,PG,27,28,372,46,123,0.374,10,38,0.263,36,85,0.424,32,53,0.604,19,51,70,70,20,15,20,48,134,0.2,0.6,0.8,2018
Alex Caruso,PG,24,25,531,77,173,0.445,24,50,0.48,53,123,0.431,51,64,0.797,20,47,67,77,24,9,42,54,229,0.5,0.6,1.0,2018
Omri Casspi,SF,30,36,520,86,161,0.534,15,43,0.349,71,118,0.602,39,58,0.672,17,98,115,26,20,9,23,35,226,0.6,0.7,1.3,2018
Willie Cauley-Stein,C,25,81,2213,412,741,0.556,1,2,0.5,411,739,0.556,140,254,0.551,181,497,678,194,96,51,84,227,965,3.8,2.9,6.7,2018
Troy Caupain,PG,23,4,16,4,8,0.5,2,3,0.667,2,5,0.4,0,0,0.0,1,2,3,4,1,0,0,0,10,0.1,0.0,0.1,2018
Tyler Cavanaugh,PF,24,11,39,3,10,0.3,1,5,0.2,2,5,0.4,2,2,1.0,3,5,8,1,0,0,1,3,9,0.0,0.0,0.0,2018
Tyson Chandler,C,36,55,875,61,99,0.616,0,1,0.0,61,98,0.622,51,87,0.586,92,215,307,37,21,23,42,110,173,0.9,1.2,2.1,2018
Wilson Chandler,PF,31,51,1177,114,273,0.418,59,158,0.373,55,115,0.478,18,25,0.72,48,167,215,82,25,21,46,123,305,0.5,1.0,1.5,2018
Joe Chealey,PG,23,1,8,1,3,0.333,0,0,0.0,1,3,0.333,0,0,0.0,0,0,0,1,0,0,0,1,2,0.0,0.0,0.0,2018
Chris Chiozza,PG,23,7,33,2,8,0.25,2,5,0.4,0,3,0.0,0,0,0.0,1,3,4,4,1,1,1,2,6,0.0,0.0,0.0,2018
Marquese Chriss,PF,21,43,499,67,180,0.372,16,72,0.222,51,108,0.472,32,45,0.711,40,102,142,22,17,11,36,81,182,-0.6,0.4,-0.2,2018
Gary Clark,PF,24,51,641,50,151,0.331,41,138,0.297,9,13,0.692,7,7,1.0,24,92,116,18,20,26,7,47,148,0.3,0.7,1.0,2018
Ian Clark,SG,27,60,973,151,383,0.394,66,202,0.327,85,181,0.47,33,37,0.892,13,76,89,94,22,8,58,95,401,-0.4,0.3,-0.1,2018
Jordan Clarkson,SG,26,81,2214,529,1180,0.448,144,445,0.324,385,735,0.524,162,192,0.844,82,188,270,196,57,13,135,112,1364,1.9,-0.1,1.8,2018
John Collins,PF,21,61,1829,465,831,0.56,55,158,0.348,410,673,0.609,203,266,0.763,219,376,595,121,22,39,120,199,1188,5.0,1.0,6.0,2018
Zach Collins,C,21,77,1356,189,400,0.473,40,121,0.331,149,279,0.534,94,126,0.746,109,215,324,71,25,66,77,174,512,1.4,1.5,2.9,2018
Darren Collison,PG,31,76,2143,308,659,0.467,79,194,0.407,229,465,0.492,158,190,0.832,36,196,232,459,110,9,125,138,853,3.9,2.9,6.8,2018
Bonzie Colson,SF,23,8,98,13,39,0.333,5,21,0.238,8,18,0.444,8,9,0.889,8,22,30,3,5,1,3,3,39,0.0,0.2,0.2,2018
Mike Conley,PG,31,70,2342,490,1120,0.438,155,426,0.364,335,694,0.483,343,406,0.845,40,199,239,449,94,22,130,123,1478,5.7,2.3,8.0,2018
Pat Connaughton,SG,26,61,1261,163,350,0.466,66,200,0.33,97,150,0.647,29,40,0.725,61,197,258,122,33,25,33,81,421,2.0,1.9,3.9,2018
Quinn Cook,PG,25,74,1059,204,439,0.465,81,200,0.405,123,239,0.515,20,26,0.769,22,135,157,116,20,3,50,92,509,1.0,0.8,1.8,2018
DeMarcus Cousins,C,28,30,771,178,371,0.48,26,95,0.274,152,276,0.551,106,144,0.736,43,204,247,107,40,44,72,109,488,0.9,1.5,2.4,2018
Robert Covington,SF,28,35,1203,156,362,0.431,85,225,0.378,71,137,0.518,68,89,0.764,28,165,193,46,74,47,47,126,465,0.9,1.6,2.5,2018
Allen Crabbe,SG,26,43,1133,137,373,0.367,98,259,0.378,39,114,0.342,41,56,0.732,16,132,148,46,23,13,46,102,413,-0.2,1.0,0.8,2018
Torrey Craig,SF,28,75,1503,160,362,0.442,61,188,0.324,99,174,0.569,49,70,0.7,89,174,263,72,37,46,44,175,430,1.4,1.7,3.0,2018
Jamal Crawford,SG,38,64,1211,174,438,0.397,67,202,0.332,107,236,0.453,93,110,0.845,8,77,85,229,33,12,99,75,508,0.1,0.0,0.2,2018
Mitch Creek,SF,26,5,48,8,16,0.5,0,2,0.0,8,14,0.571,5,7,0.714,6,6,12,6,2,0,1,3,21,0.1,0.0,0.2,2018
Jae Crowder,SF,28,80,2166,318,797,0.399,173,522,0.331,145,275,0.527,142,197,0.721,60,324,384,133,64,31,85,170,951,1.3,3.1,4.4,2018
Dante Cunningham,PF,31,64,928,75,158,0.475,30,65,0.462,45,93,0.484,14,18,0.778,48,140,188,50,27,13,22,71,194,1.0,0.9,1.9,2018
Seth Curry,SG,28,74,1399,212,465,0.456,113,251,0.45,99,214,0.463,44,52,0.846,27,93,120,66,36,12,61,97,581,1.5,0.9,2.4,2018
Stephen Curry,PG,30,69,2331,632,1340,0.472,354,810,0.437,278,530,0.525,263,287,0.916,45,324,369,361,92,25,192,166,1881,7.2,2.5,9.7,2018
Troy Daniels,SG,27,51,760,113,275,0.411,74,194,0.381,39,81,0.481,18,23,0.783,13,60,73,26,26,5,27,79,318,0.2,0.1,0.3,2018
Anthony Davis,C,25,56,1850,530,1026,0.517,48,145,0.331,482,881,0.547,344,433,0.794,174,498,672,218,88,135,112,132,1452,6.4,3.1,9.5,2018
Deyonta Davis,C,22,9,118,15,22,0.682,0,1,0.0,15,21,0.714,6,10,0.6,10,26,36,5,3,5,3,12,36,0.3,0.1,0.4,2018
Ed Davis,C,29,81,1446,186,302,0.616,0,2,0.0,186,300,0.62,100,162,0.617,216,478,694,61,35,33,64,226,472,3.3,2.5,5.7,2018
Tyler Davis,C,21,1,1,0,1,0.0,0,0,0.0,0,1,0.0,0,0,0.0,1,0,1,0,0,0,0,0,0,0.0,0.0,0.0,2018
Dewayne Dedmon,C,29,64,1609,259,526,0.492,83,217,0.382,176,309,0.57,92,113,0.814,105,375,480,90,69,71,84,214,693,2.1,1.9,4.0,2018
Sam Dekker,PF,24,47,788,120,256,0.469,19,62,0.306,101,194,0.521,28,46,0.609,53,95,148,46,38,7,24,47,287,0.6,0.5,1.0,2018
Ángel Delgado,C,24,2,15,1,5,0.2,0,0,0.0,1,5,0.2,1,2,0.5,2,2,4,0,1,0,0,2,3,0.0,0.0,0.0,2018
Matthew Dellavedova,PG,28,48,812,98,242,0.405,44,130,0.338,54,112,0.482,42,52,0.808,6,71,77,181,14,2,68,75,282,0.5,0.0,0.5,2018
Luol Deng,SF,33,22,392,59,118,0.5,14,44,0.318,45,74,0.608,25,35,0.714,20,53,73,18,15,8,14,24,157,0.5,0.3,0.8,2018
DeMar DeRozan,SG,29,77,2688,631,1313,0.481,7,45,0.156,624,1268,0.492,366,441,0.83,54,408,462,475,86,36,199,177,1635,3.6,2.6,6.3,2018
Marcus Derrickson,PF,22,11,67,16,33,0.485,10,20,0.5,6,13,0.462,4,5,0.8,8,5,13,1,0,1,3,9,46,0.2,0.0,0.2,2018
Cheick Diallo,PF,22,64,896,168,271,0.62,1,4,0.25,167,267,0.625,50,67,0.746,75,257,332,33,29,33,49,113,387,1.4,1.2,2.6,2018
Hamidou Diallo,SG,20,51,526,75,165,0.455,4,24,0.167,71,141,0.504,36,59,0.61,38,59,97,17,21,10,23,77,190,0.1,0.7,0.8,2018
Gorgui Dieng,C,29,76,1031,189,377,0.501,19,56,0.339,170,321,0.53,88,106,0.83,81,230,311,72,48,41,57,134,485,1.5,1.3,2.8,2018
Spencer Dinwiddie,PG,25,68,1914,366,828,0.442,124,370,0.335,242,458,0.528,287,356,0.806,26,140,166,311,40,17,152,187,1143,3.5,1.4,4.8,2018
Donte DiVincenzo,SG,22,27,411,50,124,0.403,22,83,0.265,28,41,0.683,9,12,0.75,16,49,65,31,13,6,19,38,131,0.0,0.6,0.6,2018
Luka Dončić,SG,19,72,2318,506,1186,0.427,168,514,0.327,338,672,0.503,346,485,0.713,86,477,563,429,77,25,247,137,1526,2.1,2.8,4.9,2018
Tyler Dorsey,SG,22,48,698,107,264,0.405,44,132,0.333,63,132,0.477,38,61,0.623,27,86,113,56,14,2,27,53,296,0.2,0.4,0.6,2018
Damyean Dotson,SG,24,73,2004,290,698,0.415,126,342,0.368,164,356,0.461,73,98,0.745,34,228,262,135,58,10,71,135,779,0.7,0.9,1.5,2018
PJ Dozier,SG,22,6,51,8,21,0.381,2,8,0.25,6,13,0.462,1,2,0.5,6,11,17,5,2,0,0,2,19,0.1,0.1,0.1,2018
Goran Dragić,PG,32,36,991,179,433,0.413,57,164,0.348,122,269,0.454,79,101,0.782,20,91,111,174,30,5,71,81,494,0.6,1.0,1.6,2018
Andre Drummond,C,25,79,2647,561,1052,0.533,5,38,0.132,556,1014,0.548,243,412,0.59,423,809,1232,112,136,138,175,272,1370,4.1,5.9,10.0,2018
Jared Dudley,PF,33,59,1220,101,239,0.423,53,151,0.351,48,88,0.545,32,46,0.696,34,121,155,83,36,16,43,131,287,0.6,1.2,1.8,2018
Kris Dunn,PG,24,46,1389,215,506,0.425,34,96,0.354,181,410,0.441,55,69,0.797,19,168,187,277,68,21,104,166,519,-0.5,1.2,0.6,2018
Kevin Durant,SF,30,78,2702,721,1383,0.521,137,388,0.353,584,995,0.587,448,506,0.885,33,464,497,457,58,84,225,155,2027,8.6,2.9,11.5,2018
Trevon Duval,PG,20,3,6,2,3,0.667,1,1,1.0,1,2,0.5,0,0,0.0,0,1,1,2,0,0,0,0,5,0.1,0.0,0.1,2018
Vince Edwards,SF,22,2,16,1,4,0.25,1,4,0.25,0,0,0.0,0,0,0.0,1,1,2,0,0,0,0,0,3,0.0,0.0,0.0,2018
Henry Ellenson,PF,22,19,259,39,95,0.411,17,38,0.447,22,57,0.386,19,25,0.76,5,61,66,16,7,2,9,27,114,0.2,0.2,0.4,2018
Wayne Ellington,SG,31,53,1297,184,457,0.403,138,372,0.371,46,85,0.541,39,49,0.796,14,93,107,72,54,6,40,92,545,1.3,1.4,2.6,2018
Joel Embiid,C,24,64,2154,580,1199,0.484,79,263,0.3,501,936,0.535,522,649,0.804,160,711,871,234,46,122,226,211,1761,4.9,3.8,8.7,2018
James Ennis III,SF,28,58,1230,138,294,0.469,55,156,0.353,83,138,0.601,58,81,0.716,60,122,182,41,41,23,34,150,389,1.6,1.0,2.6,2018
Drew Eubanks,PF,21,23,113,15,26,0.577,0,0,0.0,15,26,0.577,11,13,0.846,6,28,34,7,2,5,8,11,41,0.1,0.2,0.3,2018
Jacob Evans,SG,21,30,204,18,53,0.34,4,15,0.267,14,38,0.368,0,1,0.0,6,19,25,23,5,3,11,28,40,-0.3,0.2,-0.1,2018
Jawun Evans,PG,22,8,65,3,14,0.214,0,3,0.0,3,11,0.273,0,0,0.0,1,11,12,10,3,0,6,8,6,-0.2,0.0,-0.2,2018
Tyreke Evans,SG,29,69,1402,257,660,0.389,77,216,0.356,180,444,0.405,115,160,0.719,33,168,201,166,58,18,118,117,706,-1.7,2.0,0.3,2018
Dante Exum,PG,23,42,664,101,241,0.419,18,62,0.29,83,179,0.464,68,86,0.791,16,52,68,110,14,5,52,69,288,0.2,0.7,1.0,2018
Kenneth Faried,C,29,37,728,156,265,0.589,8,25,0.32,148,240,0.617,64,99,0.646,97,153,250,20,17,23,33,82,384,2.1,0.9,2.9,2018
Derrick Favors,C,27,76,1766,363,619,0.586,17,78,0.218,346,541,0.64,154,228,0.675,207,353,560,89,56,106,84,163,897,4.4,3.5,7.9,2018
Cristiano Felício,C,26,60,746,95,179,0.531,0,4,0.0,95,175,0.543,50,73,0.685,79,139,218,37,11,7,33,69,240,0.9,0.4,1.4,2018
Raymond Felton,PG,34,33,379,55,135,0.407,20,61,0.328,35,74,0.473,12,13,0.923,4,30,34,52,10,6,14,29,142,0.3,0.4,0.7,2018
Terrance Ferguson,SG,20,74,1931,185,431,0.429,106,290,0.366,79,141,0.56,37,51,0.725,33,108,141,72,40,16,47,231,513,1.2,1.6,2.8,2018
Yogi Ferrell,PG,25,71,1067,153,352,0.435,54,149,0.362,99,203,0.488,60,67,0.896,13,96,109,137,36,4,40,64,420,1.3,0.6,1.9,2018
Dorian Finney-Smith,SF,25,81,1985,228,528,0.432,79,254,0.311,149,274,0.544,73,103,0.709,138,251,389,95,69,36,74,186,608,1.2,2.0,3.3,2018
Bryn Forbes,SG,25,82,2293,361,791,0.456,176,413,0.426,185,378,0.489,69,78,0.885,18,221,239,175,45,4,80,159,967,2.5,1.3,3.8,2018
Evan Fournier,SG,26,81,2553,468,1069,0.438,153,450,0.34,315,619,0.509,137,170,0.806,38,220,258,295,71,12,154,225,1226,0.8,2.5,3.2,2018
De'Aaron Fox,PG,21,81,2546,505,1102,0.458,86,232,0.371,419,870,0.482,303,417,0.727,43,261,304,590,133,45,227,204,1399,3.2,2.5,5.6,2018
Melvin Frazier,SG,22,10,44,7,21,0.333,0,6,0.0,7,15,0.467,1,4,0.25,3,2,5,1,1,0,1,6,15,-0.2,0.0,-0.1,2018
Tim Frazier,PG,28,59,1120,116,261,0.444,37,101,0.366,79,160,0.494,41,54,0.759,41,127,168,248,30,5,76,112,310,1.3,0.7,2.0,2018
Jimmer Fredette,SG,29,6,65,8,29,0.276,0,13,0.0,8,16,0.5,6,6,1.0,1,6,7,8,3,0,5,5,22,-0.2,0.0,-0.2,2018
Enes Freedom,C,26,67,1640,375,683,0.549,10,34,0.294,365,649,0.562,155,197,0.787,257,402,659,116,32,26,118,167,915,3.9,1.6,5.4,2018
Channing Frye,C,35,36,341,43,117,0.368,32,79,0.405,11,38,0.289,11,14,0.786,4,48,52,20,6,5,13,44,129,0.1,0.0,0.1,2018
Markelle Fultz,SG,20,19,427,65,155,0.419,4,14,0.286,61,141,0.433,21,37,0.568,26,44,70,59,17,5,25,52,155,-0.1,0.4,0.3,2018
Danilo Gallinari,SF,30,68,2059,409,884,0.463,161,372,0.433,248,512,0.484,367,406,0.904,54,363,417,178,49,23,99,129,1346,6.4,1.8,8.2,2018
Langston Galloway,SG,27,80,1745,228,587,0.388,135,380,0.355,93,207,0.449,81,96,0.844,49,122,171,85,37,8,24,135,672,2.1,1.3,3.4,2018
Billy Garrett,SG,24,4,63,11,27,0.407,0,8,0.0,11,19,0.579,4,4,1.0,0,3,3,7,1,1,2,3,26,0.0,0.0,0.0,2018
Marc Gasol,C,34,79,2436,390,870,0.448,99,273,0.363,291,597,0.487,192,253,0.759,80,547,627,349,84,86,155,217,1071,2.0,4.0,6.0,2018
Pau Gasol*,C,38,30,360,42,94,0.447,6,13,0.462,36,81,0.444,28,40,0.7,22,115,137,52,5,15,16,29,118,0.5,0.5,1.1,2018
Rudy Gay,PF,32,69,1842,376,746,0.504,74,184,0.402,302,562,0.537,120,147,0.816,63,407,470,182,54,34,114,159,946,2.2,2.2,4.4,2018
Paul George,SF,28,77,2841,707,1614,0.438,292,757,0.386,415,857,0.484,453,540,0.839,105,523,628,318,170,34,205,214,2159,7.0,4.9,11.9,2018
Taj Gibson,PF,33,70,1686,304,537,0.566,11,34,0.324,293,503,0.583,134,177,0.757,172,286,458,84,53,39,73,186,753,3.7,1.4,5.1,2018
Harry Giles,PF,20,58,820,175,348,0.503,0,6,0.0,175,342,0.512,58,91,0.637,66,156,222,85,31,22,73,150,408,0.0,1.0,1.0,2018
Shai Gilgeous-Alexander,PG,20,82,2174,341,716,0.476,51,139,0.367,290,577,0.503,156,195,0.8,57,175,232,270,96,45,141,175,889,1.5,1.9,3.3,2018
Rudy Gobert,C,26,81,2577,476,712,0.669,0,0,0.0,476,712,0.669,332,522,0.636,309,732,1041,161,66,187,130,231,1284,8.7,5.7,14.4,2018
Brandon Goodwin,PG,23,16,57,6,23,0.261,2,6,0.333,4,17,0.235,9,11,0.818,1,2,3,14,0,0,3,7,23,0.0,0.0,0.0,2018
Aaron Gordon,PF,23,78,2633,470,1046,0.449,121,347,0.349,349,699,0.499,185,253,0.731,129,445,574,289,57,56,162,172,1246,1.8,3.3,5.1,2018
Eric Gordon,SG,30,68,2158,384,938,0.409,216,600,0.36,168,338,0.497,119,152,0.783,17,131,148,129,41,27,90,143,1103,1.7,1.0,2.6,2018
Marcin Gortat,C,34,47,751,99,186,0.532,0,0,0.0,99,186,0.532,35,48,0.729,67,194,261,65,6,24,50,92,233,0.6,0.8,1.4,2018
Devonte' Graham,PG,23,46,676,74,216,0.343,34,121,0.281,40,95,0.421,35,46,0.761,10,53,63,121,23,2,30,48,217,0.2,0.3,0.5,2018
Treveon Graham,SG,25,35,715,64,191,0.335,38,128,0.297,26,63,0.413,18,22,0.818,23,84,107,34,13,7,17,68,184,-0.1,0.6,0.5,2018
Jerami Grant,PF,24,80,2612,409,823,0.497,115,293,0.392,294,530,0.555,157,221,0.71,96,321,417,79,61,100,67,214,1090,4.0,3.3,7.3,2018
Jerian Grant,PG,26,60,939,92,220,0.418,40,110,0.364,52,110,0.473,26,40,0.65,19,79,98,156,44,6,51,78,250,0.5,1.1,1.7,2018
Donte Grantham,SF,23,3,2,0,2,0.0,0,2,0.0,0,0,0.0,0,0,0.0,0,0,0,0,0,0,0,0,0,0.0,0.0,0.0,2018
Danny Green,SG,31,80,2216,293,630,0.465,198,435,0.455,95,195,0.487,37,44,0.841,60,257,317,126,73,53,75,171,821,3.0,2.9,5.9,2018
Draymond Green,PF,28,66,2065,188,422,0.445,47,165,0.285,141,257,0.549,63,91,0.692,60,421,481,454,95,70,169,197,486,1.1,3.2,4.3,2018
Gerald Green,SG,33,73,1473,231,578,0.4,156,441,0.354,75,137,0.547,57,68,0.838,30,152,182,40,33,27,55,126,675,0.9,1.0,1.9,2018
JaMychal Green,PF,28,65,1371,230,476,0.483,71,176,0.403,159,300,0.53,80,101,0.792,104,305,409,50,45,34,87,193,611,0.9,1.9,2.9,2018
Jeff Green,PF,32,77,2097,326,687,0.475,111,320,0.347,215,367,0.586,183,206,0.888,57,252,309,137,43,39,101,160,946,2.8,0.8,3.6,2018
Blake Griffin,PF,29,75,2622,619,1341,0.462,189,522,0.362,430,819,0.525,414,550,0.753,100,465,565,402,52,28,253,199,1841,5.1,2.9,8.0,2018
Daniel Hamilton,SG,23,19,204,23,60,0.383,8,23,0.348,15,37,0.405,3,6,0.5,10,37,47,22,6,1,16,19,57,-0.2,0.1,-0.1,2018
Dusty Hannahs,SG,25,2,26,3,12,0.25,0,5,0.0,3,7,0.429,2,2,1.0,0,1,1,5,1,0,1,1,8,-0.1,0.0,-0.1,2018
Tim Hardaway Jr.,SG,26,65,2057,390,993,0.393,162,477,0.34,228,516,0.442,232,276,0.841,33,189,222,159,54,8,105,141,1174,1.0,0.9,1.8,2018
James Harden,PG,29,78,2867,843,1909,0.442,378,1028,0.368,465,881,0.528,754,858,0.879,66,452,518,586,158,58,387,244,2818,11.4,3.8,15.2,2018
Maurice Harkless,SF,25,60,1415,189,388,0.487,33,120,0.275,156,268,0.582,49,73,0.671,77,192,269,74,67,53,45,163,460,1.5,1.9,3.4,2018
Montrezl Harrell,C,25,82,2158,546,888,0.615,3,17,0.176,543,871,0.623,266,414,0.643,184,351,535,162,71,110,132,255,1361,6.1,2.6,8.7,2018
Devin Harris,PG,35,68,1071,132,347,0.38,62,200,0.31,70,147,0.476,102,134,0.761,12,100,112,122,35,16,56,133,428,0.6,0.9,1.5,2018
Gary Harris,SG,24,57,1639,270,637,0.424,82,242,0.339,188,395,0.476,115,144,0.799,41,119,160,127,55,19,68,113,737,1.1,1.5,2.6,2018
Joe Harris,SG,27,76,2293,374,748,0.5,183,386,0.474,191,362,0.528,110,133,0.827,52,239,291,181,38,17,121,182,1041,3.8,1.7,5.5,2018
Tobias Harris,PF,26,82,2847,611,1254,0.487,156,393,0.397,455,861,0.528,266,307,0.866,69,576,645,229,51,37,151,184,1644,4.5,2.6,7.1,2018
Andrew Harrison,PG,24,17,187,16,53,0.302,5,25,0.2,11,28,0.393,17,18,0.944,6,14,20,24,4,2,12,34,54,-0.1,0.0,-0.1,2018
Shaquille Harrison,SG,25,73,1430,184,426,0.432,24,89,0.27,160,337,0.475,82,123,0.667,33,189,222,139,89,30,60,124,474,-0.1,1.6,1.4,2018
Josh Hart,SG,23,67,1715,189,464,0.407,92,274,0.336,97,190,0.511,55,80,0.688,35,213,248,93,64,40,58,147,525,0.2,1.9,2.1,2018
Isaiah Hartenstein,PF,20,28,221,20,41,0.488,2,6,0.333,18,35,0.514,11,14,0.786,21,26,47,15,7,12,13,56,53,0.2,0.3,0.5,2018
Udonis Haslem,C,38,10,74,11,33,0.333,0,12,0.0,11,21,0.524,3,4,0.75,3,24,27,2,0,0,3,9,25,-0.2,0.1,-0.1,2018
Gordon Hayward,PF,28,72,1863,296,635,0.466,77,231,0.333,219,404,0.542,156,187,0.834,51,271,322,244,62,23,105,104,825,2.6,2.2,4.8,2018
John Henson,C,28,14,188,31,67,0.463,11,31,0.355,20,36,0.556,6,10,0.6,16,55,71,14,7,11,12,16,79,0.1,0.4,0.6,2018
Juancho Hernangómez,PF,23,70,1358,138,314,0.439,66,181,0.365,72,133,0.541,66,86,0.767,64,201,265,55,27,24,37,94,408,1.6,1.4,3.0,2018
Willy Hernangómez,C,24,58,812,153,295,0.519,15,39,0.385,138,256,0.539,100,144,0.694,117,194,311,60,16,20,58,98,421,1.8,0.8,2.6,2018
Mario Hezonja,SF,23,58,1206,191,464,0.412,42,152,0.276,149,312,0.478,87,114,0.763,28,211,239,88,57,8,88,110,511,-1.1,1.1,-0.1,2018
Isaiah Hicks,PF,24,3,32,4,8,0.5,0,0,0.0,4,8,0.5,4,5,0.8,2,5,7,2,1,3,1,5,12,0.1,0.0,0.1,2018
Buddy Hield,SG,26,82,2615,623,1360,0.458,278,651,0.427,345,709,0.487,171,193,0.886,106,306,412,205,58,33,146,202,1695,4.3,1.6,5.9,2018
Haywood Highsmith,SF,22,5,40,4,10,0.4,1,5,0.2,3,5,0.6,0,2,0.0,0,5,5,2,1,0,1,1,9,0.0,0.0,0.0,2018
Nenê,C,36,42,546,60,116,0.517,0,3,0.0,60,113,0.531,31,47,0.66,34,89,123,26,18,15,11,87,151,0.8,0.6,1.4,2018
George Hill,PG,32,60,1302,170,376,0.452,48,153,0.314,122,223,0.547,70,85,0.824,39,109,148,135,52,8,51,102,458,1.5,1.3,2.8,2018
Solomon Hill,SF,27,44,878,68,178,0.382,32,101,0.317,36,77,0.468,23,32,0.719,34,99,133,55,23,10,31,80,191,0.1,0.4,0.5,2018
Aaron Holiday,PG,22,50,646,105,262,0.401,43,127,0.339,62,135,0.459,41,50,0.82,5,62,67,87,21,13,40,71,294,0.1,0.8,0.9,2018
Jrue Holiday,SG,28,67,2402,547,1159,0.472,118,363,0.325,429,796,0.539,208,271,0.768,75,259,334,518,109,54,210,148,1420,3.5,1.9,5.4,2018
Justin Holiday,SG,29,82,2607,300,777,0.386,162,465,0.348,138,312,0.442,95,106,0.896,46,277,323,146,121,36,104,164,857,-0.4,2.5,2.1,2018
John Holland,SF,30,1,1,0,0,0.0,0,0,0.0,0,0,0.0,0,0,0.0,0,0,0,0,0,0,0,0,0,0.0,0.0,0.0,2018
Rondae Hollis-Jefferson,SF,24,59,1234,200,487,0.411,9,49,0.184,191,438,0.436,118,183,0.645,83,227,310,96,44,27,68,107,527,-0.5,1.7,1.2,2018
Richaun Holmes,C,25,70,1184,222,365,0.608,0,0,0.0,222,365,0.608,128,175,0.731,115,216,331,60,42,79,52,194,572,3.1,1.1,4.3,2018
Rodney Hood,SG,26,72,1893,292,671,0.435,84,236,0.356,208,435,0.478,137,155,0.884,25,132,157,126,59,12,55,146,805,2.1,0.5,2.6,2018
Al Horford,C,32,68,1973,387,723,0.535,73,203,0.36,314,520,0.604,78,95,0.821,120,338,458,283,59,86,102,126,925,4.5,2.8,7.4,2018
Danuel House Jr.,SF,25,39,979,118,252,0.468,74,178,0.416,44,74,0.595,56,71,0.789,25,115,140,40,21,11,35,80,366,1.6,0.7,2.3,2018
Dwight Howard,C,33,9,230,43,69,0.623,0,0,0.0,43,69,0.623,29,48,0.604,24,59,83,4,7,4,16,34,115,0.4,0.2,0.6,2018
Kevin Huerter,SG,20,75,2048,275,657,0.419,136,353,0.385,139,304,0.457,41,56,0.732,60,185,245,214,65,25,109,155,727,0.7,0.7,1.5,2018
Isaac Humphries,C,21,5,56,6,21,0.286,3,11,0.273,3,10,0.3,0,0,0.0,4,7,11,0,1,0,0,7,15,-0.1,0.0,-0.1,2018
R.J. Hunter,SG,25,1,26,6,13,0.462,4,10,0.4,2,3,0.667,1,2,0.5,1,2,3,3,1,0,0,3,17,0.1,0.0,0.1,2018
Chandler Hutchison,SF,22,44,895,96,209,0.459,14,50,0.28,82,159,0.516,23,38,0.605,31,154,185,34,23,6,25,59,229,0.0,0.6,0.6,2018
Serge Ibaka,C,29,74,2010,464,877,0.529,49,169,0.29,415,708,0.586,135,177,0.763,156,445,601,99,29,103,114,211,1112,2.8,3.3,6.1,2018
Andre Iguodala,SF,35,68,1578,151,302,0.5,48,144,0.333,103,158,0.652,39,67,0.582,48,204,252,216,61,51,52,95,389,2.4,1.8,4.2,2018
Ersan İlyasova,PF,31,67,1231,167,381,0.438,58,160,0.363,109,221,0.493,61,74,0.824,94,208,302,52,32,20,48,172,453,1.2,1.9,3.0,2018
Joe Ingles,PF,31,82,2568,359,802,0.448,189,483,0.391,170,319,0.533,87,123,0.707,35,295,330,469,98,20,193,180,994,2.5,3.6,6.0,2018
Andre Ingram,SG,33,4,15,0,6,0.0,0,3,0.0,0,3,0.0,0,0,0.0,1,1,2,0,1,0,1,0,0,-0.1,0.0,-0.1,2018
Brandon Ingram,SF,21,52,1760,362,729,0.497,31,94,0.33,331,635,0.521,195,289,0.675,41,226,267,154,28,31,129,149,950,0.6,1.4,2.0,2018
Kyrie Irving,PG,26,67,2214,604,1241,0.487,174,434,0.401,430,807,0.533,214,245,0.873,71,264,335,464,103,34,172,167,1596,6.2,2.8,9.0,2018
Jonathan Isaac,PF,21,75,1996,262,611,0.429,86,266,0.323,176,345,0.51,110,135,0.815,99,312,411,80,59,98,75,143,720,0.9,3.1,4.0,2018
Wes Iwundu,SF,24,68,1233,113,274,0.412,29,79,0.367,84,195,0.431,84,103,0.816,37,147,184,73,28,22,44,123,339,0.5,1.4,1.9,2018
Demetrius Jackson,PG,24,6,39,8,15,0.533,2,6,0.333,6,9,0.667,4,4,1.0,2,1,3,5,2,0,1,4,22,0.2,0.0,0.2,2018
Frank Jackson,PG,20,61,1169,194,447,0.434,53,169,0.314,141,278,0.507,54,73,0.74,25,109,134,69,25,2,48,92,495,0.1,0.4,0.4,2018
Jaren Jackson Jr.,PF,19,58,1515,298,589,0.506,51,142,0.359,247,447,0.553,151,197,0.766,73,199,272,64,52,82,98,220,798,1.2,2.2,3.3,2018
Josh Jackson,SG,21,79,1988,347,841,0.413,73,225,0.324,274,616,0.445,143,213,0.671,66,281,347,183,74,56,173,209,910,-2.8,1.1,-1.7,2018
Justin Jackson,SF,23,81,1614,217,485,0.447,87,245,0.355,130,240,0.542,62,79,0.785,44,168,212,96,32,14,29,99,583,2.0,0.9,2.9,2018
Reggie Jackson,PG,28,82,2289,441,1047,0.421,174,471,0.369,267,576,0.464,204,236,0.864,45,171,216,344,55,9,148,208,1260,3.1,1.9,5.0,2018
LeBron James,SF,34,55,1937,558,1095,0.51,111,327,0.339,447,768,0.582,278,418,0.665,57,408,465,454,72,33,197,94,1505,4.7,2.6,7.2,2018
Amile Jefferson,PF,25,12,68,10,16,0.625,0,0,0.0,10,16,0.625,7,8,0.875,6,15,21,3,3,3,1,8,27,0.2,0.1,0.4,2018
John Jenkins,SG,27,26,333,42,105,0.4,22,58,0.379,20,47,0.426,15,18,0.833,6,31,37,22,0,2,9,10,121,0.2,0.0,0.2,2018
Jonas Jerebko,PF,31,73,1218,163,355,0.459,69,188,0.367,94,167,0.563,64,80,0.8,72,216,288,96,27,18,43,137,459,2.1,1.2,3.3,2018
Alize Johnson,PF,22,14,64,4,16,0.25,1,2,0.5,3,14,0.214,4,8,0.5,4,15,19,1,1,3,0,7,13,-0.1,0.1,0.0,2018
Amir Johnson,C,31,51,529,79,157,0.503,12,40,0.3,67,117,0.573,31,41,0.756,47,100,147,60,16,13,45,99,201,0.4,0.7,1.1,2018
B.J. Johnson,SF,23,7,49,9,18,0.5,3,7,0.429,6,11,0.545,2,2,1.0,2,6,8,0,2,0,2,4,23,0.0,0.0,0.1,2018
James Johnson,PF,31,55,1164,164,379,0.433,50,149,0.336,114,230,0.496,50,70,0.714,22,154,176,135,35,27,74,114,428,0.0,1.5,1.5,2018
Stanley Johnson,SF,22,66,1208,171,440,0.389,62,215,0.288,109,225,0.484,50,64,0.781,34,183,217,88,60,14,81,114,454,-1.1,1.6,0.5,2018
Tyler Johnson,PG,26,57,1529,217,526,0.413,90,260,0.346,127,266,0.477,95,127,0.748,34,139,173,166,54,27,77,97,619,0.9,1.4,2.3,2018
Wesley Johnson,SF,31,38,534,45,128,0.352,25,76,0.329,20,52,0.385,13,19,0.684,12,60,72,23,14,12,18,63,128,-0.3,0.3,0.0,2018
Nikola Jokić,C,23,80,2504,616,1206,0.511,83,270,0.307,533,936,0.569,289,352,0.821,228,637,865,580,108,55,248,228,1604,7.5,4.3,11.8,2018
Damian Jones,C,23,24,410,53,74,0.716,0,0,0.0,53,74,0.716,24,37,0.649,31,44,75,28,12,25,16,63,130,1.0,0.5,1.5,2018
Derrick Jones Jr.,SF,21,60,1153,160,324,0.494,28,91,0.308,132,233,0.567,74,122,0.607,96,144,240,37,46,42,43,123,422,1.2,1.7,2.9,2018
Jalen Jones,SF,25,16,214,26,62,0.419,10,28,0.357,16,34,0.471,19,27,0.704,11,23,34,7,9,2,8,27,81,0.2,0.1,0.3,2018
Jemerrio Jones,SF,23,6,143,12,33,0.364,2,10,0.2,10,23,0.435,1,2,0.5,16,33,49,13,7,5,5,10,27,0.0,0.2,0.2,2018
Terrence Jones,PF,27,2,5,1,4,0.25,0,2,0.0,1,2,0.5,0,1,0.0,0,4,4,0,0,0,1,1,2,-0.1,0.0,-0.1,2018
Tyus Jones,PG,22,68,1560,185,446,0.415,40,126,0.317,145,320,0.453,58,69,0.841,23,111,134,327,81,5,47,78,468,2.1,0.9,3.0,2018
DeAndre Jordan,C,30,69,2047,286,446,0.641,0,0,0.0,286,446,0.641,186,264,0.705,225,677,902,156,42,73,153,167,758,4.0,3.1,7.1,2018
Cory Joseph,PG,27,82,2063,226,548,0.412,55,171,0.322,171,377,0.454,30,43,0.698,39,240,279,321,94,22,80,131,537,0.5,2.9,3.5,2018
Frank Kaminsky,C,25,47,755,138,298,0.463,50,139,0.36,88,159,0.553,79,107,0.738,39,124,163,63,12,12,41,68,405,1.3,0.5,1.8,2018
Luke Kennard,SG,22,63,1437,228,520,0.438,106,269,0.394,122,251,0.486,51,61,0.836,12,171,183,114,26,10,57,92,613,1.3,1.3,2.5,2018
Michael Kidd-Gilchrist,PF,25,64,1179,158,332,0.476,16,47,0.34,142,285,0.498,95,123,0.772,88,158,246,61,32,39,43,156,427,1.5,1.0,2.5,2018
George King,SF,25,1,6,0,0,0.0,0,0,0.0,0,0,0.0,0,0,0.0,0,1,1,0,0,0,0,0,0,0.0,0.0,0.0,2018
Maxi Kleber,PF,27,71,1502,175,386,0.453,77,218,0.353,98,168,0.583,58,74,0.784,90,239,329,70,36,78,54,143,485,1.6,1.8,3.5,2018
Brandon Knight,PG,27,39,736,99,260,0.381,41,129,0.318,58,131,0.443,27,34,0.794,10,49,59,71,21,2,30,62,266,-0.1,0.0,0.0,2018
Kevin Knox,PF,19,75,2158,338,914,0.37,125,364,0.343,213,550,0.387,162,226,0.717,61,274,335,82,43,24,114,175,963,-2.2,0.9,-1.3,2018
Furkan Korkmaz,SG,21,48,679,98,245,0.4,47,144,0.326,51,101,0.505,36,44,0.818,16,91,107,52,29,2,25,62,279,0.4,0.7,1.1,2018
Luke Kornet,C,23,46,784,107,283,0.378,70,193,0.363,37,90,0.411,38,46,0.826,28,107,135,54,27,42,25,41,322,0.6,0.7,1.4,2018
Kyle Korver,SG,37,70,1334,201,483,0.416,138,348,0.397,63,135,0.467,60,73,0.822,9,153,162,81,25,12,59,106,600,1.0,1.3,2.3,2018
Kosta Koufos,C,29,42,502,73,153,0.477,0,0,0.0,73,153,0.477,10,24,0.417,52,125,177,36,15,18,27,68,156,0.0,0.7,0.7,2018
Rodions Kurucs,SF,20,63,1294,202,449,0.45,58,184,0.315,144,265,0.543,72,92,0.783,56,190,246,52,41,25,77,146,534,0.1,1.5,1.6,2018
Kyle Kuzma,PF,23,70,2314,496,1087,0.456,128,422,0.303,368,665,0.553,188,250,0.752,60,322,382,178,41,26,133,170,1308,1.2,1.9,3.1,2018
Skal Labissière,PF,22,22,176,26,49,0.531,6,13,0.462,20,36,0.556,9,17,0.529,9,34,43,11,5,6,11,29,67,0.1,0.2,0.3,2018
Jeremy Lamb,SG,26,79,2250,431,979,0.44,115,330,0.348,316,649,0.487,231,260,0.888,65,369,434,172,88,32,80,140,1208,3.3,2.0,5.3,2018
Zach LaVine,SG,23,63,2171,530,1135,0.467,120,321,0.374,410,814,0.504,312,375,0.832,40,254,294,283,60,26,215,140,1492,1.7,1.1,2.8,2018
Jake Layman,SF,24,71,1327,216,424,0.509,59,181,0.326,157,243,0.646,50,71,0.704,56,161,217,53,31,30,46,116,541,1.9,1.2,3.1,2018
T.J. Leaf,PF,21,58,522,99,183,0.541,8,31,0.258,91,152,0.599,19,31,0.613,43,82,125,24,9,19,12,35,225,0.9,0.7,1.6,2018
Courtney Lee,SG,33,34,428,53,129,0.411,16,55,0.291,37,74,0.5,14,21,0.667,9,45,54,37,21,3,14,32,136,0.1,0.4,0.4,2018
Damion Lee,SG,26,32,375,56,127,0.441,27,68,0.397,29,59,0.492,19,22,0.864,8,56,64,13,13,0,11,28,158,0.3,0.4,0.7,2018
Walt Lemon Jr.,PG,26,6,167,38,87,0.437,2,5,0.4,36,82,0.439,8,11,0.727,4,23,27,30,11,1,10,14,86,-0.1,0.2,0.1,2018
Alex Len,C,25,77,1544,320,648,0.494,74,204,0.363,246,444,0.554,140,216,0.648,158,266,424,86,27,69,97,200,854,2.2,1.0,3.2,2018
Kawhi Leonard,SF,27,60,2040,560,1129,0.496,112,302,0.371,448,827,0.542,364,426,0.854,78,361,439,199,106,24,121,87,1596,6.1,3.4,9.5,2018
Meyers Leonard,C,26,61,878,132,242,0.545,50,111,0.45,82,131,0.626,43,51,0.843,49,184,233,75,13,9,43,105,357,2.1,0.9,3.0,2018
Jon Leuer,PF,29,41,402,66,113,0.584,1,11,0.091,65,102,0.637,23,31,0.742,27,70,97,14,12,4,23,60,156,0.4,0.5,0.9,2018
Caris LeVert,SF,24,40,1063,207,483,0.429,48,154,0.312,159,329,0.483,85,123,0.691,35,116,151,156,42,14,69,77,547,0.5,1.2,1.7,2018
Damian Lillard,PG,28,80,2838,681,1533,0.444,237,643,0.369,444,890,0.499,468,513,0.912,68,303,371,551,88,34,212,148,2067,9.7,2.4,12.1,2018
Jeremy Lin,PG,30,74,1436,238,541,0.44,55,187,0.294,183,354,0.517,176,210,0.838,22,157,179,231,47,13,124,144,707,1.2,0.9,2.1,2018
Shaun Livingston,PG,33,64,967,109,210,0.519,0,2,0.0,109,208,0.524,40,51,0.784,42,75,117,114,31,27,38,74,258,1.2,0.9,2.0,2018
Zach Lofton,SG,26,1,4,0,1,0.0,0,1,0.0,0,0,0.0,0,0,0.0,0,0,0,0,1,0,1,0,0,-0.1,0.0,0.0,2018
Kevon Looney,C,22,80,1481,217,347,0.625,1,10,0.1,216,337,0.641,65,105,0.619,194,223,417,123,46,53,51,211,500,4.2,1.8,6.0,2018
Brook Lopez,C,30,81,2322,355,786,0.452,187,512,0.365,168,274,0.613,112,133,0.842,33,363,396,98,51,179,82,189,1009,2.3,4.3,6.7,2018
Robin Lopez,C,30,74,1606,304,535,0.568,7,31,0.226,297,504,0.589,89,123,0.724,140,146,286,89,11,78,96,124,704,2.0,0.7,2.7,2018
Kevin Love,PF,30,22,598,109,283,0.385,53,147,0.361,56,136,0.412,103,114,0.904,33,206,239,48,6,5,42,54,374,1.0,0.4,1.3,2018
Kyle Lowry,PG,32,65,2213,304,739,0.411,157,453,0.347,147,286,0.514,161,194,0.83,41,271,312,564,91,31,182,166,926,3.6,3.0,6.6,2018
Jordan Loyd,PG,25,12,55,8,18,0.444,4,8,0.5,4,10,0.4,9,11,0.818,1,8,9,6,0,0,2,5,29,0.2,0.0,0.2,2018
Kalin Lucas,PG,29,1,6,0,1,0.0,0,1,0.0,0,0,0.0,2,2,1.0,0,3,3,1,0,0,0,1,2,0.0,0.0,0.0,2018
Timothé Luwawu-Cabarrot,SF,23,50,669,82,218,0.376,36,116,0.31,46,102,0.451,31,41,0.756,11,86,97,26,19,8,21,73,231,-0.3,0.5,0.2,2018
Tyler Lydon,PF,22,25,94,9,18,0.5,4,10,0.4,5,8,0.625,1,3,0.333,7,11,18,6,2,0,4,10,23,0.1,0.1,0.2,2018
Trey Lyles,PF,23,64,1120,207,495,0.418,51,200,0.255,156,295,0.529,81,116,0.698,44,202,246,87,30,23,68,93,546,-0.2,1.4,1.2,2018
Scott Machado,PG,28,4,19,4,6,0.667,1,1,1.0,3,5,0.6,1,1,1.0,0,0,0,3,1,0,0,2,10,0.1,0.0,0.1,2018
Shelvin Mack,PG,28,57,1246,163,403,0.404,46,130,0.354,117,273,0.429,58,84,0.69,18,86,104,183,47,4,66,84,430,-0.2,1.1,0.9,2018
Daryl Macon,SG,23,8,90,10,27,0.37,5,11,0.455,5,16,0.313,4,7,0.571,2,10,12,7,1,0,6,8,29,-0.1,0.0,0.0,2018
J.P. Macura,SG,23,2,17,3,9,0.333,0,4,0.0,3,5,0.6,0,0,0.0,0,3,3,2,0,0,0,0,6,0.0,0.0,0.0,2018
Ian Mahinmi,C,32,34,498,47,104,0.452,3,16,0.188,44,88,0.5,42,61,0.689,48,80,128,25,25,16,21,84,139,0.5,0.5,1.0,2018
Thon Maker,C,21,64,972,109,268,0.407,49,153,0.32,60,115,0.522,56,84,0.667,41,161,202,45,21,51,33,105,323,0.5,1.5,2.0,2018
Boban Marjanović,C,30,58,681,160,260,0.615,4,10,0.4,156,250,0.624,98,131,0.748,87,178,265,54,16,27,59,90,422,2.1,0.9,3.0,2018
Lauri Markkanen,PF,21,52,1682,342,795,0.43,120,332,0.361,222,463,0.479,170,195,0.872,74,396,470,75,37,33,85,122,974,1.3,1.5,2.7,2018
Jarell Martin,PF,24,42,328,43,104,0.413,20,57,0.351,23,47,0.489,9,11,0.818,11,62,73,18,3,8,11,51,115,0.1,0.4,0.5,2018
Frank Mason III,PG,24,38,435,71,169,0.42,14,64,0.219,57,105,0.543,39,57,0.684,6,37,43,84,16,4,36,34,195,0.0,0.3,0.3,2018
Yante Maten,PF,22,2,13,1,4,0.25,0,1,0.0,1,3,0.333,0,0,0.0,1,2,3,0,1,0,0,0,2,0.0,0.0,0.0,2018
Wesley Matthews,SF,32,69,2091,279,698,0.4,150,403,0.372,129,295,0.437,132,163,0.81,32,138,170,160,54,17,91,160,840,1.1,1.5,2.7,2018
Luc Mbah a Moute,PF,32,4,61,8,18,0.444,2,6,0.333,6,12,0.5,2,5,0.4,2,5,7,2,1,1,2,8,20,0.0,0.0,0.0,2018
Tahjere McCall,SG,24,1,8,2,3,0.667,0,1,0.0,2,2,1.0,0,1,0.0,0,1,1,0,0,0,0,2,4,0.0,0.0,0.0,2018
Patrick McCaw,SG,23,29,397,26,63,0.413,9,28,0.321,17,35,0.486,13,15,0.867,7,41,48,29,23,2,17,38,74,0.0,0.5,0.5,2018
CJ McCollum,SG,27,70,2375,571,1243,0.459,167,445,0.375,404,798,0.506,159,192,0.828,62,220,282,207,55,28,106,172,1468,4.0,1.7,5.6,2018
T.J. McConnell,PG,26,76,1470,220,419,0.525,14,42,0.333,206,377,0.546,29,37,0.784,28,146,174,258,79,17,91,105,483,1.2,1.7,2.9,2018
Doug McDermott,SF,27,77,1340,207,422,0.491,84,206,0.408,123,216,0.569,66,79,0.835,17,92,109,67,18,8,42,104,564,1.8,1.1,2.9,2018
JaVale McGee,C,31,75,1671,400,641,0.624,1,12,0.083,399,629,0.634,96,152,0.632,195,371,566,52,47,148,108,208,897,3.0,2.9,5.9,2018
Rodney McGruder,SG,27,66,1550,186,461,0.403,79,225,0.351,107,236,0.453,52,72,0.722,60,178,238,112,36,12,64,115,503,0.4,1.6,1.9,2018
Alfonzo McKinnie,SF,26,72,1003,134,275,0.487,42,118,0.356,92,157,0.586,27,48,0.563,81,166,247,31,18,15,30,134,337,1.2,0.9,2.1,2018
Ben McLemore,SG,25,19,158,25,64,0.391,17,41,0.415,8,23,0.348,8,12,0.667,3,14,17,4,6,3,5,22,75,0.1,0.1,0.2,2018
Jordan McRae,SG,27,27,333,61,130,0.469,10,35,0.286,51,95,0.537,28,35,0.8,6,34,40,30,13,7,15,26,160,0.3,0.2,0.5,2018
Jodie Meeks,SG,31,8,104,21,39,0.538,8,18,0.444,13,21,0.619,1,1,1.0,1,11,12,8,1,1,2,5,51,0.2,0.1,0.3,2018
Salah Mejri,C,32,36,399,55,112,0.491,11,34,0.324,44,78,0.564,20,32,0.625,36,95,131,35,10,26,21,55,141,0.5,0.6,1.1,2018
De'Anthony Melton,PG,20,50,984,100,256,0.391,29,95,0.305,71,161,0.441,21,28,0.75,25,109,134,159,68,23,75,113,250,-0.8,0.8,0.0,2018
Chimezie Metu,PF,21,29,145,19,58,0.328,0,2,0.0,19,56,0.339,13,17,0.765,9,27,36,13,6,2,15,14,51,-0.5,0.2,-0.3,2018
Khris Middleton,SF,27,77,2393,506,1148,0.441,179,474,0.378,327,674,0.485,216,258,0.837,50,411,461,331,80,7,174,172,1407,2.5,3.6,6.1,2018
C.J. Miles,SF,31,53,856,112,311,0.36,67,203,0.33,45,108,0.417,48,58,0.828,13,82,95,36,26,15,30,79,339,-0.2,0.9,0.7,2018
Darius Miller,SF,28,69,1757,189,484,0.39,133,364,0.365,56,120,0.467,56,71,0.789,14,114,128,146,40,23,59,165,567,1.1,0.6,1.6,2018
Malcolm Miller,SF,25,10,67,11,26,0.423,10,21,0.476,1,5,0.2,3,4,0.75,1,4,5,1,1,1,1,5,35,0.1,0.1,0.2,2018
Patty Mills,PG,30,82,1908,282,663,0.425,159,404,0.394,123,259,0.475,88,103,0.854,24,158,182,245,49,10,93,129,811,2.2,1.2,3.5,2018
Paul Millsap,PF,33,70,1895,322,665,0.484,58,159,0.365,264,506,0.522,181,249,0.727,153,352,505,141,83,54,95,183,883,3.2,2.9,6.1,2018
Shake Milton,SG,22,20,268,34,87,0.391,14,44,0.318,20,43,0.465,5,7,0.714,9,26,35,18,8,8,6,29,87,0.1,0.3,0.3,2018
Nikola Mirotić,PF,27,46,1245,238,542,0.439,116,318,0.365,122,224,0.545,105,124,0.847,60,279,339,55,31,34,48,107,697,2.0,1.4,3.5,2018
Donovan Mitchell,SG,22,77,2598,661,1530,0.432,188,519,0.362,473,1011,0.468,319,396,0.806,59,257,316,322,106,31,218,208,1829,1.3,3.7,5.0,2018
Naz Mitrou-Long,SG,25,14,84,6,20,0.3,2,11,0.182,4,9,0.444,2,2,1.0,1,5,6,15,1,1,8,10,16,-0.2,0.1,-0.1,2018
Malik Monk,SG,20,73,1258,227,586,0.387,109,330,0.33,118,256,0.461,90,102,0.882,16,121,137,117,37,19,86,106,653,-0.4,0.7,0.3,2018
Greg Monroe,C,28,43,480,92,189,0.487,1,5,0.2,91,184,0.495,45,72,0.625,67,105,172,24,14,8,32,66,230,0.4,0.7,1.1,2018
E'Twaun Moore,SG,29,53,1463,256,532,0.481,76,176,0.432,180,356,0.506,45,59,0.763,35,92,127,102,40,8,59,112,633,1.2,0.5,1.7,2018
Eric Moreland,PF,27,5,43,3,7,0.429,1,1,1.0,2,6,0.333,0,0,0.0,4,16,20,4,1,1,5,9,7,-0.1,0.1,0.0,2018
Jaylen Morris,SG,23,4,29,4,10,0.4,1,3,0.333,3,7,0.429,1,2,0.5,0,5,5,4,2,0,1,1,10,0.0,0.1,0.1,2018
Marcus Morris,PF,29,75,2091,377,844,0.447,146,389,0.375,231,455,0.508,146,173,0.844,76,382,458,109,43,25,92,181,1046,2.1,2.4,4.4,2018
Markieff Morris,PF,29,58,1270,204,484,0.421,68,203,0.335,136,281,0.484,71,92,0.772,61,204,265,79,36,22,54,175,547,0.6,1.1,1.6,2018
Monte Morris,PG,23,82,1970,346,702,0.493,94,227,0.414,252,475,0.531,65,81,0.802,35,159,194,297,73,4,52,102,851,4.4,1.8,6.2,2018
Donatas Motiejūnas,PF,28,3,13,3,6,0.5,0,0,0.0,3,6,0.5,0,2,0.0,2,1,3,1,0,1,3,6,6,-0.1,0.0,-0.1,2018
Johnathan Motley,PF,23,22,156,39,73,0.534,0,3,0.0,39,70,0.557,24,40,0.6,18,33,51,11,5,3,16,27,102,0.1,0.2,0.3,2018
Emmanuel Mudiay,PG,22,59,1607,330,740,0.446,69,210,0.329,261,530,0.492,144,186,0.774,33,163,196,228,43,19,140,103,873,0.1,0.7,0.8,2018
Jamal Murray,PG,21,75,2447,513,1173,0.437,152,414,0.367,361,759,0.476,189,223,0.848,65,252,317,363,67,27,158,153,1367,2.8,2.3,5.1,2018
Džanan Musa,SG,19,9,39,9,22,0.409,1,10,0.1,8,12,0.667,0,2,0.0,1,4,5,2,2,0,4,1,19,-0.2,0.0,-0.1,2018
Mike Muscala,PF,27,64,1306,145,361,0.402,89,256,0.348,56,105,0.533,70,85,0.824,57,187,244,76,22,38,48,130,449,1.2,1.2,2.5,2018
Svi Mykhailiuk,SF,21,42,440,46,140,0.329,29,89,0.326,17,51,0.333,12,20,0.6,9,27,36,37,14,1,21,25,133,-0.4,0.3,-0.1,2018
Abdel Nader,SF,25,61,694,91,215,0.423,32,100,0.32,59,115,0.513,27,36,0.75,14,102,116,20,20,12,26,68,241,0.0,0.9,0.9,2018
Larry Nance Jr.,C,26,67,1795,249,479,0.52,33,98,0.337,216,381,0.567,96,134,0.716,168,384,552,214,100,40,97,192,627,3.3,1.6,4.9,2018
Shabazz Napier,PG,27,56,983,169,435,0.389,76,228,0.333,93,207,0.449,115,138,0.833,18,82,100,143,41,16,66,67,529,1.0,1.0,2.0,2018
Raul Neto,PG,26,37,474,74,161,0.46,20,60,0.333,54,101,0.535,28,33,0.848,6,56,62,93,14,4,35,49,196,0.5,0.6,1.1,2018
Georges Niang,PF,25,59,516,86,181,0.475,43,105,0.41,43,76,0.566,20,24,0.833,11,76,87,35,10,6,23,57,235,0.7,0.7,1.3,2018
Joakim Noah,C,33,42,693,110,213,0.516,0,1,0.0,110,212,0.519,78,109,0.716,58,180,238,89,20,31,50,96,298,1.0,1.2,2.2,2018
Nerlens Noel,C,24,77,1055,162,276,0.587,0,0,0.0,162,276,0.587,54,79,0.684,127,198,325,45,66,96,48,166,378,1.9,2.5,4.3,2018
Dirk Nowitzki*,PF,40,51,795,135,376,0.359,64,205,0.312,71,171,0.415,39,50,0.78,5,153,158,35,9,18,18,76,373,-0.5,0.8,0.3,2018
Frank Ntilikina,PG,20,43,904,95,282,0.337,33,115,0.287,62,167,0.371,23,30,0.767,12,75,87,121,30,14,56,104,246,-1.3,0.4,-0.8,2018
James Nunnally,SF,28,15,102,12,34,0.353,8,25,0.32,4,9,0.444,4,4,1.0,0,5,5,7,1,0,1,10,36,0.1,0.0,0.1,2018
Jusuf Nurkić,C,24,72,1974,420,826,0.508,3,29,0.103,417,797,0.523,282,365,0.773,243,505,748,233,71,103,168,250,1125,4.4,3.3,7.8,2018
David Nwaba,SF,26,51,984,126,262,0.481,24,75,0.32,102,187,0.545,58,85,0.682,41,122,163,54,36,17,29,106,334,1.1,0.3,1.4,2018
Royce O'Neale,SF,25,82,1671,163,343,0.475,68,176,0.386,95,167,0.569,32,42,0.762,22,263,285,124,54,24,70,172,426,0.7,2.5,3.3,2018
Kyle O'Quinn,C,28,45,371,69,136,0.507,1,12,0.083,68,124,0.548,17,21,0.81,29,90,119,56,9,25,31,68,156,0.2,0.8,1.0,2018
Semi Ojeleye,PF,24,56,594,67,158,0.424,28,89,0.315,39,69,0.565,24,39,0.615,24,62,86,23,10,4,19,43,186,0.2,0.5,0.7,2018
Jahlil Okafor,C,23,59,935,212,362,0.586,1,5,0.2,211,357,0.591,59,89,0.663,82,196,278,40,15,40,52,96,484,1.4,0.8,2.2,2018
Elie Okobo,PG,21,53,958,114,290,0.393,39,132,0.295,75,158,0.475,37,47,0.787,12,86,98,127,32,7,69,109,304,-0.7,0.2,-0.5,2018
Josh Okogie,SG,20,74,1757,196,508,0.386,60,215,0.279,136,293,0.464,118,162,0.728,41,177,218,91,88,33,63,166,570,-0.1,1.4,1.2,2018
Victor Oladipo,SG,26,36,1147,249,588,0.423,74,216,0.343,175,372,0.47,103,141,0.73,21,181,202,186,60,11,82,72,675,0.4,1.9,2.3,2018
Kelly Olynyk,PF,27,79,1812,261,564,0.463,113,319,0.354,148,245,0.604,152,185,0.822,72,303,375,140,53,37,114,183,787,2.3,2.5,4.7,2018
Cedi Osman,SF,23,76,2444,360,844,0.427,130,374,0.348,230,470,0.489,141,181,0.779,45,312,357,195,60,11,114,195,991,1.2,0.2,1.5,2018
Kelly Oubre Jr.,SF,23,69,1935,375,842,0.445,108,338,0.32,267,504,0.53,189,244,0.775,71,254,325,84,84,59,103,181,1047,0.9,1.3,2.2,2018
Zaza Pachulia,C,34,68,878,85,193,0.44,0,4,0.0,85,189,0.45,97,124,0.782,99,166,265,91,31,17,57,151,267,1.1,1.3,2.3,2018
Jabari Parker,PF,23,64,1724,369,749,0.493,61,195,0.313,308,554,0.556,131,184,0.712,79,342,421,152,46,30,151,145,930,0.1,1.3,1.4,2018
Tony Parker*,PG,36,56,1003,213,463,0.46,13,51,0.255,200,412,0.485,91,124,0.734,14,69,83,207,21,7,75,53,530,0.6,0.3,0.9,2018
Chandler Parsons,SF,30,25,496,68,182,0.374,29,94,0.309,39,88,0.443,22,25,0.88,4,66,70,43,19,5,32,45,187,-0.6,0.6,0.0,2018
Patrick Patterson,PF,29,63,861,82,219,0.374,46,137,0.336,36,82,0.439,19,30,0.633,42,105,147,31,16,13,22,46,229,0.2,0.9,1.1,2018
Justin Patton,C,21,3,21,2,7,0.286,0,2,0.0,2,5,0.4,1,2,0.5,2,4,6,3,2,0,0,5,5,0.0,0.0,0.0,2018
Chris Paul,PG,33,58,1857,302,720,0.419,127,355,0.358,175,365,0.479,175,203,0.862,36,229,265,473,114,18,152,146,906,4.4,2.2,6.6,2018
Cameron Payne,PG,24,40,712,96,223,0.43,25,84,0.298,71,139,0.511,33,41,0.805,13,59,72,106,28,9,45,64,250,0.1,0.3,0.5,2018
Elfrid Payton,PG,24,42,1250,179,412,0.434,33,105,0.314,146,307,0.476,55,74,0.743,49,171,220,320,44,17,112,81,446,0.6,0.9,1.5,2018
Gary Payton II,PG,26,3,16,5,8,0.625,1,2,0.5,4,6,0.667,0,0,0.0,1,1,2,4,3,1,1,2,11,0.1,0.0,0.1,2018
Theo Pinson,SG,23,18,211,25,73,0.342,12,46,0.261,13,27,0.481,19,22,0.864,4,32,36,21,6,0,18,15,81,-0.2,0.2,0.0,2018
Mason Plumlee,C,28,82,1731,262,442,0.593,2,10,0.2,260,432,0.602,111,198,0.561,165,359,524,243,66,76,126,252,637,2.9,2.9,5.8,2018
Miles Plumlee,C,30,18,173,32,48,0.667,0,0,0.0,32,48,0.667,16,30,0.533,16,23,39,17,6,4,10,14,80,0.4,0.1,0.5,2018
Jakob Poeltl,C,23,77,1273,187,290,0.645,0,0,0.0,187,290,0.645,49,92,0.533,178,232,410,93,29,68,48,124,423,3.5,1.6,5.1,2018
Quincy Pondexter,SF,30,53,292,29,58,0.5,6,18,0.333,23,40,0.575,34,42,0.81,8,38,46,24,11,1,13,24,98,0.5,0.3,0.8,2018
Otto Porter Jr.,SF,25,56,1683,299,643,0.465,104,256,0.406,195,387,0.504,78,96,0.813,54,260,314,120,82,31,65,108,780,1.8,1.5,3.2,2018
Bobby Portis,PF,23,50,1299,279,628,0.444,75,191,0.393,204,437,0.467,77,97,0.794,109,294,403,72,35,20,74,145,710,0.5,1.1,1.6,2018
Dwight Powell,C,27,77,1662,290,486,0.597,39,127,0.307,251,359,0.699,196,254,0.772,140,271,411,112,44,50,67,201,815,5.6,1.9,7.5,2018
Norman Powell,SG,25,60,1126,193,400,0.483,68,170,0.4,125,230,0.543,62,75,0.827,16,123,139,91,39,13,65,96,516,1.0,1.4,2.4,2018
Alex Poythress,PF,25,21,305,40,81,0.494,9,23,0.391,31,58,0.534,18,29,0.621,29,47,76,17,4,10,13,47,107,0.4,0.2,0.5,2018
Taurean Prince,SF,24,55,1552,262,594,0.441,123,315,0.39,139,279,0.498,95,116,0.819,22,177,199,118,53,19,100,141,742,0.8,0.7,1.5,2018
Zhou Qi,PF,23,1,1,1,1,1.0,0,0,0.0,1,1,1.0,0,0,0.0,0,0,0,0,0,0,0,0,2,0.0,0.0,0.0,2018
Ivan Rabb,PF,21,49,721,116,212,0.547,3,15,0.2,113,197,0.574,49,69,0.71,70,136,206,54,17,14,35,90,284,1.2,0.9,2.1,2018
Chasson Randle,PG,25,49,743,91,217,0.419,46,115,0.4,45,102,0.441,43,62,0.694,10,46,56,97,25,3,43,91,271,0.4,0.2,0.6,2018
Julius Randle,PF,24,73,2232,571,1089,0.524,67,195,0.344,504,894,0.564,356,487,0.731,162,472,634,229,52,45,208,246,1565,4.2,1.9,6.1,2018
JJ Redick,SG,34,76,2379,452,1027,0.44,240,605,0.397,212,422,0.502,228,255,0.894,20,166,186,206,32,17,101,129,1372,4.6,1.2,5.9,2018
Davon Reed,SG,23,10,47,5,12,0.417,2,4,0.5,3,8,0.375,0,0,0.0,2,4,6,3,1,0,1,3,12,0.0,0.0,0.1,2018
Cameron Reynolds,SG,23,19,259,33,78,0.423,21,51,0.412,12,27,0.444,8,9,0.889,4,27,31,13,6,2,5,26,95,0.3,0.1,0.4,2018
Josh Richardson,SG,25,73,2539,423,1026,0.412,164,460,0.357,259,566,0.458,199,231,0.861,54,209,263,298,79,34,113,200,1209,3.0,2.6,5.6,2018
Malachi Richardson,SG,23,22,103,9,29,0.31,8,25,0.32,1,4,0.25,4,5,0.8,2,11,13,0,1,0,8,13,30,-0.2,0.1,-0.1,2018
Austin Rivers,SG,26,76,2028,232,572,0.406,104,327,0.318,128,245,0.522,50,95,0.526,25,137,162,167,47,23,68,207,618,0.4,0.8,1.2,2018
Devin Robinson,SF,23,7,95,19,32,0.594,0,2,0.0,19,30,0.633,9,14,0.643,6,14,20,6,4,6,2,11,47,0.2,0.1,0.3,2018
Duncan Robinson,SF,24,15,161,18,46,0.391,10,35,0.286,8,11,0.727,4,6,0.667,2,17,19,5,5,0,4,11,50,0.0,0.2,0.2,2018
Glenn Robinson III,SF,25,47,610,74,176,0.42,18,62,0.29,56,114,0.491,32,40,0.8,17,54,71,21,14,8,18,45,198,0.1,0.6,0.7,2018
Jerome Robinson,SG,21,33,320,44,110,0.4,18,57,0.316,26,53,0.491,6,9,0.667,3,38,41,19,11,3,13,46,112,-0.2,0.3,0.1,2018
Mitchell Robinson,C,20,66,1360,202,291,0.694,0,0,0.0,202,291,0.694,81,135,0.6,177,246,423,37,52,161,35,217,485,4.0,2.2,6.1,2018
Rajon Rondo,PG,32,46,1369,175,432,0.405,51,142,0.359,124,290,0.428,23,36,0.639,34,209,243,367,57,7,127,100,424,-0.2,1.5,1.3,2018
Derrick Rose,PG,30,51,1392,363,753,0.482,54,146,0.37,309,607,0.509,137,160,0.856,33,107,140,220,31,12,82,57,917,2.6,0.3,3.0,2018
Terrence Ross,SG,27,81,2150,440,1027,0.428,217,566,0.383,223,461,0.484,126,144,0.875,27,253,280,135,72,29,90,119,1223,1.7,2.6,4.3,2018
Terry Rozier,PG,24,79,1791,258,666,0.387,119,337,0.353,139,329,0.422,73,93,0.785,32,275,307,231,68,21,68,101,708,0.9,2.2,3.1,2018
Ricky Rubio,PG,28,68,1899,295,730,0.404,79,254,0.311,216,476,0.454,195,228,0.855,33,210,243,416,91,10,180,180,864,0.9,2.8,3.7,2018
D'Angelo Russell,PG,22,81,2448,659,1517,0.434,234,635,0.369,425,882,0.482,160,205,0.78,53,262,315,563,100,20,253,141,1712,2.4,2.6,5.0,2018
Domantas Sabonis,C,22,74,1838,413,700,0.59,9,17,0.529,404,683,0.592,208,291,0.715,186,504,690,212,48,30,160,239,1043,4.3,3.3,7.6,2018
Brandon Sampson,SG,21,14,214,28,60,0.467,11,29,0.379,17,31,0.548,4,6,0.667,3,13,16,10,8,3,12,19,71,-0.1,0.1,0.0,2018
JaKarr Sampson,SF,25,4,127,29,54,0.537,5,14,0.357,24,40,0.6,17,21,0.81,5,27,32,4,4,3,4,8,80,0.3,0.1,0.5,2018
Dario Šarić,PF,24,81,2023,304,696,0.437,118,323,0.365,186,373,0.499,132,150,0.88,126,331,457,127,45,9,97,182,858,2.3,1.2,3.5,2018
Tomáš Satoranský,PG,27,80,2164,257,530,0.485,64,162,0.395,193,368,0.524,131,160,0.819,82,197,279,399,82,13,120,172,709,3.8,0.9,4.7,2018
Dennis Schröder,PG,25,79,2314,457,1104,0.414,124,364,0.341,333,740,0.45,186,227,0.819,38,246,284,323,65,12,172,189,1224,0.4,2.4,2.9,2018
Mike Scott,PF,30,79,1395,168,420,0.4,101,252,0.401,67,168,0.399,22,33,0.667,43,233,276,66,26,13,44,156,459,0.4,1.2,1.6,2018
Thabo Sefolosha,SF,34,50,609,71,149,0.477,34,78,0.436,37,71,0.521,14,22,0.636,8,115,123,27,43,5,25,41,190,0.2,1.2,1.5,2018
Wayne Selden,SG,24,75,1439,196,483,0.406,55,174,0.316,141,309,0.456,67,92,0.728,37,143,180,109,33,13,79,131,514,-1.0,0.8,-0.3,2018
Collin Sexton,PG,20,82,2605,519,1206,0.43,119,296,0.402,400,910,0.44,214,255,0.839,57,179,236,243,44,6,185,186,1371,-0.1,-0.5,-0.6,2018
Landry Shamet,SG,21,79,1802,240,557,0.431,167,396,0.422,73,161,0.453,75,93,0.806,21,113,134,117,37,10,45,155,722,2.7,0.9,3.6,2018
Iman Shumpert,SG,28,62,1481,167,446,0.374,95,273,0.348,72,173,0.416,36,45,0.8,27,156,183,112,59,24,50,127,465,0.1,1.2,1.4,2018
Pascal Siakam,PF,24,80,2548,519,945,0.549,79,214,0.369,440,731,0.602,237,302,0.785,124,425,549,248,73,52,154,241,1354,5.7,3.6,9.3,2018
Jordan Sibert,SG,26,1,4,1,1,1.0,1,1,1.0,0,0,0.0,0,0,0.0,0,0,0,0,0,0,0,0,3,0.0,0.0,0.0,2018
Ben Simmons,PG,22,79,2700,540,960,0.563,0,6,0.0,540,954,0.566,257,428,0.6,172,525,697,610,112,61,274,209,1337,4.6,3.6,8.2,2018
Jonathon Simmons,SG,29,56,1064,133,350,0.38,28,104,0.269,105,246,0.427,72,97,0.742,27,99,126,128,29,15,68,89,366,-0.8,1.1,0.3,2018
Kobi Simmons,PG,21,1,2,0,0,0.0,0,0,0.0,0,0,0.0,0,0,0.0,0,0,0,0,0,0,0,0,0,0.0,0.0,0.0,2018
Anfernee Simons,SG,19,20,141,28,63,0.444,10,29,0.345,18,34,0.529,9,16,0.563,3,10,13,13,1,0,11,9,75,0.0,0.0,0.1,2018
Marcus Smart,SG,24,80,2200,239,567,0.422,126,346,0.364,113,221,0.511,104,129,0.806,57,177,234,321,143,28,123,201,708,2.2,3.0,5.2,2018
Dennis Smith Jr.,PG,21,53,1508,278,650,0.428,67,208,0.322,211,442,0.477,99,156,0.635,32,123,155,252,67,20,154,129,722,-1.2,1.2,0.0,2018
Ish Smith,PG,30,56,1251,205,489,0.419,44,135,0.326,161,354,0.455,47,62,0.758,23,122,145,203,28,11,61,109,501,0.5,1.1,1.7,2018
J.R. Smith,SG,33,11,222,27,79,0.342,12,39,0.308,15,40,0.375,8,10,0.8,0,18,18,21,11,3,11,19,74,-0.3,0.1,-0.2,2018
Jason Smith,C,32,20,190,21,59,0.356,9,26,0.346,12,33,0.364,14,16,0.875,16,36,52,14,3,7,13,30,65,0.0,0.2,0.2,2018
Zhaire Smith,SG,19,6,111,14,34,0.412,6,16,0.375,8,18,0.444,6,8,0.75,3,10,13,10,2,2,6,8,40,0.0,0.1,0.1,2018
Tony Snell,SF,27,74,1304,163,361,0.452,81,204,0.397,82,157,0.522,37,42,0.881,29,128,157,68,26,18,23,90,444,1.6,1.6,3.2,2018
Ray Spalding,PF,21,14,148,25,47,0.532,0,3,0.0,25,44,0.568,4,12,0.333,15,33,48,5,9,8,9,23,54,0.0,0.2,0.2,2018
Omari Spellman,PF,21,46,805,98,244,0.402,44,128,0.344,54,116,0.466,32,45,0.711,72,122,194,47,26,25,31,67,272,0.6,0.5,1.2,2018
Nik Stauskas,SG,25,68,1015,136,338,0.402,70,188,0.372,66,150,0.44,57,64,0.891,18,109,127,81,21,7,51,50,399,0.6,0.5,1.1,2018
D.J. Stephens,SG,28,1,7,1,2,0.5,0,0,0.0,1,2,0.5,0,0,0.0,0,0,0,0,1,0,1,0,2,0.0,0.0,0.0,2018
Lance Stephenson,SG,28,68,1123,184,432,0.426,73,197,0.371,111,235,0.472,50,73,0.685,32,183,215,140,41,7,86,111,491,-0.1,1.2,1.1,2018
Edmond Sumner,PG,23,23,210,22,64,0.344,7,27,0.259,15,37,0.405,15,24,0.625,9,15,24,10,12,5,10,26,66,-0.2,0.3,0.1,2018
Caleb Swanigan,PF,21,21,178,18,53,0.34,1,7,0.143,17,46,0.37,6,9,0.667,17,47,64,11,6,1,18,28,43,-0.5,0.2,-0.2,2018
Jayson Tatum,SF,20,79,2455,466,1036,0.45,116,311,0.373,350,725,0.483,195,228,0.855,70,407,477,168,84,57,122,168,1243,1.6,3.2,4.8,2018
Jeff Teague,PG,30,42,1264,176,416,0.423,35,105,0.333,141,311,0.453,123,153,0.804,16,90,106,343,43,18,97,90,510,1.7,0.5,2.2,2018
Garrett Temple,SG,32,75,2040,208,493,0.422,90,264,0.341,118,229,0.515,80,107,0.748,28,188,216,106,76,30,70,204,586,0.3,2.0,2.2,2018
Miloš Teodosić,PG,31,15,150,17,40,0.425,10,27,0.37,7,13,0.538,4,7,0.571,3,13,16,32,3,1,21,27,48,-0.1,0.1,-0.1,2018
Jared Terrell,SG,23,14,111,12,39,0.308,4,17,0.235,8,22,0.364,3,6,0.5,1,5,6,12,3,2,10,16,31,-0.4,0.0,-0.3,2018
Emanuel Terry,PF,22,3,23,4,7,0.571,0,0,0.0,4,7,0.571,2,4,0.5,3,4,7,2,3,0,2,4,10,0.0,0.0,0.1,2018
Daniel Theis,C,26,66,908,146,266,0.549,26,67,0.388,120,199,0.603,56,76,0.737,87,138,225,68,21,42,33,161,374,2.3,1.2,3.5,2018
Isaiah Thomas,SG,29,12,181,34,99,0.343,12,43,0.279,22,56,0.393,17,27,0.63,5,8,13,23,5,1,18,17,97,-0.4,0.1,-0.3,2018
Khyri Thomas,SG,22,26,195,22,69,0.319,10,35,0.286,12,34,0.353,7,11,0.636,4,16,20,8,7,5,4,22,61,-0.2,0.2,0.0,2018
Lance Thomas,PF,30,46,783,78,197,0.396,22,79,0.278,56,118,0.475,27,36,0.75,21,96,117,27,17,7,24,83,205,-0.3,0.3,0.1,2018
Klay Thompson,SG,28,78,2652,655,1402,0.467,241,599,0.402,414,803,0.516,129,158,0.816,37,262,299,186,84,47,115,157,1680,2.9,2.3,5.3,2018
Tristan Thompson,C,27,43,1198,201,380,0.529,0,0,0.0,201,380,0.529,68,106,0.642,173,265,438,86,28,16,59,89,470,2.1,0.5,2.6,2018
Sindarius Thornwell,SG,24,64,313,17,49,0.347,3,15,0.2,14,34,0.412,25,34,0.735,5,39,44,18,14,7,20,41,62,-0.3,0.3,0.0,2018
Anthony Tolliver,PF,33,65,1079,99,259,0.382,81,215,0.377,18,44,0.409,47,60,0.783,15,162,177,46,17,21,36,91,326,0.6,0.5,1.2,2018
Karl-Anthony Towns,C,23,77,2545,681,1314,0.518,142,355,0.4,539,959,0.562,376,450,0.836,263,691,954,259,67,125,240,292,1880,7.2,3.2,10.4,2018
Gary Trent Jr.,SG,20,15,111,16,50,0.32,5,21,0.238,11,29,0.379,3,7,0.429,1,10,11,5,1,2,4,4,40,-0.3,0.1,-0.2,2018
Allonzo Trier,SG,23,64,1459,232,518,0.448,52,132,0.394,180,386,0.466,179,223,0.803,31,166,197,119,28,14,116,117,695,0.4,0.5,0.9,2018
P.J. Tucker,PF,33,82,2802,207,523,0.396,146,387,0.377,61,136,0.449,41,59,0.695,121,358,479,96,132,39,63,252,601,2.0,3.0,5.0,2018
Evan Turner,PG,30,73,1605,204,443,0.46,11,52,0.212,193,391,0.494,75,106,0.708,37,291,328,283,33,18,114,110,494,0.5,1.5,2.0,2018
Myles Turner,C,22,74,2119,380,780,0.487,76,196,0.388,304,584,0.521,148,201,0.736,101,430,531,115,60,199,100,195,984,1.9,4.4,6.3,2018
Ekpe Udoh,C,31,51,320,50,72,0.694,0,0,0.0,50,72,0.694,19,30,0.633,27,63,90,28,10,31,13,36,119,0.9,0.7,1.6,2018
Tyler Ulis,PG,23,1,1,0,0,0.0,0,0,0.0,0,0,0.0,0,0,0.0,0,0,0,0,0,0,0,0,0,0.0,0.0,0.0,2018
Jonas Valančiūnas,C,26,49,1091,301,538,0.559,14,48,0.292,287,490,0.586,147,185,0.795,106,313,419,70,19,53,90,146,763,2.2,1.9,4.2,2018
Jarred Vanderbilt,PF,19,17,69,9,19,0.474,0,1,0.0,9,18,0.5,6,10,0.6,7,16,23,3,6,1,8,8,24,-0.1,0.1,0.1,2018
Fred VanVleet,PG,24,64,1760,246,600,0.41,112,296,0.378,134,304,0.441,97,115,0.843,21,146,167,307,57,20,82,110,701,2.4,1.9,4.3,2018
Noah Vonleh,PF,23,68,1722,207,440,0.47,46,137,0.336,161,303,0.531,111,156,0.712,113,415,528,129,46,51,88,174,571,1.5,1.7,3.2,2018
Nikola Vučević,C,28,80,2510,701,1354,0.518,84,231,0.364,617,1123,0.549,179,227,0.789,224,736,960,307,81,89,159,157,1665,5.4,4.7,10.1,2018
Dwyane Wade*,SG,37,72,1885,416,960,0.433,86,261,0.33,330,699,0.472,165,233,0.708,69,216,285,301,59,38,166,118,1083,0.1,2.3,2.4,2018
Moritz Wagner,C,21,43,446,71,171,0.415,22,77,0.286,49,94,0.521,43,53,0.811,17,68,85,24,11,13,39,57,207,-0.3,0.5,0.2,2018
Dion Waiters,SG,27,44,1138,198,478,0.414,109,289,0.377,89,189,0.471,22,44,0.5,7,109,116,121,29,9,64,72,527,0.1,1.1,1.2,2018
Kemba Walker,PG,28,82,2863,731,1684,0.434,260,731,0.356,471,953,0.494,380,450,0.844,52,309,361,484,102,34,211,131,2102,5.5,1.9,7.4,2018
Lonnie Walker IV,SG,20,17,118,16,46,0.348,5,13,0.385,11,33,0.333,8,10,0.8,0,17,17,9,7,3,4,7,45,-0.1,0.2,0.0,2018
John Wall,PG,28,32,1104,245,552,0.444,51,169,0.302,194,383,0.507,122,175,0.697,15,101,116,279,49,29,121,71,663,0.5,0.7,1.2,2018
Tyrone Wallace,PG,24,62,628,92,217,0.424,4,19,0.211,88,198,0.444,30,57,0.526,20,81,101,42,21,7,36,83,218,-0.8,0.5,-0.3,2018
Brad Wanamaker,PG,29,36,343,50,105,0.476,16,39,0.41,34,66,0.515,24,28,0.857,3,38,41,56,12,2,19,34,140,0.6,0.4,0.9,2018
T.J. Warren,SF,25,43,1360,297,611,0.486,77,180,0.428,220,431,0.51,101,124,0.815,31,143,174,64,51,29,52,119,772,1.6,0.5,2.1,2018
Julian Washburn,SF,27,18,254,16,48,0.333,5,24,0.208,11,24,0.458,3,4,0.75,8,33,41,14,13,2,7,16,40,-0.2,0.3,0.1,2018
Yuta Watanabe,SF,24,15,174,15,51,0.294,2,16,0.125,13,35,0.371,7,10,0.7,4,27,31,8,4,1,6,11,39,-0.4,0.2,-0.2,2018
Thomas Welsh,C,22,11,36,7,13,0.538,3,7,0.429,4,6,0.667,1,2,0.5,0,4,4,5,0,0,1,3,18,0.1,0.0,0.1,2018
Russell Westbrook,PG,30,73,2630,630,1473,0.428,119,411,0.29,511,1062,0.481,296,451,0.656,109,698,807,784,142,33,325,245,1675,1.8,5.0,6.8,2018
Derrick White,PG,24,67,1728,260,543,0.479,48,142,0.338,212,401,0.529,95,123,0.772,35,212,247,263,67,47,97,145,663,1.7,1.9,3.6,2018
Okaro White,PF,26,3,6,0,2,0.0,0,2,0.0,0,0,0.0,0,0,0.0,1,1,2,0,0,0,0,0,0,0.0,0.0,0.0,2018
Hassan Whiteside,C,29,72,1674,388,680,0.571,2,16,0.125,386,664,0.581,109,243,0.449,257,560,817,56,46,136,97,192,887,2.3,4.0,6.3,2018
Andrew Wiggins,SF,23,73,2543,498,1209,0.412,118,348,0.339,380,861,0.441,207,296,0.699,83,269,352,184,70,48,138,153,1321,-0.6,1.3,0.6,2018
Alan Williams,PF,26,5,26,8,13,0.615,0,1,0.0,8,12,0.667,2,4,0.5,4,15,19,3,1,0,1,2,18,0.1,0.1,0.2,2018
C.J. Williams,SG,28,15,128,17,35,0.486,5,16,0.313,12,19,0.632,0,1,0.0,1,7,8,12,6,0,5,16,39,0.1,0.1,0.1,2018
Johnathan Williams,C,23,24,372,65,110,0.591,0,2,0.0,65,108,0.602,27,48,0.563,48,51,99,13,8,7,16,62,157,0.7,0.3,1.0,2018
Kenrich Williams,SF,24,46,1079,107,279,0.384,52,156,0.333,55,123,0.447,13,19,0.684,55,164,219,83,45,19,36,95,279,0.3,0.9,1.2,2018
Lou Williams,SG,32,75,1993,484,1138,0.425,105,291,0.361,379,847,0.447,425,485,0.876,40,182,222,402,57,11,181,80,1498,3.9,1.2,5.1,2018
Marvin Williams,PF,32,75,2133,275,652,0.422,140,382,0.366,135,270,0.5,66,86,0.767,76,331,407,92,71,61,47,156,756,1.9,1.9,3.8,2018
Robert Williams,C,21,32,283,36,51,0.706,0,0,0.0,36,51,0.706,9,15,0.6,27,54,81,7,9,40,10,36,81,0.5,0.6,1.2,2018
Troy Williams,SF,24,21,312,44,98,0.449,14,44,0.318,30,54,0.556,9,15,0.6,12,47,59,11,10,8,9,37,111,0.1,0.3,0.4,2018
D.J. Wilson,PF,22,48,882,104,251,0.414,46,127,0.362,58,124,0.468,26,47,0.553,45,177,222,52,18,20,32,85,280,0.3,1.4,1.7,2018
Justise Winslow,SF,22,66,1959,324,749,0.433,96,256,0.375,228,493,0.462,86,137,0.628,63,292,355,282,72,19,142,177,830,0.2,2.6,2.8,2018
Christian Wood,PF,23,21,251,61,117,0.521,9,26,0.346,52,91,0.571,41,56,0.732,17,66,83,8,7,10,17,17,172,0.4,0.3,0.8,2018
Delon Wright,PG,26,75,1699,242,558,0.434,50,168,0.298,192,390,0.492,119,150,0.793,68,198,266,248,88,30,77,103,653,1.9,2.4,4.3,2018
Guerschon Yabusele,PF,23,41,251,35,77,0.455,9,28,0.321,26,49,0.531,15,22,0.682,23,30,53,15,8,7,15,32,94,0.2,0.3,0.5,2018
Nick Young,SG,33,4,37,3,9,0.333,3,8,0.375,0,1,0.0,0,0,0.0,0,1,1,2,0,1,2,4,9,0.0,0.0,0.0,2018
Thaddeus Young,PF,30,81,2489,443,841,0.527,51,146,0.349,392,695,0.564,87,135,0.644,192,331,523,204,123,36,123,194,1024,3.0,3.9,6.9,2018
Trae Young,PG,20,81,2503,525,1256,0.418,156,482,0.324,369,774,0.477,343,414,0.829,64,237,301,653,72,15,308,140,1549,2.5,0.7,3.3,2018
Cody Zeller,C,26,49,1243,190,345,0.551,6,22,0.273,184,323,0.57,111,141,0.787,110,223,333,102,38,41,62,164,497,2.6,1.2,3.9,2018
Tyler Zeller,C,29,6,93,16,30,0.533,0,1,0.0,16,29,0.552,14,18,0.778,11,13,24,4,1,3,4,20,46,0.2,0.1,0.3,2018
Ante Žižić,C,22,59,1082,183,331,0.553,0,0,0.0,183,331,0.553,93,132,0.705,108,212,320,53,13,22,61,113,459,1.7,0.3,2.0,2018
Ivica Zubac,C,21,59,1040,212,379,0.559,0,0,0.0,212,379,0.559,101,126,0.802,115,247,362,63,14,51,70,137,525,1.9,1.3,3.2,2018
Steven Adams,C,26,63,1680,283,478,0.592,1,3,0.333,282,475,0.594,117,201,0.582,207,376,583,146,51,67,94,122,684,3.8,2.7,6.5,2019
Bam Adebayo,PF,22,72,2417,440,790,0.557,2,14,0.143,438,776,0.564,264,382,0.691,176,559,735,368,82,93,204,182,1146,4.6,3.9,8.5,2019
LaMarcus Aldridge,C,34,53,1754,391,793,0.493,61,157,0.389,330,636,0.519,158,191,0.827,103,289,392,129,36,87,74,128,1001,3.0,1.4,4.5,2019
Kyle Alexander,C,23,2,13,1,2,0.5,0,0,0.0,1,2,0.5,0,0,0.0,2,1,3,0,0,0,1,1,2,0.0,0.0,0.0,2019
Nickeil Alexander-Walker,SG,21,47,591,98,266,0.368,46,133,0.346,52,133,0.391,25,37,0.676,9,75,84,89,17,8,54,57,267,-0.7,0.4,-0.2,2019
Grayson Allen,SG,24,38,718,117,251,0.466,57,141,0.404,60,110,0.545,39,45,0.867,8,77,85,52,10,2,33,53,330,0.8,0.4,1.2,2019
Jarrett Allen,C,21,70,1852,302,465,0.649,0,6,0.0,302,459,0.658,171,270,0.633,216,455,671,110,40,92,77,162,775,5.2,2.9,8.2,2019
Kadeem Allen,PG,27,10,117,19,44,0.432,5,16,0.313,14,28,0.5,7,11,0.636,2,7,9,21,5,2,8,7,50,0.1,0.1,0.1,2019
Al-Farouq Aminu,PF,29,18,380,25,86,0.291,9,36,0.25,16,50,0.32,19,29,0.655,24,63,87,21,18,8,17,27,78,-0.4,0.5,0.1,2019
Justin Anderson,SG,26,10,107,10,38,0.263,6,29,0.207,4,9,0.444,2,4,0.5,1,20,21,8,0,6,4,13,28,-0.2,0.1,-0.1,2019
Kyle Anderson,SF,26,67,1330,157,331,0.474,24,85,0.282,133,246,0.541,52,78,0.667,58,227,285,162,54,37,66,111,390,0.9,1.7,2.5,2019
Ryan Anderson,C,31,2,14,2,7,0.286,1,5,0.2,1,2,0.5,0,0,0.0,0,7,7,2,1,0,1,1,5,0.0,0.0,0.0,2019
Giannis Antetokounmpo,PF,25,63,1917,685,1238,0.553,89,293,0.304,596,945,0.631,398,629,0.633,140,716,856,354,61,66,230,195,1857,6.1,5.0,11.1,2019
Kostas Antetokounmpo,PF,22,5,20,3,3,1.0,0,0,0.0,3,3,1.0,1,2,0.5,2,1,3,2,0,0,1,2,7,0.1,0.0,0.1,2019
Thanasis Antetokounmpo,SF,27,20,129,24,48,0.5,0,10,0.0,24,38,0.632,7,17,0.412,12,12,24,15,7,2,12,18,55,-0.1,0.2,0.2,2019
Carmelo Anthony,PF,35,58,1902,336,782,0.43,87,226,0.385,249,556,0.448,136,161,0.845,71,297,368,85,49,27,100,171,895,0.4,0.9,1.3,2019
OG Anunoby,SF,22,69,2066,286,566,0.505,89,228,0.39,197,338,0.583,72,102,0.706,80,284,364,108,96,45,79,167,733,2.1,3.7,5.7,2019
Ryan Arcidiacono,PG,25,58,930,90,220,0.409,54,138,0.391,36,82,0.439,27,38,0.711,20,90,110,96,27,3,37,96,261,0.7,0.7,1.4,2019
Trevor Ariza,SF,34,53,1493,142,324,0.438,77,207,0.372,65,117,0.556,62,74,0.838,34,212,246,91,69,15,56,111,423,1.3,1.2,2.5,2019
D.J. Augustin,PG,32,57,1420,184,461,0.399,70,201,0.348,114,260,0.438,161,181,0.89,22,100,122,262,34,1,86,72,599,2.0,0.9,2.9,2019
Deandre Ayton,C,21,38,1236,310,568,0.546,3,13,0.231,307,555,0.553,67,89,0.753,147,289,436,72,26,58,80,117,690,1.5,1.6,3.1,2019
Dwayne Bacon,SG,24,39,687,85,244,0.348,19,67,0.284,66,177,0.373,35,53,0.66,15,85,100,52,23,2,37,52,224,-1.2,0.4,-0.8,2019
Marvin Bagley III,C,20,13,334,78,167,0.467,4,22,0.182,74,145,0.51,25,31,0.806,29,68,97,10,6,12,18,43,185,0.0,0.3,0.4,2019
Lonzo Ball,PG,22,63,2025,277,687,0.403,148,395,0.375,129,292,0.442,43,76,0.566,71,312,383,438,88,38,193,128,745,0.4,2.0,2.4,2019
Mo Bamba,C,21,62,878,132,286,0.462,37,107,0.346,95,179,0.531,31,46,0.674,100,202,302,42,23,86,42,116,332,0.8,1.7,2.5,2019
J.J. Barea,PG,35,29,450,85,207,0.411,32,85,0.376,53,122,0.434,20,22,0.909,10,43,53,112,5,2,38,27,222,0.5,0.2,0.7,2019
Harrison Barnes,PF,27,72,2482,365,793,0.46,102,268,0.381,263,525,0.501,214,267,0.801,77,278,355,159,43,12,88,93,1046,3.4,1.1,4.6,2019
RJ Barrett,SG,19,56,1704,292,727,0.402,63,197,0.32,229,530,0.432,156,254,0.614,50,229,279,143,55,17,124,122,803,-1.6,1.1,-0.5,2019
Will Barton,SF,29,58,1916,332,738,0.45,108,288,0.375,224,450,0.498,102,133,0.767,76,289,365,212,61,29,88,121,874,2.4,1.8,4.2,2019
Keita Bates-Diop,PF,24,44,744,100,234,0.427,34,103,0.33,66,131,0.504,54,75,0.72,25,102,127,30,19,24,17,43,288,0.6,0.6,1.2,2019
Nicolas Batum,SF,31,22,505,28,81,0.346,14,49,0.286,14,32,0.438,9,10,0.9,25,75,100,66,17,8,22,41,79,0.2,0.4,0.6,2019
Aron Baynes,C,33,42,934,183,381,0.48,59,168,0.351,124,213,0.582,56,75,0.747,71,166,237,67,10,23,50,141,481,1.3,0.8,2.1,2019
Kent Bazemore,SF,30,68,1688,200,534,0.375,84,244,0.344,116,290,0.4,113,147,0.769,27,267,294,93,74,40,91,196,597,-0.9,1.5,0.6,2019
Darius Bazley,PF,19,61,1130,125,317,0.394,49,141,0.348,76,176,0.432,43,62,0.694,30,216,246,41,23,41,45,55,342,-0.5,1.5,1.0,2019
Bradley Beal,SG,26,57,2053,593,1303,0.455,170,481,0.353,423,822,0.515,385,457,0.842,52,190,242,347,71,23,194,126,1741,4.5,0.6,5.1,2019
Malik Beasley,SG,23,55,1209,227,534,0.425,107,276,0.388,120,258,0.465,54,66,0.818,18,130,148,75,40,8,57,77,615,0.4,0.8,1.2,2019
Marco Belinelli,SG,33,57,883,123,314,0.392,67,178,0.376,56,136,0.412,48,58,0.828,7,92,99,69,12,1,19,45,361,0.7,0.2,0.8,2019
Jordan Bell,C,25,29,256,35,67,0.522,4,12,0.333,31,55,0.564,19,31,0.613,30,51,81,16,3,10,21,19,93,0.2,0.2,0.4,2019
DeAndre' Bembry,SG,25,43,915,104,228,0.456,15,65,0.231,89,163,0.546,26,48,0.542,34,118,152,81,55,19,60,84,249,-0.5,0.8,0.2,2019
Dragan Bender,PF,22,16,286,41,92,0.446,15,43,0.349,26,49,0.531,10,14,0.714,16,57,73,28,4,9,21,42,107,0.0,0.3,0.3,2019
Dāvis Bertāns,PF,27,54,1583,265,610,0.434,200,472,0.424,65,138,0.471,104,122,0.852,35,210,245,92,37,33,59,139,834,3.0,0.5,3.5,2019
Patrick Beverley,PG,31,51,1342,147,341,0.431,80,206,0.388,67,135,0.496,31,47,0.66,57,209,266,183,54,25,66,156,405,1.6,2.0,3.6,2019
Khem Birch,C,27,48,922,73,143,0.51,0,1,0.0,73,142,0.514,66,101,0.653,91,129,220,50,20,23,31,91,212,1.2,0.9,2.2,2019
Goga Bitadze,C,20,54,471,70,150,0.467,8,42,0.19,62,108,0.574,24,33,0.727,25,81,106,23,10,37,28,65,172,-0.1,0.8,0.7,2019
Bismack Biyombo,C,27,53,1029,151,278,0.543,0,0,0.0,151,278,0.543,91,151,0.603,120,188,308,50,10,49,48,116,393,1.5,0.9,2.4,2019
Nemanja Bjelica,PF,31,72,2011,314,653,0.481,134,320,0.419,180,333,0.541,69,84,0.821,111,347,458,203,62,40,99,216,831,3.4,1.9,5.3,2019
Eric Bledsoe,PG,30,61,1646,334,703,0.475,74,215,0.344,260,488,0.533,169,214,0.79,43,239,282,328,57,26,148,128,911,2.4,3.0,5.4,2019
Bogdan Bogdanović,SG,27,61,1766,337,766,0.44,164,441,0.372,173,325,0.532,86,116,0.741,26,181,207,207,64,15,102,133,924,1.8,1.3,3.1,2019
Bojan Bogdanović,SF,30,63,2083,418,935,0.447,189,457,0.414,229,478,0.479,250,277,0.903,39,220,259,131,34,7,159,110,1275,2.6,1.6,4.2,2019
Bol Bol,PF,20,7,87,14,28,0.5,4,9,0.444,10,19,0.526,8,10,0.8,5,14,19,6,2,6,10,11,40,0.0,0.1,0.1,2019
Jonah Bolden,C,24,7,47,4,11,0.364,0,4,0.0,4,7,0.571,2,4,0.5,3,6,9,0,3,2,2,10,10,-0.1,0.1,0.0,2019
Marques Bolden,C,21,1,3,0,0,0.0,0,0,0.0,0,0,0.0,0,0,0.0,0,2,2,0,1,0,0,1,0,0.0,0.0,0.0,2019
Jordan Bone,PG,22,10,53,5,20,0.25,2,10,0.2,3,10,0.3,0,0,0.0,0,4,4,8,1,0,2,6,12,-0.1,0.0,-0.1,2019
Isaac Bonga,SF,20,66,1250,118,234,0.504,25,71,0.352,93,163,0.571,69,85,0.812,71,151,222,76,45,22,58,156,330,1.2,0.6,1.8,2019
Devin Booker,SG,23,70,2512,627,1283,0.489,141,398,0.354,486,885,0.549,468,509,0.919,29,268,297,456,49,18,264,213,1863,6.0,1.5,7.5,2019
Chris Boucher,C,27,62,819,141,299,0.472,38,118,0.322,103,181,0.569,91,116,0.784,107,170,277,26,22,61,28,114,411,2.1,1.8,3.8,2019
Brian Bowen,SF,21,6,31,3,10,0.3,0,2,0.0,3,8,0.375,0,0,0.0,1,6,7,0,0,1,1,3,6,-0.1,0.0,-0.1,2019
Ky Bowman,PG,22,45,1015,134,321,0.417,33,107,0.308,101,214,0.472,34,41,0.829,24,97,121,131,44,10,70,102,335,-0.6,0.6,-0.1,2019
Avery Bradley,SG,29,49,1186,170,383,0.444,63,173,0.364,107,210,0.51,20,24,0.833,18,97,115,63,43,5,47,110,423,0.2,1.4,1.5,2019
Tony Bradley,C,22,58,663,126,189,0.667,3,3,1.0,123,186,0.661,30,46,0.652,111,156,267,23,14,33,30,115,285,2.2,1.1,3.3,2019
Jarrell Brantley,PF,23,9,96,10,28,0.357,3,13,0.231,7,15,0.467,1,2,0.5,2,18,20,11,3,5,7,7,24,-0.2,0.1,0.0,2019
Ignas Brazdeikis,SF,21,9,53,6,22,0.273,1,9,0.111,5,13,0.385,4,5,0.8,2,3,5,4,0,1,2,3,17,-0.1,0.0,-0.1,2019
Corey Brewer,PF,33,5,33,2,4,0.5,0,1,0.0,2,3,0.667,1,3,0.333,2,6,8,2,4,0,2,7,5,0.0,0.1,0.0,2019
Mikal Bridges,SF,23,73,2042,247,484,0.51,70,194,0.361,177,290,0.61,103,122,0.844,66,226,292,129,102,46,73,163,667,2.5,2.3,4.8,2019
Miles Bridges,SF,21,65,1995,319,753,0.424,99,300,0.33,220,453,0.486,106,131,0.809,88,274,362,114,40,48,95,132,843,0.3,1.3,1.6,2019
Oshae Brissett,SF,21,19,135,13,36,0.361,3,15,0.2,10,21,0.476,8,10,0.8,9,17,26,7,4,1,7,18,37,-0.1,0.2,0.1,2019
Ryan Broekhoff,SF,29,17,180,22,59,0.373,20,51,0.392,2,8,0.25,7,8,0.875,5,38,43,11,5,4,6,15,71,0.2,0.2,0.4,2019
Malcolm Brogdon,PG,27,54,1666,326,744,0.438,75,230,0.326,251,514,0.488,166,186,0.892,46,216,262,381,35,10,131,98,893,2.3,1.7,4.0,2019
Dillon Brooks,SG,24,73,2112,435,1068,0.407,147,411,0.358,288,657,0.438,164,203,0.808,68,175,243,150,63,27,124,278,1181,-0.4,1.6,1.2,2019
Bruce Brown,PG,23,58,1634,198,447,0.443,33,96,0.344,165,351,0.47,88,119,0.739,61,213,274,230,63,29,100,162,517,0.7,1.4,2.1,2019
Charlie Brown Jr.,SG,22,10,40,6,19,0.316,3,9,0.333,3,10,0.3,5,5,1.0,2,2,4,2,2,2,3,3,20,0.0,0.0,0.0,2019
Jaylen Brown,SG,23,57,1934,427,887,0.481,129,338,0.382,298,549,0.543,176,243,0.724,62,302,364,118,65,20,125,167,1159,2.3,2.6,4.9,2019
Moses Brown,C,20,9,33,4,10,0.4,0,0,0.0,4,10,0.4,3,8,0.375,3,11,14,1,1,1,3,7,11,-0.1,0.0,0.0,2019
Sterling Brown,SF,24,52,767,95,256,0.371,44,136,0.324,51,120,0.425,32,40,0.8,31,152,183,51,29,7,42,54,266,-0.4,1.5,1.1,2019
Troy Brown Jr.,SF,20,69,1782,273,622,0.439,61,179,0.341,212,443,0.479,109,139,0.784,76,307,383,178,85,7,79,132,716,1.3,1.2,2.4,2019
Jalen Brunson,PG,23,57,1022,181,388,0.466,43,120,0.358,138,268,0.515,61,75,0.813,22,112,134,188,22,4,66,74,466,1.6,0.6,2.1,2019
Thomas Bryant,C,22,46,1147,243,418,0.581,37,91,0.407,206,327,0.63,86,116,0.741,98,233,331,83,25,49,53,103,609,3.1,0.8,3.9,2019
Reggie Bullock,SG,28,29,684,90,224,0.402,37,111,0.333,53,113,0.469,17,21,0.81,13,55,68,42,25,3,19,56,234,0.2,0.3,0.5,2019
Trey Burke,PG,27,33,520,94,209,0.45,32,75,0.427,62,134,0.463,23,29,0.793,16,34,50,83,16,2,21,33,243,1.0,0.4,1.3,2019
Alec Burks,SF,28,66,1754,321,768,0.418,116,301,0.385,205,467,0.439,235,265,0.887,48,234,282,189,62,17,91,128,993,2.5,1.2,3.7,2019
Deonte Burton,SF,26,39,356,43,125,0.344,10,53,0.189,33,72,0.458,8,14,0.571,7,50,57,17,7,10,19,34,104,-0.9,0.4,-0.5,2019
Jimmy Butler,SF,30,58,1959,345,758,0.455,29,119,0.244,316,639,0.495,438,525,0.834,106,280,386,350,103,32,127,81,1157,6.3,2.7,9.0,2019
Bruno Caboclo,C,24,30,244,38,89,0.427,6,33,0.182,32,56,0.571,8,9,0.889,23,37,60,12,15,17,13,31,90,0.0,0.4,0.4,2019
Devontae Cacok,C,23,1,9,3,6,0.5,0,0,0.0,3,6,0.5,0,0,0.0,2,3,5,1,0,0,0,0,6,0.0,0.0,0.0,2019
Kentavious Caldwell-Pope,SG,26,69,1762,237,507,0.467,92,239,0.385,145,268,0.541,79,102,0.775,38,104,142,111,57,14,62,128,645,1.9,1.9,3.7,2019
Vlatko Čančar,PF,22,14,45,6,15,0.4,1,6,0.167,5,9,0.556,4,4,1.0,5,5,10,3,1,1,3,7,17,0.0,0.0,0.1,2019
Clint Capela,C,25,39,1279,244,388,0.629,0,0,0.0,244,388,0.629,55,104,0.529,168,369,537,48,33,72,63,102,543,2.8,2.1,4.9,2019
DeMarre Carroll,SF,33,24,290,25,66,0.379,8,33,0.242,17,33,0.515,29,42,0.69,12,43,55,25,8,5,17,32,87,0.0,0.2,0.3,2019
Jevon Carter,PG,24,58,945,101,243,0.416,62,146,0.425,39,97,0.402,23,27,0.852,30,88,118,84,47,17,32,86,287,0.8,1.0,1.8,2019
Vince Carter*,PF,43,60,876,107,304,0.352,61,202,0.302,46,102,0.451,23,29,0.793,18,106,124,48,23,25,33,90,298,-0.6,0.4,-0.2,2019
Wendell Carter Jr.,C,20,43,1256,183,343,0.534,6,29,0.207,177,314,0.564,112,152,0.737,139,266,405,51,33,36,72,162,484,1.7,1.6,3.3,2019
Michael Carter-Williams,SG,28,45,833,111,260,0.427,22,75,0.293,89,185,0.481,79,95,0.832,46,101,147,109,49,22,52,87,323,0.7,1.2,1.9,2019
Alex Caruso,PG,25,64,1175,120,291,0.412,40,120,0.333,80,171,0.468,69,94,0.734,17,106,123,124,70,18,53,98,349,0.5,1.8,2.3,2019
Willie Cauley-Stein,C,26,54,1097,175,302,0.579,0,1,0.0,175,301,0.581,40,66,0.606,84,231,315,70,49,61,40,121,390,1.5,1.5,2.9,2019
Tyson Chandler,C,37,26,219,14,18,0.778,0,0,0.0,14,18,0.778,6,13,0.462,25,41,66,6,6,8,8,32,34,0.3,0.3,0.6,2019
Wilson Chandler,PF,32,35,734,74,183,0.404,37,121,0.306,37,62,0.597,20,23,0.87,11,134,145,39,16,12,34,79,205,-0.1,0.9,0.7,2019
Joe Chealey,PG,24,4,33,0,7,0.0,0,4,0.0,0,3,0.0,2,2,1.0,0,0,0,1,4,0,2,2,2,-0.2,0.0,-0.1,2019
Zylan Cheatham,PF,24,4,51,6,9,0.667,0,1,0.0,6,8,0.75,0,0,0.0,3,6,9,3,1,1,4,10,12,0.0,0.0,0.0,2019
Chris Chiozza,PG,24,28,401,55,140,0.393,27,72,0.375,28,68,0.412,5,5,1.0,9,44,53,83,21,4,32,37,142,0.0,0.4,0.5,2019
Marquese Chriss,PF,22,59,1196,210,385,0.545,8,39,0.205,202,346,0.584,120,156,0.769,114,251,365,114,39,62,78,122,548,2.1,1.3,3.4,2019
Gary Clark,SF,25,42,567,54,133,0.406,39,111,0.351,15,22,0.682,9,10,0.9,37,73,110,17,6,22,10,46,156,0.7,0.5,1.2,2019
Brandon Clarke,PF,23,58,1300,296,479,0.618,23,64,0.359,273,415,0.658,85,112,0.759,92,253,345,81,32,48,55,100,700,3.4,1.6,5.0,2019
Jordan Clarkson,SG,27,71,1705,394,867,0.454,152,413,0.368,242,454,0.533,138,165,0.836,50,137,187,136,46,16,97,108,1078,2.4,1.0,3.4,2019
Nic Claxton,C,20,15,187,27,48,0.563,1,7,0.143,26,41,0.634,11,21,0.524,19,25,44,16,1,8,9,14,66,0.3,0.2,0.5,2019
Chris Clemons,SG,22,33,291,57,142,0.401,37,107,0.346,20,35,0.571,10,11,0.909,4,26,30,27,9,6,19,26,161,0.1,0.2,0.4,2019
Antonius Cleveland,SG,25,11,46,4,14,0.286,0,3,0.0,4,11,0.364,3,5,0.6,2,5,7,1,1,3,2,8,11,-0.1,0.0,-0.1,2019
Amir Coffey,SG,22,18,159,23,54,0.426,6,19,0.316,17,35,0.486,6,11,0.545,4,12,16,14,5,2,8,20,58,0.0,0.2,0.1,2019
John Collins,PF,22,41,1363,353,605,0.583,59,147,0.401,294,458,0.642,120,150,0.8,116,300,416,60,31,66,75,138,885,3.8,1.2,4.9,2019
Zach Collins,PF,22,11,290,32,68,0.471,7,19,0.368,25,49,0.51,6,8,0.75,25,44,69,16,5,5,14,36,77,0.2,0.1,0.3,2019
Mike Conley,PG,32,47,1363,232,567,0.409,96,256,0.375,136,311,0.437,115,139,0.827,33,118,151,208,36,5,92,104,675,1.4,1.1,2.5,2019
Pat Connaughton,SG,27,67,1243,137,301,0.455,55,166,0.331,82,135,0.607,31,40,0.775,60,224,284,107,25,31,52,70,360,1.1,2.3,3.4,2019
Quinn Cook,PG,26,44,508,91,214,0.425,31,85,0.365,60,129,0.465,11,14,0.786,11,40,51,49,12,2,33,27,224,-0.2,0.5,0.3,2019
Tyler Cook,PF,22,13,54,8,12,0.667,0,0,0.0,8,12,0.667,7,8,0.875,6,8,14,1,3,0,3,5,23,0.2,0.0,0.2,2019
Robert Covington,PF,29,70,2137,305,723,0.422,161,480,0.335,144,243,0.593,99,124,0.798,63,400,463,88,115,93,103,220,870,0.7,3.0,3.7,2019
Allen Crabbe,SG,27,37,653,63,177,0.356,36,119,0.303,27,58,0.466,10,14,0.714,11,66,77,33,15,4,17,47,172,-0.2,0.2,-0.1,2019
Torrey Craig,SF,29,58,1072,124,269,0.461,45,138,0.326,79,131,0.603,22,36,0.611,63,126,189,47,23,36,25,135,315,1.1,0.9,2.0,2019
Jamal Crawford,SG,39,1,6,2,4,0.5,1,2,0.5,1,2,0.5,0,0,0.0,0,0,0,3,0,0,0,1,5,0.1,0.0,0.1,2019
Jae Crowder,SF,29,65,1875,226,563,0.401,135,394,0.343,91,169,0.538,97,125,0.776,52,332,384,161,72,24,69,143,684,1.6,2.2,3.8,2019
Jarrett Culver,SG,20,63,1506,230,569,0.404,66,221,0.299,164,348,0.471,54,117,0.462,70,142,212,110,57,38,81,125,580,-1.2,1.1,-0.1,2019
Seth Curry,SG,29,64,1576,284,574,0.495,145,321,0.452,139,253,0.549,80,97,0.825,27,118,145,124,38,9,62,113,793,3.5,0.8,4.3,2019
Stephen Curry,PG,31,5,139,33,82,0.402,12,49,0.245,21,33,0.636,26,26,1.0,4,22,26,33,5,2,16,11,104,0.2,0.1,0.3,2019
Troy Daniels,SG,28,47,532,72,186,0.387,46,132,0.348,26,54,0.481,10,16,0.625,12,40,52,17,11,3,12,37,200,0.1,0.5,0.6,2019
Anthony Davis,PF,26,62,2131,551,1096,0.503,72,218,0.33,479,878,0.546,444,525,0.846,142,435,577,200,91,143,154,156,1618,6.7,4.4,11.1,2019
Ed Davis,C,30,28,303,22,46,0.478,0,0,0.0,22,46,0.478,7,14,0.5,35,70,105,12,11,9,13,61,51,0.2,0.5,0.6,2019
Terence Davis,SG,22,72,1209,199,436,0.456,94,242,0.388,105,194,0.541,51,59,0.864,50,187,237,115,39,14,76,124,543,1.2,1.9,3.1,2019
Dewayne Dedmon,C,30,44,774,102,255,0.4,22,107,0.206,80,148,0.541,30,36,0.833,60,189,249,22,25,41,57,133,256,-1.0,1.0,0.1,2019
Matthew Dellavedova,PG,29,57,821,62,175,0.354,21,91,0.231,41,84,0.488,32,37,0.865,18,57,75,180,20,2,59,78,177,0.1,0.1,0.2,2019
DeMar DeRozan,SF,30,68,2316,557,1049,0.531,9,35,0.257,548,1014,0.54,381,451,0.845,44,331,375,380,70,20,164,180,1504,5.9,1.3,7.3,2019
Cheick Diallo,C,23,47,479,92,142,0.648,1,3,0.333,91,139,0.655,34,39,0.872,30,101,131,22,11,12,32,55,219,0.8,0.5,1.3,2019
Hamidou Diallo,SF,21,46,896,132,296,0.446,16,57,0.281,116,239,0.485,38,63,0.603,44,123,167,36,37,9,51,101,318,-0.7,1.1,0.4,2019
Gorgui Dieng,C,30,63,1096,166,364,0.456,54,152,0.355,112,212,0.528,78,101,0.772,91,263,354,73,51,59,60,124,464,1.3,1.7,2.9,2019
Spencer Dinwiddie,PG,26,64,1994,424,1021,0.415,123,400,0.308,301,621,0.485,347,446,0.778,32,189,221,432,40,21,174,180,1318,3.2,1.6,4.8,2019
Donte DiVincenzo,SG,23,66,1520,232,510,0.455,83,247,0.336,149,263,0.567,63,86,0.733,66,252,318,154,85,20,90,113,610,1.0,3.2,4.3,2019
Luka Dončić,PG,20,61,2047,581,1255,0.463,171,541,0.316,410,714,0.574,426,562,0.758,78,495,573,538,62,14,260,153,1759,6.5,2.3,8.8,2019
Luguentz Dort,SF,20,36,820,86,218,0.394,30,101,0.297,56,117,0.479,42,53,0.792,24,57,81,27,31,4,22,97,244,0.1,0.8,0.8,2019
Damyean Dotson,SG,25,48,836,120,290,0.414,59,163,0.362,61,127,0.48,22,33,0.667,10,81,91,57,23,4,21,44,321,0.6,0.4,0.9,2019
Sekou Doumbouya,PF,19,38,754,92,236,0.39,28,98,0.286,64,138,0.464,31,46,0.674,20,98,118,19,20,8,35,80,243,-0.8,0.5,-0.3,2019
PJ Dozier,SG,23,29,412,65,157,0.414,17,49,0.347,48,108,0.444,21,29,0.724,10,45,55,63,14,6,27,45,168,0.0,0.4,0.4,2019
Goran Dragić,PG,33,59,1663,319,724,0.441,124,338,0.367,195,386,0.505,191,246,0.776,29,158,187,301,40,10,144,124,953,2.2,1.3,3.5,2019
Andre Drummond,C,26,57,1879,418,784,0.533,5,35,0.143,413,749,0.551,169,294,0.575,250,614,864,152,109,93,203,201,1010,0.6,3.6,4.2,2019
Jared Dudley,PF,34,45,364,24,60,0.4,18,42,0.429,6,18,0.333,2,2,1.0,6,46,52,28,15,3,8,41,68,0.3,0.5,0.8,2019
Kris Dunn,PG,25,51,1269,152,342,0.444,29,112,0.259,123,230,0.535,40,54,0.741,23,163,186,173,101,17,68,158,373,0.3,2.0,2.3,2019
Carsen Edwards,SG,21,37,351,42,128,0.328,24,76,0.316,18,52,0.346,13,19,0.684,6,41,47,24,12,4,15,34,121,-0.3,0.4,0.1,2019
Henry Ellenson,C,23,5,15,1,7,0.143,0,4,0.0,1,3,0.333,0,0,0.0,2,4,6,1,0,0,0,1,2,-0.1,0.0,-0.1,2019
Wayne Ellington,SG,32,36,558,61,174,0.351,50,143,0.35,11,31,0.355,11,13,0.846,4,61,65,44,13,4,18,41,183,0.2,0.2,0.4,2019
Joel Embiid,C,25,51,1506,382,801,0.477,57,172,0.331,325,629,0.517,351,435,0.807,141,452,593,152,45,65,159,174,1172,3.3,2.7,6.0,2019
James Ennis III,SF,29,69,1265,160,359,0.446,55,169,0.325,105,190,0.553,79,98,0.806,71,174,245,63,35,22,58,137,454,1.0,1.4,2.4,2019
Drew Eubanks,C,22,22,272,43,67,0.642,1,1,1.0,42,66,0.636,20,26,0.769,28,57,85,15,5,17,21,37,107,0.5,0.3,0.8,2019
Jacob Evans,SG,22,29,418,45,134,0.336,13,39,0.333,32,95,0.337,25,29,0.862,9,32,41,31,11,12,25,41,128,-0.7,0.2,-0.5,2019
Dante Exum,SG,24,35,485,56,119,0.471,15,43,0.349,41,76,0.539,32,43,0.744,12,55,67,40,13,8,31,38,159,0.2,0.2,0.4,2019
Tacko Fall,C,24,7,33,11,14,0.786,0,0,0.0,11,14,0.786,1,3,0.333,1,14,15,1,1,4,3,7,23,0.1,0.1,0.2,2019
Derrick Favors,C,28,51,1243,209,339,0.617,1,7,0.143,208,332,0.627,40,71,0.563,163,338,501,81,30,46,55,107,459,2.6,1.6,4.2,2019
Cristiano Felício,C,27,22,386,34,54,0.63,0,2,0.0,34,52,0.654,18,23,0.783,55,47,102,16,10,2,18,34,86,0.7,0.3,1.0,2019
Terrance Ferguson,SF,21,56,1257,78,220,0.355,49,168,0.292,29,52,0.558,15,20,0.75,23,51,74,51,27,17,31,155,220,-0.3,0.9,0.6,2019
Bruno Fernando,C,21,56,713,103,199,0.518,5,37,0.135,98,162,0.605,29,51,0.569,67,131,198,49,18,17,42,107,240,0.4,0.4,0.8,2019
Yogi Ferrell,PG,26,50,530,79,188,0.42,24,79,0.304,55,109,0.505,36,42,0.857,6,43,49,69,18,4,28,38,218,0.3,0.3,0.7,2019
Dorian Finney-Smith,PF,26,71,2120,243,522,0.466,114,303,0.376,129,219,0.589,78,108,0.722,145,260,405,114,45,39,69,178,678,3.3,1.5,4.9,2019
Bryn Forbes,SG,26,63,1579,242,581,0.417,148,381,0.388,94,200,0.47,75,90,0.833,12,114,126,108,33,0,57,113,707,1.3,0.3,1.5,2019
Evan Fournier,SF,27,66,2076,434,929,0.467,173,434,0.399,261,495,0.527,180,220,0.818,18,153,171,209,71,15,125,161,1221,2.9,1.7,4.6,2019
De'Aaron Fox,PG,22,51,1634,391,815,0.48,54,185,0.292,337,630,0.535,241,342,0.705,35,161,196,348,74,25,158,145,1077,2.6,1.4,4.0,2019
Melvin Frazier,SG,23,19,126,15,34,0.441,8,16,0.5,7,18,0.389,2,4,0.5,2,8,10,3,9,2,5,11,40,0.0,0.2,0.2,2019
Michael Frazier,SG,25,13,145,7,29,0.241,4,23,0.174,3,6,0.5,9,14,0.643,1,9,10,2,2,0,5,22,27,-0.2,0.1,-0.2,2019
Tim Frazier,PG,29,27,355,34,94,0.362,10,30,0.333,24,64,0.375,19,24,0.792,9,24,33,93,14,4,36,42,97,-0.1,0.2,0.1,2019
Enes Freedom,C,27,58,983,199,348,0.572,1,7,0.143,198,341,0.581,70,99,0.707,163,268,431,56,22,41,56,100,469,2.6,1.8,4.4,2019
Markelle Fultz,PG,21,72,1996,359,772,0.465,36,135,0.267,323,637,0.507,116,159,0.73,41,197,238,369,90,11,147,142,870,0.6,2.0,2.7,2019
Wenyen Gabriel,PF,22,30,235,21,48,0.438,6,20,0.3,15,28,0.536,15,22,0.682,21,31,52,8,11,7,16,39,63,0.0,0.2,0.2,2019
Daniel Gafford,C,21,43,609,94,134,0.701,0,0,0.0,94,134,0.701,32,60,0.533,52,54,106,21,13,56,29,98,220,1.1,0.8,1.9,2019
Danilo Gallinari,PF,31,62,1834,358,817,0.438,178,439,0.405,180,378,0.476,266,298,0.893,34,288,322,119,42,5,76,75,1160,4.5,1.9,6.3,2019
Langston Galloway,SG,28,66,1702,236,542,0.435,132,331,0.399,104,211,0.493,73,85,0.859,33,116,149,101,48,11,40,96,677,2.4,0.7,3.1,2019
Darius Garland,SG,20,59,1824,280,699,0.401,105,296,0.355,175,403,0.434,63,72,0.875,27,84,111,229,42,4,151,92,728,-1.3,0.0,-1.3,2019
Marc Gasol,C,35,44,1161,119,279,0.427,57,148,0.385,62,131,0.473,36,49,0.735,31,244,275,147,34,38,59,124,331,0.8,2.2,3.0,2019
Rudy Gay,PF,33,67,1461,266,596,0.446,74,220,0.336,192,376,0.511,120,136,0.882,61,301,362,114,35,33,88,103,726,0.9,1.1,2.1,2019
Paul George,SF,29,48,1419,343,782,0.439,157,381,0.412,186,401,0.464,190,217,0.876,24,248,272,185,68,20,125,113,1033,2.5,2.3,4.8,2019
Taj Gibson,C,34,62,1025,167,286,0.584,4,14,0.286,163,272,0.599,41,56,0.732,111,156,267,52,27,30,47,122,379,1.8,0.8,2.6,2019
Harry Giles,C,21,46,667,139,251,0.554,0,2,0.0,139,249,0.558,38,49,0.776,43,145,188,60,22,18,44,119,316,0.8,0.8,1.6,2019
Shai Gilgeous-Alexander,SG,21,70,2428,478,1015,0.471,87,251,0.347,391,764,0.512,288,357,0.807,47,365,412,232,79,47,134,117,1331,3.1,3.0,6.1,2019
Rudy Gobert,C,27,68,2333,386,557,0.693,0,0,0.0,386,557,0.693,254,403,0.63,230,686,916,101,51,135,130,215,1026,6.5,4.2,10.7,2019
Brandon Goodwin,PG,24,34,430,76,190,0.4,26,87,0.299,50,103,0.485,28,30,0.933,11,61,72,51,12,4,29,43,206,-0.1,0.2,0.1,2019
Aaron Gordon,PF,24,62,2017,335,767,0.437,73,237,0.308,262,530,0.494,151,224,0.674,107,368,475,228,51,39,100,125,894,1.4,2.3,3.7,2019
Eric Gordon,SF,31,36,1016,171,463,0.369,96,303,0.317,75,160,0.469,82,107,0.766,9,62,71,54,23,13,43,70,520,-0.1,0.6,0.5,2019
Devonte' Graham,PG,24,63,2211,368,963,0.382,218,585,0.373,150,378,0.397,191,233,0.82,42,170,212,471,62,15,181,115,1145,2.4,0.9,3.4,2019
Treveon Graham,SF,26,55,929,87,242,0.36,33,120,0.275,54,122,0.443,36,56,0.643,51,99,150,45,24,6,29,102,243,-0.2,0.4,0.2,2019
Jerami Grant,PF,25,71,1892,303,634,0.478,98,252,0.389,205,382,0.537,147,196,0.75,58,190,248,88,50,57,63,154,851,2.8,1.6,4.4,2019
Jerian Grant,SG,27,6,80,10,27,0.37,2,8,0.25,8,19,0.421,5,7,0.714,2,4,6,9,1,1,3,11,27,0.0,0.0,0.0,2019
Josh Gray,PG,26,2,23,1,2,0.5,0,0,0.0,1,2,0.5,0,0,0.0,1,1,2,2,0,0,5,1,2,-0.1,0.0,-0.1,2019
Danny Green,SG,32,68,1687,197,474,0.416,120,327,0.367,77,147,0.524,33,48,0.688,51,174,225,91,85,32,63,136,547,0.8,2.5,3.4,2019
Draymond Green,PF,29,43,1222,123,316,0.389,36,129,0.279,87,187,0.465,63,83,0.759,23,243,266,266,59,33,98,110,345,-0.2,1.3,1.1,2019
JaMychal Green,PF,29,63,1307,151,352,0.429,92,238,0.387,59,114,0.518,36,48,0.75,77,311,388,49,29,24,54,174,430,1.1,2.0,3.1,2019
Javonte Green,SG,26,48,468,63,126,0.5,9,33,0.273,54,93,0.581,28,42,0.667,24,69,93,26,24,8,23,43,163,0.4,0.8,1.1,2019
Jeff Green,PF,33,48,960,159,344,0.462,62,183,0.339,97,161,0.602,73,91,0.802,24,109,133,50,26,19,42,89,453,1.2,0.9,2.1,2019
Blake Griffin,PF,30,18,512,88,250,0.352,27,111,0.243,61,139,0.439,76,98,0.776,17,67,84,59,7,7,40,27,279,-0.4,0.3,-0.1,2019
Marko Gudurić,SG,24,44,484,62,157,0.395,25,83,0.301,37,74,0.5,24,26,0.923,14,59,73,45,12,8,36,34,173,-0.3,0.4,0.1,2019
Kyle Guy,SG,22,3,10,2,5,0.4,0,3,0.0,2,2,1.0,0,0,0.0,0,1,1,1,0,0,0,1,4,0.0,0.0,0.0,2019
Rui Hachimura,PF,21,48,1444,254,545,0.466,25,87,0.287,229,458,0.5,116,140,0.829,78,216,294,87,37,8,53,105,649,1.3,0.5,1.8,2019
Devon Hall,PG,24,11,81,6,30,0.2,4,17,0.235,2,13,0.154,4,8,0.5,2,5,7,13,4,1,5,6,20,-0.3,0.1,-0.2,2019
Donta Hall,C,22,9,133,15,22,0.682,0,0,0.0,15,22,0.682,9,18,0.5,14,24,38,4,3,6,5,23,39,0.2,0.2,0.4,2019
Dusty Hannahs,SG,26,2,13,4,9,0.444,2,3,0.667,2,6,0.333,2,2,1.0,0,1,1,0,0,0,0,1,12,0.0,0.0,0.0,2019
Tim Hardaway Jr.,SG,27,71,2091,384,884,0.434,204,513,0.398,180,371,0.485,149,182,0.819,25,207,232,137,41,5,69,125,1121,3.4,1.1,4.4,2019
James Harden,SG,30,68,2483,672,1514,0.444,299,843,0.355,373,671,0.556,692,800,0.865,70,376,446,512,125,60,308,227,2335,9.9,3.2,13.1,2019
Maurice Harkless,PF,26,62,1427,142,283,0.502,34,98,0.347,108,185,0.584,39,66,0.591,55,185,240,68,58,33,53,148,357,0.8,1.9,2.7,2019
Jared Harper,PG,22,3,8,1,4,0.25,0,2,0.0,1,2,0.5,0,0,0.0,0,0,0,0,0,0,0,0,2,0.0,0.0,0.0,2019
Montrezl Harrell,C,26,63,1749,471,812,0.58,0,18,0.0,471,794,0.593,231,351,0.658,163,282,445,107,39,72,108,146,1173,4.4,2.5,7.0,2019
Gary Harris,SG,25,56,1780,218,519,0.42,70,210,0.333,148,309,0.479,75,92,0.815,26,137,163,118,76,14,60,116,581,0.5,1.4,1.9,2019
Joe Harris,SF,28,69,2123,381,784,0.486,172,406,0.424,209,378,0.553,64,89,0.719,64,234,298,144,41,17,104,159,998,2.5,1.8,4.3,2019
Tobias Harris,PF,27,72,2469,553,1173,0.471,131,357,0.367,422,816,0.517,174,216,0.806,69,426,495,227,53,40,104,165,1411,3.5,2.7,6.2,2019
Shaquille Harrison,SG,26,43,484,77,165,0.467,16,42,0.381,61,123,0.496,39,50,0.78,22,64,86,49,34,19,19,55,209,0.7,0.8,1.5,2019
Josh Hart,SF,24,65,1755,225,532,0.423,121,354,0.342,104,178,0.584,85,115,0.739,61,364,425,108,63,23,75,160,656,1.3,1.8,3.1,2019
Isaiah Hartenstein,C,21,23,266,44,67,0.657,0,5,0.0,44,62,0.71,19,28,0.679,29,61,90,18,9,12,16,41,107,0.7,0.4,1.1,2019
Udonis Haslem,C,39,4,44,4,11,0.364,1,3,0.333,3,8,0.375,3,4,0.75,1,15,16,1,0,0,1,6,12,0.0,0.1,0.0,2019
Jaxson Hayes,C,19,64,1080,174,259,0.672,1,4,0.25,173,255,0.678,123,190,0.647,97,162,259,56,26,55,53,161,472,2.8,1.1,3.9,2019
Gordon Hayward,SF,29,52,1740,350,700,0.5,85,222,0.383,265,478,0.554,124,145,0.855,55,293,348,212,38,22,96,96,909,3.5,2.2,5.7,2019
John Henson,C,29,40,600,95,171,0.556,8,36,0.222,87,135,0.644,23,46,0.5,46,116,162,54,24,42,36,78,221,0.6,0.8,1.4,2019
Dewan Hernandez,C,23,6,28,5,14,0.357,1,2,0.5,4,12,0.333,3,5,0.6,5,9,14,3,1,0,3,6,14,0.0,0.1,0.0,2019
Juancho Hernangómez,PF,24,48,833,100,247,0.405,44,129,0.341,56,118,0.475,44,71,0.62,43,154,197,40,19,9,32,64,288,0.2,0.7,0.9,2019
Willy Hernangómez,C,25,31,375,74,139,0.532,5,22,0.227,69,117,0.59,37,59,0.627,43,91,134,29,10,7,30,32,190,0.4,0.4,0.8,2019
Tyler Herro,SG,20,55,1508,270,631,0.428,116,298,0.389,154,333,0.462,87,100,0.87,16,208,224,121,34,9,87,76,743,0.2,1.3,1.6,2019
Kevin Hervey,PF,23,10,52,7,27,0.259,3,20,0.15,4,7,0.571,0,0,0.0,1,11,12,5,1,1,0,4,17,-0.2,0.1,-0.1,2019
Mario Hezonja,PF,24,53,871,92,218,0.422,24,78,0.308,68,140,0.486,48,59,0.814,30,154,184,50,36,9,42,107,256,0.1,0.6,0.8,2019
Buddy Hield,SG,27,72,2216,498,1162,0.429,271,688,0.394,227,474,0.479,115,136,0.846,57,271,328,213,66,17,168,165,1382,1.4,1.5,3.0,2019
George Hill,PG,33,59,1271,194,376,0.516,81,176,0.46,113,200,0.565,85,101,0.842,50,127,177,180,47,5,57,84,554,3.5,2.1,5.5,2019
Solomon Hill,PF,28,59,1088,110,278,0.396,63,171,0.368,47,107,0.439,40,54,0.741,29,136,165,104,43,12,51,85,323,0.4,1.1,1.4,2019
Jaylen Hoard,PF,20,13,103,15,32,0.469,0,3,0.0,15,29,0.517,8,13,0.615,14,18,32,4,5,0,4,12,38,0.1,0.1,0.2,2019
Aaron Holiday,PG,23,66,1617,233,563,0.414,87,221,0.394,146,342,0.427,74,87,0.851,22,134,156,225,55,16,88,120,627,0.4,1.7,2.1,2019
Jrue Holiday,SG,29,61,2117,458,1006,0.455,122,346,0.353,336,660,0.509,129,182,0.709,77,216,293,408,99,48,184,145,1167,2.0,1.9,3.9,2019
Justin Holiday,SF,30,73,1826,208,486,0.428,134,331,0.405,74,155,0.477,53,67,0.791,32,206,238,93,87,46,44,137,603,1.6,2.6,4.2,2019
Rondae Hollis-Jefferson,PF,25,60,1122,155,329,0.471,3,23,0.13,152,306,0.497,105,143,0.734,110,173,283,106,46,23,59,115,418,1.4,2.0,3.4,2019
Richaun Holmes,C,26,44,1242,223,344,0.648,0,0,0.0,223,344,0.648,93,118,0.788,127,231,358,42,41,56,52,169,539,3.4,1.5,4.9,2019
Rodney Hood,SF,27,21,619,87,172,0.506,35,71,0.493,52,101,0.515,21,27,0.778,10,62,72,32,17,4,19,46,230,0.9,0.2,1.1,2019
Al Horford,C,33,67,2025,319,709,0.45,99,283,0.35,220,426,0.516,61,80,0.763,103,353,456,270,52,61,80,142,798,2.8,2.6,5.4,2019
Talen Horton-Tucker,SG,19,6,81,14,30,0.467,4,13,0.308,10,17,0.588,2,4,0.5,2,5,7,6,8,1,6,10,34,0.0,0.2,0.1,2019
Danuel House Jr.,SF,26,63,1913,230,539,0.427,129,355,0.363,101,184,0.549,73,90,0.811,57,210,267,85,67,34,54,132,662,1.9,1.8,3.6,2019
Dwight Howard,C,34,69,1306,202,277,0.729,3,5,0.6,199,272,0.732,110,214,0.514,172,335,507,45,31,79,84,222,517,2.8,2.6,5.4,2019
William Howard,PF,26,2,13,0,4,0.0,0,4,0.0,0,0,0.0,0,0,0.0,0,2,2,1,0,0,1,1,0,-0.1,0.0,-0.1,2019
Kevin Huerter,SG,21,56,1760,252,610,0.413,127,334,0.38,125,276,0.453,53,64,0.828,35,193,228,213,51,27,87,139,684,1.0,0.6,1.6,2019
De'Andre Hunter,SF,22,63,2018,280,683,0.41,108,304,0.355,172,379,0.454,110,144,0.764,44,242,286,112,44,18,103,182,778,-0.4,0.5,0.1,2019
Chandler Hutchison,SF,23,28,527,80,175,0.457,12,38,0.316,68,137,0.496,46,78,0.59,18,90,108,26,27,7,27,47,218,0.0,0.7,0.7,2019
Serge Ibaka,C,30,55,1485,343,670,0.512,70,182,0.385,273,488,0.559,89,124,0.718,114,338,452,77,28,46,109,153,845,1.2,2.7,3.9,2019
Andre Iguodala,SF,36,21,418,38,88,0.432,14,47,0.298,24,41,0.585,6,15,0.4,17,61,78,51,14,21,26,35,96,0.0,0.6,0.6,2019
Ersan İlyasova,PF,32,63,986,146,313,0.466,50,137,0.365,96,176,0.545,72,87,0.828,62,240,302,49,24,17,34,95,414,1.6,2.0,3.6,2019
Joe Ingles,PF,32,72,2137,246,553,0.445,141,353,0.399,105,200,0.525,74,94,0.787,27,251,278,373,65,11,142,154,707,2.7,2.1,4.8,2019
Brandon Ingram,PF,22,62,2104,507,1096,0.463,150,384,0.391,357,712,0.501,313,368,0.851,51,329,380,259,61,38,189,179,1477,3.3,1.8,5.1,2019
Kyrie Irving,PG,27,20,658,199,416,0.478,56,142,0.394,143,274,0.522,94,102,0.922,22,81,103,128,27,10,52,53,548,2.1,0.8,2.9,2019
Jonathan Isaac,PF,22,34,980,156,332,0.47,32,94,0.34,124,238,0.521,60,77,0.779,58,173,231,48,53,78,49,83,404,0.6,1.9,2.5,2019
Wes Iwundu,SF,25,52,953,97,233,0.416,28,82,0.341,69,151,0.457,78,97,0.804,24,107,131,60,25,13,26,80,300,0.8,0.8,1.7,2019
Frank Jackson,PG,21,59,797,134,331,0.405,47,144,0.326,87,187,0.465,56,75,0.747,22,61,83,61,17,4,49,77,371,-0.2,0.3,0.2,2019
Jaren Jackson Jr.,C,20,57,1622,353,753,0.469,145,368,0.394,208,385,0.54,139,186,0.747,55,207,262,78,40,92,99,232,990,1.6,1.8,3.5,2019
Josh Jackson,SF,22,22,381,70,159,0.44,23,72,0.319,47,87,0.54,35,50,0.7,11,55,66,35,18,9,28,40,198,0.1,0.5,0.5,2019
Justin Jackson,PF,24,65,1045,135,341,0.396,48,163,0.294,87,178,0.489,42,50,0.84,27,127,154,52,15,10,14,69,360,0.6,0.6,1.2,2019
Reggie Jackson,PG,29,31,743,134,326,0.411,57,145,0.393,77,181,0.425,45,54,0.833,17,75,92,126,13,5,51,59,370,0.6,0.5,1.1,2019
Justin James,SF,23,36,232,35,84,0.417,9,29,0.31,26,55,0.473,10,21,0.476,6,26,32,18,6,9,8,17,89,-0.1,0.2,0.1,2019
LeBron James,PG,35,67,2316,643,1303,0.493,148,425,0.348,495,878,0.564,264,381,0.693,66,459,525,684,78,36,261,118,1698,6.2,3.6,9.8,2019
Amile Jefferson,PF,26,18,74,5,14,0.357,0,0,0.0,5,14,0.357,5,14,0.357,10,13,23,4,1,3,3,7,15,0.0,0.1,0.0,2019
DaQuan Jeffries,SG,22,13,141,20,40,0.5,5,18,0.278,15,22,0.682,5,6,0.833,3,15,18,7,4,1,2,19,50,0.2,0.1,0.3,2019
Ty Jerome,SG,22,31,328,38,113,0.336,14,50,0.28,24,63,0.381,12,16,0.75,7,39,46,44,15,3,18,29,102,-0.3,0.3,0.0,2019
Alize Johnson,PF,23,17,118,12,29,0.414,3,8,0.375,9,21,0.429,7,10,0.7,16,32,48,7,3,2,7,12,34,0.1,0.2,0.3,2019
B.J. Johnson,SF,24,10,83,9,32,0.281,3,9,0.333,6,23,0.261,9,10,0.9,3,12,15,3,3,0,6,3,30,-0.2,0.1,-0.1,2019
Cameron Johnson,PF,23,57,1255,176,405,0.435,106,272,0.39,70,133,0.526,46,57,0.807,49,138,187,69,36,20,32,88,504,1.7,1.0,2.7,2019
James Johnson,PF,32,32,619,103,215,0.479,33,91,0.363,70,124,0.565,31,48,0.646,25,93,118,74,25,32,48,80,270,0.3,0.8,1.1,2019
Keldon Johnson,SF,20,17,301,53,89,0.596,13,22,0.591,40,67,0.597,35,44,0.795,10,47,57,15,14,2,13,28,154,0.8,0.2,1.1,2019
Stanley Johnson,PF,23,25,150,22,59,0.373,7,24,0.292,15,35,0.429,9,16,0.563,7,30,37,20,6,4,15,16,60,-0.3,0.3,0.0,2019
Tyler Johnson,PG,27,39,709,97,250,0.388,38,119,0.319,59,131,0.45,42,50,0.84,18,58,76,74,16,9,29,58,274,0.3,0.5,0.7,2019
Nikola Jokić,C,24,73,2336,565,1071,0.528,80,255,0.314,485,816,0.594,246,301,0.817,166,545,711,512,85,44,226,222,1456,6.7,3.1,9.8,2019
Damian Jones,C,24,55,887,121,178,0.68,2,9,0.222,119,169,0.704,62,84,0.738,74,132,206,35,26,40,28,149,306,2.2,0.6,2.8,2019
Derrick Jones Jr.,SF,22,59,1375,184,349,0.527,37,132,0.28,147,217,0.677,95,123,0.772,66,167,233,62,58,38,30,130,500,2.6,1.8,4.4,2019
Tyus Jones,PG,23,65,1232,197,429,0.459,47,124,0.379,150,305,0.492,43,58,0.741,9,94,103,285,59,6,55,44,484,1.9,1.1,3.0,2019
DeAndre Jordan,C,31,56,1234,191,287,0.666,0,0,0.0,191,287,0.666,83,122,0.68,141,420,561,105,18,52,74,114,465,3.0,2.2,5.2,2019
Cory Joseph,PG,28,72,1759,171,412,0.415,56,159,0.352,115,253,0.455,60,70,0.857,44,144,188,251,53,21,80,133,458,1.2,1.1,2.3,2019
Mfiondu Kabengele,C,22,12,64,14,32,0.438,9,20,0.45,5,12,0.417,5,5,1.0,1,10,11,2,2,2,2,9,42,0.1,0.1,0.2,2019
Frank Kaminsky,C,26,39,777,138,307,0.45,41,124,0.331,97,183,0.53,61,90,0.678,35,141,176,75,14,10,37,75,378,0.7,0.7,1.4,2019
Luke Kennard,SG,23,28,922,151,342,0.442,73,183,0.399,78,159,0.491,67,75,0.893,9,89,98,115,12,6,43,65,442,1.6,0.3,1.9,2019
Stanton Kidd,SG,27,4,15,0,3,0.0,0,1,0.0,0,2,0.0,0,0,0.0,0,3,3,1,0,0,2,3,0,-0.1,0.0,-0.1,2019
Michael Kidd-Gilchrist,PF,26,25,281,22,66,0.333,5,20,0.25,17,46,0.37,11,14,0.786,14,53,67,14,2,6,16,37,60,-0.4,0.2,-0.2,2019
Louis King,SF,20,10,62,8,21,0.381,4,11,0.364,4,10,0.4,0,3,0.0,1,9,10,5,2,0,2,10,20,-0.1,0.0,0.0,2019
Maxi Kleber,PF,28,74,1890,237,514,0.461,119,319,0.373,118,195,0.605,79,93,0.849,112,276,388,88,25,83,58,176,672,3.2,1.7,4.8,2019
Brandon Knight,SG,28,25,462,59,167,0.353,45,131,0.344,14,36,0.389,20,34,0.588,4,37,41,69,10,3,38,40,183,-0.2,0.1,-0.1,2019
Kevin Knox,SF,20,65,1166,144,401,0.359,65,199,0.327,79,202,0.391,66,101,0.653,28,156,184,61,23,28,45,106,419,-0.5,0.7,0.2,2019
John Konchar,SG,23,19,181,24,37,0.649,5,10,0.5,19,27,0.704,1,2,0.5,18,29,47,22,7,3,7,7,54,0.5,0.2,0.7,2019
Furkan Korkmaz,SG,22,72,1559,242,563,0.43,143,356,0.402,99,207,0.478,77,102,0.755,18,150,168,79,41,16,59,98,704,1.4,1.4,2.8,2019
Luke Kornet,C,24,36,559,82,187,0.439,31,108,0.287,51,79,0.646,20,28,0.714,22,62,84,32,11,26,14,54,215,0.5,0.6,1.1,2019
Kyle Korver,SF,38,58,960,126,293,0.43,99,237,0.418,27,56,0.482,35,41,0.854,15,107,122,68,26,12,48,78,386,0.9,1.5,2.5,2019
Rodions Kurucs,PF,21,47,684,79,177,0.446,33,90,0.367,46,87,0.529,24,38,0.632,25,112,137,51,25,5,46,90,215,-0.1,0.8,0.8,2019
Kyle Kuzma,PF,24,61,1526,291,668,0.436,86,272,0.316,205,396,0.518,114,155,0.735,52,221,273,80,28,26,91,126,782,0.1,1.9,2.0,2019
Skal Labissière,C,23,33,567,81,147,0.551,3,13,0.231,78,134,0.582,25,33,0.758,65,104,169,42,7,31,30,89,190,1.0,0.4,1.4,2019
Jeremy Lamb,SG,27,46,1291,216,479,0.451,53,158,0.335,163,321,0.508,92,110,0.836,24,176,200,96,55,22,50,104,577,0.9,1.8,2.7,2019
Romeo Langford,SG,20,32,370,28,80,0.35,5,27,0.185,23,53,0.434,18,25,0.72,15,26,41,13,8,8,11,33,79,-0.2,0.4,0.2,2019
Zach LaVine,SF,24,60,2085,539,1199,0.45,184,484,0.38,355,715,0.497,268,334,0.802,41,248,289,254,88,28,206,131,1530,1.8,2.2,4.0,2019
Vic Law,PF,24,8,62,6,18,0.333,1,7,0.143,5,11,0.455,2,6,0.333,2,9,11,3,2,0,2,6,15,-0.1,0.1,-0.1,2019
Jake Layman,SF,25,23,505,81,179,0.453,24,72,0.333,57,107,0.533,24,32,0.75,17,40,57,15,17,10,24,47,210,0.0,0.3,0.3,2019
T.J. Leaf,PF,22,28,222,36,86,0.419,5,18,0.278,31,68,0.456,7,16,0.438,23,48,71,9,10,4,8,22,84,-0.1,0.4,0.3,2019
Jalen Lecque,SG,19,5,32,4,10,0.4,0,4,0.0,4,6,0.667,2,2,1.0,0,2,2,2,0,0,2,3,10,0.0,0.0,0.0,2019
Courtney Lee,SG,34,24,345,40,82,0.488,21,47,0.447,19,35,0.543,6,7,0.857,7,25,32,12,18,6,11,33,107,0.3,0.3,0.7,2019
Damion Lee,SG,27,49,1423,213,511,0.417,85,239,0.356,128,272,0.471,110,126,0.873,32,207,239,133,50,6,67,116,621,0.9,0.8,1.7,2019
Alex Len,C,26,55,970,177,319,0.555,16,59,0.271,161,260,0.619,68,105,0.648,100,221,321,50,23,48,55,127,438,1.5,1.0,2.5,2019
Kawhi Leonard,SF,28,57,1848,532,1133,0.47,123,325,0.378,409,808,0.506,356,402,0.886,54,348,402,280,103,33,149,113,1543,5.4,3.3,8.7,2019
Meyers Leonard,C,27,51,1034,119,234,0.509,53,128,0.414,66,106,0.623,18,28,0.643,30,230,260,55,14,15,39,107,309,0.9,1.2,2.1,2019
Caris LeVert,SG,25,45,1330,311,732,0.425,80,220,0.364,231,512,0.451,140,197,0.711,49,140,189,199,53,10,118,81,842,0.1,1.4,1.5,2019
Damian Lillard,PG,29,66,2474,624,1349,0.463,270,674,0.401,354,675,0.524,460,518,0.888,33,251,284,530,70,22,194,114,1978,10.9,0.7,11.6,2019
Nassir Little,PF,19,48,573,65,151,0.43,14,59,0.237,51,92,0.554,28,44,0.636,31,77,108,22,13,14,15,72,172,0.3,0.3,0.6,2019
Kevon Looney,C,23,20,262,29,79,0.367,1,14,0.071,28,65,0.431,9,12,0.75,28,38,66,20,12,6,12,34,68,-0.2,0.2,0.0,2019
Brook Lopez,C,31,68,1817,292,671,0.435,102,325,0.314,190,346,0.549,127,152,0.836,58,254,312,99,46,163,70,163,813,1.4,4.1,5.5,2019
Robin Lopez,C,31,66,958,147,299,0.492,35,105,0.333,112,194,0.577,28,53,0.528,56,105,161,45,10,45,63,96,357,-0.1,1.6,1.5,2019
Kevin Love,PF,31,56,1780,327,727,0.45,146,390,0.374,181,337,0.537,187,219,0.854,54,493,547,178,33,19,140,90,987,2.5,1.3,3.8,2019
Kyle Lowry,PG,33,58,2098,334,803,0.416,164,466,0.352,170,337,0.504,294,343,0.857,32,260,292,433,82,26,178,190,1126,4.2,3.3,7.5,2019
Timothé Luwawu-Cabarrot,SF,24,47,853,117,269,0.435,62,160,0.388,55,109,0.505,69,81,0.852,29,98,127,29,18,7,37,106,365,0.9,0.7,1.7,2019
Trey Lyles,PF,24,63,1271,153,343,0.446,65,168,0.387,88,175,0.503,33,45,0.733,71,290,361,69,28,28,39,98,404,1.2,1.0,2.2,2019
Daryl Macon,PG,24,4,14,1,3,0.333,1,2,0.5,0,1,0.0,0,0,0.0,0,0,0,1,0,0,2,1,3,0.0,0.0,0.0,2019
J.P. Macura,SG,24,1,1,0,0,0.0,0,0,0.0,0,0,0.0,0,0,0.0,0,0,0,0,0,0,0,0,0,0.0,0.0,0.0,2019
Josh Magette,PG,30,8,38,5,15,0.333,1,4,0.25,4,11,0.364,1,2,0.5,1,5,6,5,3,1,5,4,12,-0.2,0.1,-0.1,2019
Ian Mahinmi,C,33,38,808,104,210,0.495,5,26,0.192,99,184,0.538,70,113,0.619,78,140,218,49,31,44,45,114,283,0.7,0.7,1.4,2019
Thon Maker,C,22,60,776,93,193,0.482,22,64,0.344,71,129,0.55,73,110,0.664,54,113,167,43,25,39,45,102,281,0.7,0.8,1.5,2019
Terance Mann,SF,23,41,362,37,79,0.468,7,20,0.35,30,59,0.508,18,27,0.667,10,45,55,53,11,5,18,46,99,0.4,0.4,0.8,2019
Boban Marjanović,C,31,44,422,121,211,0.573,4,17,0.235,117,194,0.603,43,57,0.754,66,131,197,20,8,10,30,56,289,1.2,0.6,1.8,2019
Lauri Markkanen,PF,22,50,1492,251,591,0.425,109,317,0.344,142,274,0.518,126,153,0.824,60,253,313,74,42,23,81,96,737,1.0,1.6,2.6,2019
Caleb Martin,SF,24,18,317,37,84,0.44,20,37,0.541,17,47,0.362,17,21,0.81,10,28,38,23,12,7,15,32,111,0.3,0.2,0.5,2019
Cody Martin,SF,24,48,903,89,207,0.43,18,77,0.234,71,130,0.546,42,65,0.646,38,120,158,95,39,9,44,78,238,0.2,0.8,1.0,2019
Jeremiah Martin,PG,23,9,99,24,53,0.453,5,18,0.278,19,35,0.543,11,14,0.786,1,9,10,18,7,2,4,7,64,0.2,0.1,0.4,2019
Kelan Martin,SF,24,31,495,71,181,0.392,25,96,0.26,46,85,0.541,30,31,0.968,12,84,96,23,7,9,20,51,197,-0.1,0.3,0.2,2019
Frank Mason III,PG,25,9,118,23,51,0.451,6,21,0.286,17,30,0.567,10,17,0.588,5,14,19,29,5,1,11,11,62,0.1,0.2,0.4,2019
Garrison Mathews,SG,23,18,227,24,56,0.429,19,46,0.413,5,10,0.5,31,34,0.912,6,18,24,10,8,1,8,32,98,0.6,0.1,0.6,2019
Wesley Matthews,SG,33,67,1635,167,422,0.396,108,297,0.364,59,125,0.472,52,68,0.765,22,144,166,92,38,9,43,103,494,0.8,2.4,3.2,2019
Luc Mbah a Moute,PF,33,3,25,2,5,0.4,0,2,0.0,2,3,0.667,1,2,0.5,1,1,2,0,2,0,1,0,5,0.0,0.0,0.0,2019
Patrick McCaw,SF,24,37,908,67,162,0.414,23,71,0.324,44,91,0.484,13,18,0.722,19,67,86,79,39,4,29,60,170,0.2,1.2,1.4,2019
CJ McCollum,SG,28,70,2556,611,1356,0.451,194,512,0.379,417,844,0.494,140,185,0.757,46,251,297,310,54,42,127,183,1556,3.5,0.6,4.1,2019
T.J. McConnell,PG,27,71,1326,212,411,0.516,5,17,0.294,207,394,0.525,35,42,0.833,38,151,189,355,56,11,100,73,464,1.7,1.7,3.3,2019
Jalen McDaniels,SF,22,16,293,33,70,0.471,9,24,0.375,24,46,0.522,14,17,0.824,15,50,65,13,8,3,11,36,89,0.2,0.2,0.5,2019
Doug McDermott,PF,28,69,1372,267,547,0.488,128,294,0.435,139,253,0.549,48,58,0.828,26,148,174,78,12,5,42,117,710,2.3,1.1,3.3,2019
JaVale McGee,C,32,68,1130,195,306,0.637,3,6,0.5,192,300,0.64,53,82,0.646,125,265,390,37,36,94,55,159,446,2.2,2.4,4.7,2019
Rodney McGruder,SG,28,56,871,72,181,0.398,24,89,0.27,48,92,0.522,19,34,0.559,29,122,151,36,26,8,24,74,187,-0.1,1.1,1.0,2019
Alfonzo McKinnie,SF,27,40,593,73,171,0.427,14,65,0.215,59,106,0.557,22,31,0.71,37,76,113,14,23,8,26,72,182,-0.2,0.3,0.2,2019
Jordan McLaughlin,PG,23,30,590,87,178,0.489,29,76,0.382,58,102,0.569,26,39,0.667,7,42,49,125,34,4,31,31,229,1.1,0.4,1.6,2019
Ben McLemore,SF,26,71,1619,242,545,0.444,181,452,0.4,61,93,0.656,50,67,0.746,21,136,157,58,45,16,50,155,715,2.2,1.1,3.3,2019
Jordan McRae,SG,28,37,784,149,366,0.407,45,126,0.357,104,240,0.433,83,109,0.761,18,106,124,93,21,16,43,73,426,0.4,0.4,0.7,2019
Nicolò Melli,C,29,60,1042,136,323,0.421,69,206,0.335,67,117,0.573,54,73,0.74,38,142,180,82,34,23,46,124,395,0.9,0.9,1.8,2019
De'Anthony Melton,PG,21,60,1167,161,401,0.401,40,140,0.286,121,261,0.464,93,121,0.769,43,177,220,175,77,20,84,109,455,0.1,1.7,1.7,2019
Chimezie Metu,C,22,18,105,24,42,0.571,0,2,0.0,24,40,0.6,10,13,0.769,12,21,33,10,3,6,10,7,58,0.2,0.1,0.3,2019
Khris Middleton,SF,28,62,1853,471,947,0.497,147,354,0.415,324,593,0.546,208,227,0.916,44,338,382,265,53,7,137,142,1297,4.6,3.3,7.9,2019
Eric Mika,C,25,1,19,2,3,0.667,0,0,0.0,2,3,0.667,2,2,1.0,2,5,7,0,0,0,0,5,6,0.1,0.0,0.1,2019
C.J. Miles,SF,32,10,161,19,59,0.322,11,35,0.314,8,24,0.333,15,20,0.75,4,8,12,12,10,4,4,14,64,0.0,0.1,0.1,2019
Malcolm Miller,SF,26,28,162,12,29,0.414,8,22,0.364,4,7,0.571,3,8,0.375,2,14,16,11,5,2,4,18,35,0.1,0.2,0.3,2019
Patty Mills,PG,31,66,1485,258,598,0.431,154,403,0.382,104,195,0.533,97,112,0.866,22,86,108,118,53,6,54,105,767,2.3,0.5,2.8,2019
Paul Millsap,PF,34,51,1240,211,438,0.482,54,124,0.435,157,314,0.5,115,141,0.816,98,195,293,83,44,30,70,150,591,2.1,1.4,3.5,2019
Shake Milton,SG,23,40,805,134,277,0.484,58,135,0.43,76,142,0.535,51,65,0.785,15,73,88,104,20,7,47,92,377,1.4,0.7,2.1,2019
Donovan Mitchell,SG,23,69,2364,602,1342,0.449,173,473,0.366,429,869,0.494,278,322,0.863,53,251,304,294,70,14,184,172,1655,3.2,2.2,5.4,2019
Naz Mitrou-Long,SG,26,5,47,6,17,0.353,2,12,0.167,4,5,0.8,0,0,0.0,0,7,7,8,1,1,3,2,14,-0.1,0.1,0.0,2019
Adam Mokoka,SF,21,11,112,12,28,0.429,6,15,0.4,6,13,0.462,2,4,0.5,7,3,10,4,4,0,2,17,32,0.1,0.1,0.2,2019
Malik Monk,SG,21,55,1169,212,488,0.434,58,204,0.284,154,284,0.542,82,100,0.82,27,130,157,114,25,16,77,74,564,0.1,0.6,0.7,2019
Matt Mooney,SG,23,4,19,1,4,0.25,0,2,0.0,1,2,0.5,0,0,0.0,0,3,3,1,2,1,0,1,2,0.0,0.0,0.0,2019
E'Twaun Moore,SG,30,56,1020,186,437,0.426,63,167,0.377,123,270,0.456,31,45,0.689,31,100,131,78,32,11,40,80,466,0.3,0.7,0.9,2019
Ja Morant,PG,20,67,2074,447,937,0.477,60,179,0.335,387,758,0.511,239,308,0.776,51,208,259,488,58,18,220,110,1193,2.3,1.5,3.8,2019
Juwan Morgan,PF,22,21,134,15,26,0.577,3,8,0.375,12,18,0.667,3,4,0.75,10,19,29,6,1,2,6,19,36,0.2,0.1,0.3,2019
Marcus Morris,SF,30,62,1936,355,810,0.438,142,348,0.408,213,462,0.461,181,220,0.823,59,252,311,86,47,30,97,180,1033,2.1,1.5,3.6,2019
Markieff Morris,PF,30,58,1187,203,458,0.443,88,228,0.386,115,230,0.5,66,85,0.776,40,178,218,77,31,17,76,133,560,0.5,1.0,1.4,2019
Monte Morris,PG,24,73,1636,260,566,0.459,65,172,0.378,195,394,0.495,75,89,0.843,24,113,137,255,55,17,53,73,660,2.7,1.1,3.8,2019
Johnathan Motley,PF,24,13,41,11,15,0.733,1,1,1.0,10,14,0.714,5,7,0.714,3,7,10,8,3,0,5,6,28,0.2,0.1,0.3,2019
Emmanuel Mudiay,PG,23,54,850,151,327,0.462,30,87,0.345,121,240,0.504,63,83,0.759,18,108,126,116,24,10,76,72,395,0.1,0.9,1.0,2019
Mychal Mulder,SF,25,7,204,26,67,0.388,16,52,0.308,10,15,0.667,9,12,0.75,3,20,23,8,2,1,5,20,77,0.0,0.0,0.1,2019
Dejounte Murray,PG,23,66,1687,294,637,0.462,41,111,0.369,253,526,0.481,91,114,0.798,69,314,383,271,111,17,125,143,720,0.7,2.0,2.6,2019
Jamal Murray,PG,22,59,1904,408,894,0.456,112,324,0.346,296,570,0.519,163,185,0.881,45,191,236,284,67,17,127,102,1091,2.8,1.5,4.3,2019
Džanan Musa,SF,20,40,487,64,172,0.372,19,78,0.244,45,94,0.479,45,60,0.75,21,65,86,43,15,1,36,30,192,-0.3,0.5,0.2,2019
Mike Muscala,C,28,47,572,77,189,0.407,54,143,0.378,23,46,0.5,18,22,0.818,16,92,108,40,9,12,17,58,226,0.7,0.6,1.3,2019
Svi Mykhailiuk,SF,22,56,1265,166,405,0.41,115,285,0.404,51,120,0.425,57,70,0.814,17,87,104,106,41,4,61,87,504,1.0,0.6,1.6,2019
Abdel Nader,SF,26,55,867,123,263,0.468,48,128,0.375,75,135,0.556,51,66,0.773,14,86,100,38,23,20,43,78,345,0.5,0.9,1.3,2019
Larry Nance Jr.,PF,27,56,1472,229,431,0.531,56,159,0.352,173,272,0.636,50,74,0.676,106,303,409,123,56,22,60,91,564,2.8,1.1,3.9,2019
Shabazz Napier,PG,28,56,1344,188,456,0.412,76,240,0.317,112,216,0.519,126,153,0.824,26,132,158,262,69,11,128,101,578,0.8,0.9,1.7,2019
Raul Neto,PG,27,54,668,101,222,0.455,34,88,0.386,67,134,0.5,39,47,0.83,11,50,61,95,24,6,47,50,275,0.5,0.6,1.2,2019
Malik Newman,SG,22,1,4,0,2,0.0,0,1,0.0,0,1,0.0,2,2,1.0,0,0,0,0,0,0,1,0,2,0.0,0.0,0.0,2019
Georges Niang,PF,26,66,923,141,322,0.438,90,225,0.4,51,97,0.526,20,24,0.833,15,112,127,44,18,5,30,75,392,1.0,0.8,1.8,2019
Joakim Noah,C,34,5,50,4,8,0.5,0,0,0.0,4,8,0.5,6,8,0.75,5,11,16,7,1,1,6,9,14,0.0,0.1,0.1,2019
Nerlens Noel,C,25,61,1127,184,269,0.684,1,3,0.333,183,266,0.688,80,106,0.755,91,209,300,57,59,91,66,166,449,2.6,2.3,4.9,2019
Zach Norvell,SG,22,5,41,3,12,0.25,3,8,0.375,0,4,0.0,1,1,1.0,0,6,6,3,2,0,3,4,10,-0.1,0.0,-0.1,2019
Jaylen Nowell,SG,20,15,151,19,53,0.358,3,26,0.115,16,27,0.593,16,17,0.941,3,10,13,19,3,1,3,11,57,0.1,0.0,0.2,2019
Frank Ntilikina,PG,21,57,1187,131,333,0.393,44,137,0.321,87,196,0.444,51,59,0.864,23,98,121,172,54,16,71,142,357,0.1,0.8,0.9,2019
Kendrick Nunn,PG,24,67,1962,401,914,0.439,137,391,0.35,264,523,0.505,85,100,0.85,21,159,180,220,56,15,114,152,1024,0.4,1.6,2.0,2019
Jusuf Nurkić,C,25,8,253,54,109,0.495,2,10,0.2,52,99,0.525,31,35,0.886,23,59,82,32,11,16,19,39,141,0.5,0.3,0.9,2019
David Nwaba,SF,27,20,268,37,71,0.521,12,28,0.429,25,43,0.581,18,27,0.667,8,37,45,8,11,12,8,32,104,0.4,0.4,0.8,2019
Royce O'Neale,SF,26,71,2049,158,365,0.433,92,244,0.377,66,121,0.545,42,55,0.764,27,362,389,180,59,32,61,202,450,1.8,2.5,4.3,2019
Kyle O'Quinn,C,29,29,313,42,85,0.494,7,27,0.259,35,58,0.603,11,20,0.55,34,82,116,51,7,24,20,37,102,0.5,0.6,1.1,2019
Semi Ojeleye,PF,25,69,1011,80,196,0.408,48,127,0.378,32,69,0.464,28,32,0.875,26,119,145,37,21,5,19,80,236,0.8,1.0,1.9,2019
Jahlil Okafor,C,24,30,467,101,162,0.623,1,3,0.333,100,159,0.629,40,62,0.645,48,79,127,37,7,22,38,67,243,0.9,0.4,1.3,2019
Elie Okobo,PG,22,55,719,72,181,0.398,25,71,0.352,47,110,0.427,50,71,0.704,16,74,90,115,24,4,38,54,219,0.5,0.5,1.0,2019
Josh Okogie,SG,21,62,1547,170,398,0.427,41,154,0.266,129,244,0.529,152,191,0.796,87,181,268,99,68,26,87,139,533,0.9,1.2,2.2,2019
KZ Okpala,PF,20,5,26,3,5,0.6,0,1,0.0,3,4,0.75,1,2,0.5,1,4,5,1,2,1,1,2,7,0.0,0.0,0.1,2019
Victor Oladipo,SG,27,19,528,97,246,0.394,33,104,0.317,64,142,0.451,48,59,0.814,9,66,75,56,17,4,47,36,275,-0.6,0.6,0.0,2019
Kelly Olynyk,C,28,67,1300,184,398,0.462,95,234,0.406,89,164,0.543,86,100,0.86,44,261,305,116,45,23,71,173,549,1.9,1.8,3.7,2019
Miye Oni,SF,22,10,109,12,32,0.375,7,19,0.368,5,13,0.385,4,5,0.8,5,12,17,4,4,2,4,9,35,0.0,0.1,0.1,2019
Cedi Osman,SF,24,65,1910,266,609,0.437,123,321,0.383,143,288,0.497,63,94,0.67,39,192,231,154,54,16,91,160,718,1.0,0.6,1.6,2019
Kelly Oubre Jr.,SF,24,56,1933,373,826,0.452,108,307,0.352,265,519,0.511,192,246,0.78,67,294,361,85,71,40,83,192,1046,1.7,2.1,3.8,2019
Tariq Owens,PF,24,3,15,1,5,0.2,0,2,0.0,1,3,0.333,2,2,1.0,2,1,3,0,1,0,0,1,4,0.0,0.0,0.0,2019
Jeremy Pargo,PG,33,3,44,11,22,0.5,3,7,0.429,8,15,0.533,0,1,0.0,1,2,3,8,1,0,4,8,25,0.0,0.0,0.0,2019
Jabari Parker,PF,24,38,917,219,429,0.51,32,119,0.269,187,310,0.603,61,81,0.753,61,153,214,68,45,16,64,99,531,0.8,0.8,1.6,2019
Chandler Parsons,PF,31,5,54,5,18,0.278,4,14,0.286,1,4,0.25,0,0,0.0,1,6,7,3,4,1,3,3,14,-0.1,0.0,-0.1,2019
Eric Paschall,PF,23,60,1654,318,640,0.497,37,129,0.287,281,511,0.55,164,212,0.774,82,193,275,127,32,13,94,125,837,1.6,0.5,2.1,2019
Anžejs Pasečņiks,C,24,27,437,61,116,0.526,0,3,0.0,61,113,0.54,34,58,0.586,42,65,107,18,9,12,24,75,156,0.3,0.2,0.5,2019
Patrick Patterson,PF,30,59,776,95,233,0.408,67,172,0.39,28,61,0.459,35,43,0.814,35,116,151,41,7,3,21,54,292,1.1,0.8,1.9,2019
Justin Patton,C,22,5,24,4,10,0.4,1,4,0.25,3,6,0.5,0,0,0.0,1,4,5,2,0,0,2,4,9,-0.1,0.0,0.0,2019
Chris Paul,PG,34,70,2208,434,887,0.489,111,304,0.365,323,583,0.554,253,279,0.907,26,323,349,472,111,11,161,158,1232,5.9,3.0,8.9,2019
Cameron Payne,SG,25,8,183,33,68,0.485,15,29,0.517,18,39,0.462,6,7,0.857,4,27,31,24,8,2,11,20,87,0.3,0.2,0.5,2019
Elfrid Payton,PG,25,45,1246,193,440,0.439,14,69,0.203,179,371,0.482,49,86,0.57,52,160,212,323,70,17,96,89,449,0.5,1.2,1.7,2019
Gary Payton II,SF,27,29,432,48,116,0.414,13,46,0.283,35,70,0.5,4,8,0.5,26,54,80,48,33,7,20,54,113,0.0,0.4,0.5,2019
Norvel Pelle,C,26,24,232,25,48,0.521,0,1,0.0,25,47,0.532,7,14,0.5,20,52,72,8,3,31,18,55,57,-0.2,0.5,0.3,2019
Theo Pinson,SG,24,33,365,45,155,0.29,15,80,0.188,30,75,0.4,15,16,0.938,10,44,54,56,17,4,33,35,120,-1.0,0.4,-0.6,2019
Mason Plumlee,C,29,61,1057,177,288,0.615,0,5,0.0,177,283,0.625,83,155,0.535,98,219,317,154,33,38,82,143,437,2.0,1.4,3.4,2019
Jakob Poeltl,C,24,66,1171,166,266,0.624,0,0,0.0,166,266,0.624,40,86,0.465,131,244,375,116,37,95,54,126,372,2.4,1.6,4.0,2019
Vincent Poirier,C,26,22,130,17,36,0.472,1,2,0.5,16,34,0.471,6,7,0.857,13,30,43,8,2,9,8,25,41,0.1,0.2,0.3,2019
Shamorie Ponds,PG,21,4,11,3,5,0.6,1,2,0.5,2,3,0.667,2,2,1.0,0,1,1,2,0,1,0,2,9,0.1,0.0,0.1,2019
Jordan Poole,SG,20,57,1274,167,502,0.333,74,265,0.279,93,237,0.392,95,119,0.798,9,109,118,134,35,10,74,94,503,-1.6,0.4,-1.2,2019
Kevin Porter Jr.,SF,19,50,1162,186,421,0.442,53,158,0.335,133,263,0.506,73,101,0.723,22,140,162,109,46,14,93,135,498,-0.3,0.6,0.3,2019
Michael Porter Jr.,SF,21,55,903,195,383,0.509,62,147,0.422,133,236,0.564,60,72,0.833,66,193,259,46,27,25,49,100,512,1.8,1.1,2.9,2019
Otto Porter Jr.,SF,26,14,331,62,140,0.443,24,62,0.387,38,78,0.487,19,27,0.704,13,35,48,25,15,6,11,31,167,0.4,0.4,0.8,2019
Bobby Portis,PF,24,66,1393,265,589,0.45,67,187,0.358,198,402,0.493,71,93,0.763,80,258,338,98,32,18,73,110,668,0.9,1.0,1.9,2019
Kristaps Porziņģis,C,24,57,1814,398,932,0.427,142,403,0.352,256,529,0.484,226,283,0.799,100,440,540,102,41,115,92,185,1164,2.6,2.6,5.2,2019
Dwight Powell,C,28,40,1061,146,229,0.638,10,39,0.256,136,190,0.716,74,111,0.667,75,152,227,59,34,22,36,102,376,2.6,1.0,3.6,2019
Norman Powell,SG,26,52,1479,296,598,0.495,109,273,0.399,187,325,0.575,129,153,0.843,26,164,190,91,60,21,77,108,830,2.3,2.3,4.6,2019
Taurean Prince,PF,25,64,1857,278,739,0.376,146,431,0.339,132,308,0.429,71,89,0.798,50,331,381,116,57,25,127,159,773,-1.7,2.3,0.6,2019
Chasson Randle,PG,26,3,40,0,4,0.0,0,2,0.0,0,2,0.0,5,6,0.833,0,2,2,5,2,0,0,3,5,0.0,0.0,0.0,2019
Julius Randle,PF,25,64,2080,463,1006,0.46,64,231,0.277,399,775,0.515,258,352,0.733,151,471,622,198,51,22,193,178,1248,0.9,1.8,2.7,2019
Josh Reaves,SF,22,4,28,3,9,0.333,0,2,0.0,3,7,0.429,2,2,1.0,1,2,3,3,0,0,0,5,8,0.0,0.0,0.0,2019
Cam Reddish,SF,20,58,1551,213,554,0.384,83,250,0.332,130,304,0.428,101,126,0.802,35,181,216,87,62,28,96,132,610,-1.2,0.8,-0.4,2019
JJ Redick,SG,35,60,1581,286,631,0.453,180,397,0.453,106,234,0.453,165,185,0.892,10,141,151,119,20,10,75,96,917,3.6,0.6,4.1,2019
Naz Reid,C,20,30,495,100,243,0.412,32,97,0.33,68,146,0.466,37,53,0.698,34,90,124,35,19,22,22,83,269,0.2,0.6,0.8,2019
Josh Richardson,SG,26,55,1693,278,646,0.43,85,249,0.341,193,397,0.486,114,141,0.809,41,133,174,162,52,36,104,136,755,0.5,1.7,2.1,2019
Austin Rivers,SG,27,68,1594,211,501,0.421,96,270,0.356,115,231,0.498,78,111,0.703,27,148,175,113,49,10,50,129,596,1.2,1.2,2.4,2019
Andre Roberson,SF,28,7,87,8,29,0.276,3,14,0.214,5,15,0.333,1,2,0.5,7,20,27,4,1,3,2,13,20,-0.1,0.1,0.0,2019
Duncan Robinson,SG,25,73,2166,323,687,0.47,270,606,0.446,53,81,0.654,67,72,0.931,10,222,232,102,35,19,70,193,983,3.7,1.6,5.3,2019
Glenn Robinson III,SF,26,62,1786,288,592,0.486,77,197,0.391,211,395,0.534,74,86,0.86,81,189,270,96,54,16,55,100,727,2.0,0.9,2.9,2019
Jerome Robinson,SG,22,63,979,115,310,0.371,49,153,0.32,66,157,0.42,40,57,0.702,13,116,129,87,28,17,49,112,319,-0.6,0.8,0.2,2019
Justin Robinson,PG,22,9,49,5,12,0.417,3,5,0.6,2,7,0.286,0,0,0.0,1,4,5,7,0,1,3,2,13,0.0,0.0,0.0,2019
Mitchell Robinson,C,21,61,1412,253,341,0.742,0,0,0.0,253,341,0.742,84,148,0.568,186,242,428,36,52,119,37,194,590,4.8,2.0,6.8,2019
Isaiah Roby,PF,21,3,11,0,1,0.0,0,0,0.0,0,1,0.0,0,0,0.0,0,2,2,0,0,0,1,1,0,-0.1,0.0,0.0,2019
Rajon Rondo,PG,33,48,984,137,328,0.418,41,125,0.328,96,203,0.473,27,41,0.659,23,119,142,240,40,2,91,58,342,0.1,1.3,1.4,2019
Derrick Rose,PG,31,50,1298,369,753,0.49,45,147,0.306,324,606,0.535,121,139,0.871,27,94,121,278,40,16,126,49,904,1.8,0.7,2.5,2019
Terrence Ross,SG,28,69,1889,341,846,0.403,177,504,0.351,164,342,0.48,157,184,0.853,13,209,222,82,77,24,70,109,1016,1.1,2.0,3.0,2019
Terry Rozier,PG,25,63,2164,398,941,0.423,172,423,0.407,226,518,0.436,166,190,0.874,50,226,276,259,61,10,141,126,1134,1.9,1.1,3.0,2019
Ricky Rubio,PG,29,65,2016,287,692,0.415,78,216,0.361,209,476,0.439,195,226,0.863,46,258,304,570,94,11,173,167,847,2.9,2.0,4.9,2019
D'Angelo Russell,PG,23,45,1452,360,846,0.426,158,431,0.367,202,415,0.487,161,199,0.809,17,160,177,285,48,13,147,86,1039,1.1,0.7,1.8,2019
Domantas Sabonis,PF,23,62,2159,458,848,0.54,17,67,0.254,441,781,0.565,214,296,0.723,189,582,771,310,47,30,170,195,1147,4.1,3.4,7.5,2019
Luka Šamanić,PF,20,3,48,5,16,0.313,3,8,0.375,2,8,0.25,3,4,0.75,1,9,10,6,0,2,2,6,16,0.0,0.0,0.0,2019
JaKarr Sampson,PF,26,34,471,68,115,0.591,2,13,0.154,66,102,0.647,18,27,0.667,20,68,88,21,16,12,15,64,156,0.6,0.7,1.2,2019
Dario Šarić,PF,25,66,1632,256,538,0.476,84,235,0.357,172,303,0.568,108,128,0.844,100,306,406,123,37,16,88,156,704,2.1,1.5,3.6,2019
Tomáš Satoranský,SG,28,65,1878,237,551,0.43,64,199,0.322,173,352,0.491,106,121,0.876,76,178,254,354,80,7,130,135,644,1.8,1.7,3.5,2019
Admiral Schofield,PF,22,33,368,35,92,0.38,19,61,0.311,16,31,0.516,10,15,0.667,7,40,47,15,8,4,7,50,99,0.1,0.1,0.1,2019
Dennis Schröder,PG,26,65,1999,453,965,0.469,125,325,0.385,328,640,0.513,198,236,0.839,19,217,236,262,45,14,166,146,1229,1.9,1.8,3.6,2019
Mike Scott,PF,31,68,1207,149,350,0.426,80,217,0.369,69,133,0.519,30,37,0.811,65,183,248,56,21,5,26,96,408,1.4,1.1,2.5,2019
Thabo Sefolosha,PF,35,41,436,37,91,0.407,15,54,0.278,22,37,0.595,3,8,0.375,21,72,93,25,24,12,15,43,92,0.0,0.6,0.7,2019
Collin Sexton,PG,21,65,2143,513,1086,0.472,97,255,0.38,416,831,0.501,226,267,0.846,61,143,204,192,65,7,158,142,1349,2.1,0.4,2.5,2019
Landry Shamet,SG,22,53,1452,158,391,0.404,111,296,0.375,47,95,0.495,65,76,0.855,6,94,100,99,20,10,42,142,492,1.5,1.1,2.6,2019
Marial Shayok,SG,24,4,28,3,12,0.25,2,6,0.333,1,6,0.167,3,4,0.75,1,6,7,1,0,1,3,4,11,-0.1,0.0,-0.1,2019
Iman Shumpert,SF,29,13,241,21,64,0.328,8,33,0.242,13,31,0.419,4,7,0.571,9,25,34,12,12,2,10,21,54,-0.3,0.3,0.0,2019
Pascal Siakam,PF,25,60,2110,500,1104,0.453,131,365,0.359,369,739,0.499,240,303,0.792,64,375,439,207,61,53,148,170,1371,1.8,3.6,5.4,2019
Chris Silva,PF,23,44,346,48,78,0.615,0,3,0.0,48,75,0.64,37,55,0.673,60,66,126,23,9,21,32,85,133,0.7,0.5,1.3,2019
Ben Simmons,PG,23,57,2017,375,647,0.58,2,7,0.286,373,640,0.583,185,298,0.621,113,331,444,455,119,33,200,186,937,3.8,3.1,6.9,2019
Anfernee Simons,SG,20,70,1449,214,536,0.399,75,226,0.332,139,310,0.448,76,92,0.826,25,127,152,97,26,10,61,135,579,0.0,0.1,0.2,2019
Alen Smailagić,C,19,14,139,20,40,0.5,3,13,0.231,17,27,0.63,16,19,0.842,10,17,27,13,3,4,11,14,59,0.2,0.1,0.2,2019
Marcus Smart,SG,25,60,1919,256,682,0.375,137,395,0.347,119,287,0.415,127,152,0.836,42,183,225,291,101,29,103,162,776,1.7,2.8,4.5,2019
Dennis Smith Jr.,PG,22,34,537,72,211,0.341,16,54,0.296,56,157,0.357,27,53,0.509,21,57,78,98,28,8,58,65,187,-1.4,0.5,-0.9,2019
Ish Smith,PG,31,68,1787,308,689,0.447,62,169,0.367,246,520,0.473,62,86,0.721,30,189,219,334,59,30,95,106,740,1.3,0.6,1.9,2019
J.R. Smith,SG,34,6,79,7,22,0.318,1,11,0.091,6,11,0.545,2,2,1.0,0,5,5,3,1,0,4,5,17,-0.2,0.1,-0.1,2019
Zhaire Smith,SF,20,7,32,3,11,0.273,0,3,0.0,3,8,0.375,2,4,0.5,0,2,2,2,3,0,2,4,8,-0.1,0.1,-0.1,2019
Tony Snell,SF,28,59,1641,170,382,0.445,102,254,0.402,68,128,0.531,32,32,1.0,9,102,111,127,32,15,31,101,474,2.1,0.5,2.6,2019
Omari Spellman,C,22,49,886,127,295,0.431,43,110,0.391,84,185,0.454,73,92,0.793,77,142,219,47,33,24,54,63,370,0.5,0.7,1.2,2019
Max Strus,SF,23,2,6,2,3,0.667,0,1,0.0,2,2,1.0,1,1,1.0,1,0,1,0,0,0,0,1,5,0.0,0.0,0.0,2019
Edmond Sumner,SG,24,31,447,61,142,0.43,14,53,0.264,47,89,0.528,16,29,0.552,11,35,46,55,15,9,22,44,152,-0.1,0.5,0.4,2019
Caleb Swanigan,PF,22,27,288,28,47,0.596,0,2,0.0,28,45,0.622,9,17,0.529,27,73,100,31,3,7,37,62,65,-0.2,0.2,0.0,2019
Jayson Tatum,PF,21,66,2265,552,1226,0.45,189,469,0.403,363,757,0.48,254,313,0.812,64,396,460,200,93,57,155,136,1547,3.2,3.7,6.9,2019
Jeff Teague,PG,31,59,1464,213,489,0.436,43,117,0.368,170,372,0.457,172,197,0.873,27,115,142,308,44,19,116,106,641,1.9,0.6,2.5,2019
Garrett Temple,SG,33,62,1730,222,587,0.378,127,386,0.329,95,201,0.473,70,87,0.805,29,189,218,156,49,29,62,108,641,0.7,1.7,2.4,2019
Daniel Theis,C,27,65,1566,241,426,0.566,32,96,0.333,209,330,0.633,87,114,0.763,140,286,426,111,37,84,54,219,601,4.0,2.6,6.5,2019
Isaiah Thomas,PG,30,40,925,174,426,0.408,78,189,0.413,96,237,0.405,62,76,0.816,11,57,68,146,13,6,77,77,488,0.1,-0.1,0.0,2019
Khyri Thomas,SG,23,8,61,5,17,0.294,5,14,0.357,0,3,0.0,2,4,0.5,1,0,1,3,3,0,3,9,17,-0.1,0.0,0.0,2019
Lance Thomas,PF,31,7,98,8,23,0.348,4,13,0.308,4,10,0.4,4,4,1.0,2,11,13,6,0,0,6,11,24,-0.1,0.1,0.0,2019
Matt Thomas,SG,25,41,440,73,150,0.487,47,99,0.475,26,51,0.51,9,12,0.75,9,52,61,22,10,1,16,38,202,0.7,0.6,1.2,2019
Tristan Thompson,C,28,57,1721,288,562,0.512,9,23,0.391,279,539,0.518,99,161,0.615,226,351,577,120,33,50,103,124,684,2.0,1.1,3.1,2019
Sindarius Thornwell,SF,25,2,35,6,11,0.545,2,4,0.5,4,7,0.571,2,4,0.5,0,4,4,4,1,1,2,2,16,0.0,0.0,0.1,2019
Matisse Thybulle,SG,22,65,1287,112,265,0.423,56,157,0.357,56,108,0.519,25,41,0.61,44,63,107,79,94,47,51,141,305,0.3,2.0,2.3,2019
Anthony Tolliver,PF,34,55,872,65,182,0.357,49,145,0.338,16,37,0.432,21,29,0.724,34,120,154,42,19,11,34,74,200,0.0,0.4,0.5,2019
Juan Toscano-Anderson,SG,26,13,272,29,63,0.46,8,23,0.348,21,40,0.525,3,5,0.6,9,43,52,26,13,5,16,30,69,-0.1,0.2,0.2,2019
Karl-Anthony Towns,C,24,35,1187,316,622,0.508,114,277,0.412,202,345,0.586,180,226,0.796,95,283,378,153,33,42,110,117,926,3.7,1.3,5.1,2019
Gary Trent Jr.,SF,21,61,1332,196,441,0.444,112,268,0.418,84,173,0.486,37,45,0.822,25,75,100,61,48,16,21,90,541,2.2,0.3,2.5,2019
Allonzo Trier,SG,24,24,291,51,106,0.481,19,53,0.358,32,53,0.604,34,43,0.791,6,23,29,28,3,4,22,29,155,0.5,0.1,0.5,2019
P.J. Tucker,PF,34,72,2467,177,426,0.415,107,299,0.358,70,127,0.551,39,48,0.813,112,364,476,115,77,36,72,229,500,1.6,2.4,4.0,2019
Rayjon Tucker,SG,22,20,161,20,43,0.465,3,17,0.176,17,26,0.654,19,23,0.826,3,17,20,5,1,1,8,10,62,0.1,0.1,0.2,2019
Evan Turner,SG,31,19,251,25,67,0.373,0,5,0.0,25,62,0.403,12,14,0.857,8,30,38,38,9,8,26,20,62,-0.5,0.1,-0.3,2019
Myles Turner,C,23,62,1826,268,587,0.457,86,250,0.344,182,337,0.54,127,169,0.751,86,321,407,72,46,132,85,166,749,1.1,3.1,4.2,2019
Jarrod Uthoff,PF,26,7,53,7,18,0.389,3,9,0.333,4,9,0.444,2,2,1.0,2,4,6,0,1,0,0,2,19,0.0,0.0,0.0,2019
Jonas Valančiūnas,C,27,70,1845,432,739,0.585,32,91,0.352,400,648,0.617,148,200,0.74,213,575,788,131,30,76,127,185,1044,4.2,2.8,7.0,2019
Denzel Valentine,SF,26,36,488,97,237,0.409,46,137,0.336,51,100,0.51,6,8,0.75,9,65,74,43,26,6,26,51,246,-0.1,0.6,0.5,2019
Jarred Vanderbilt,PF,20,11,46,5,8,0.625,0,1,0.0,5,7,0.714,2,2,1.0,3,6,9,2,3,1,7,6,12,-0.1,0.1,0.0,2019
Fred VanVleet,SG,25,54,1928,319,773,0.413,146,374,0.39,173,399,0.434,168,198,0.848,18,185,203,357,100,17,121,132,952,2.8,3.1,5.8,2019
Gabe Vincent,PG,23,9,83,8,37,0.216,6,27,0.222,2,10,0.2,0,0,0.0,0,5,5,6,5,0,1,6,22,-0.3,0.1,-0.2,2019
Noah Vonleh,C,24,36,377,52,92,0.565,3,15,0.2,49,77,0.636,25,32,0.781,37,87,124,28,11,6,21,40,132,0.6,0.4,1.0,2019
Nikola Vučević,C,29,62,1998,493,1033,0.477,98,289,0.339,395,744,0.531,131,167,0.784,140,533,673,222,54,47,88,135,1215,3.5,2.9,6.4,2019
Dean Wade,PF,23,12,71,9,13,0.692,2,4,0.5,7,9,0.778,0,1,0.0,3,16,19,2,2,4,3,8,20,0.1,0.1,0.2,2019
Moritz Wagner,C,22,45,835,145,266,0.545,25,80,0.313,120,186,0.645,78,95,0.821,56,163,219,56,28,19,66,152,393,1.1,0.6,1.7,2019
Dion Waiters,SG,28,10,207,41,99,0.414,15,47,0.319,26,52,0.5,14,17,0.824,2,22,24,20,4,6,16,21,111,-0.1,0.2,0.1,2019
Kemba Walker,PG,29,56,1742,378,889,0.425,180,473,0.381,198,416,0.476,209,242,0.864,36,181,217,268,48,28,117,91,1145,3.9,2.0,5.9,2019
Lonnie Walker IV,SG,21,61,988,152,357,0.426,41,101,0.406,111,256,0.434,44,61,0.721,23,116,139,68,32,14,44,78,389,-0.2,0.6,0.3,2019
Tyrone Wallace,SG,25,14,160,14,44,0.318,1,15,0.067,13,29,0.448,11,17,0.647,3,19,22,13,7,1,10,19,40,-0.3,0.1,-0.2,2019
Derrick Walton,PG,24,26,248,18,39,0.462,10,24,0.417,8,15,0.533,7,9,0.778,2,14,16,27,7,0,5,21,53,0.4,0.2,0.6,2019
Brad Wanamaker,PG,30,71,1369,162,362,0.448,37,102,0.363,125,260,0.481,126,136,0.926,22,122,144,179,61,14,76,133,487,1.8,1.8,3.5,2019
T.J. Warren,SF,26,67,2202,534,997,0.536,91,226,0.403,443,771,0.575,167,204,0.819,68,212,280,99,78,34,84,187,1326,4.0,2.6,6.5,2019
P.J. Washington,PF,21,58,1759,268,589,0.455,86,230,0.374,182,359,0.507,88,136,0.647,58,258,316,123,51,44,93,158,710,0.5,1.5,2.0,2019
Yuta Watanabe,SF,25,18,105,15,34,0.441,3,8,0.375,12,26,0.462,3,8,0.375,7,13,20,5,5,1,2,9,36,0.0,0.1,0.1,2019
Tremont Waters,PG,22,11,119,14,49,0.286,4,24,0.167,10,25,0.4,8,8,1.0,0,12,12,16,10,2,15,13,40,-0.5,0.2,-0.3,2019
Paul Watson,SF,25,10,87,10,26,0.385,4,12,0.333,6,14,0.429,7,9,0.778,2,15,17,8,4,1,3,5,31,0.0,0.1,0.2,2019
Quinndary Weatherspoon,SG,23,11,78,5,17,0.294,1,5,0.2,4,12,0.333,1,2,0.5,1,6,7,11,3,1,5,8,12,-0.2,0.0,-0.1,2019
Russell Westbrook,PG,31,57,2049,604,1281,0.472,55,213,0.258,549,1068,0.514,290,380,0.763,100,351,451,401,93,20,255,200,1553,1.7,2.5,4.2,2019
Coby White,PG,19,65,1674,312,792,0.394,133,376,0.354,179,416,0.43,102,129,0.791,28,202,230,175,49,6,109,117,859,-0.5,1.4,0.9,2019
Derrick White,SG,25,68,1677,253,552,0.458,79,216,0.366,174,336,0.518,180,211,0.853,35,188,223,241,44,59,89,152,765,3.1,1.1,4.2,2019
Hassan Whiteside,C,30,67,2008,436,702,0.621,4,7,0.571,432,695,0.622,164,239,0.686,258,647,905,78,26,196,120,196,1040,5.6,3.0,8.5,2019
Andrew Wiggins,SF,24,54,1858,437,978,0.447,111,334,0.332,326,644,0.506,190,268,0.709,66,208,274,198,45,53,132,127,1175,0.8,1.1,1.9,2019
Grant Williams,PF,21,69,1043,87,211,0.412,24,96,0.25,63,115,0.548,39,54,0.722,59,119,178,68,30,36,50,163,237,0.1,1.4,1.6,2019
Johnathan Williams,PF,24,15,180,19,34,0.559,0,2,0.0,19,32,0.594,7,13,0.538,24,40,64,8,1,8,5,16,45,0.3,0.1,0.4,2019
Kenrich Williams,PF,25,39,832,51,147,0.347,25,97,0.258,26,50,0.52,9,26,0.346,51,135,186,57,27,21,22,88,136,0.1,0.8,0.9,2019
Lou Williams,PG,33,65,1864,391,936,0.418,111,315,0.352,280,621,0.451,292,339,0.861,31,170,201,365,43,12,182,80,1185,2.3,1.8,4.1,2019
Marvin Williams,PF,33,58,1129,119,267,0.446,56,156,0.359,63,111,0.568,49,57,0.86,30,153,183,60,36,30,33,103,343,1.1,1.3,2.4,2019
Robert Williams,C,22,29,388,64,88,0.727,0,0,0.0,64,88,0.727,22,34,0.647,40,88,128,27,22,35,21,51,150,1.1,1.0,2.0,2019
Nigel Williams-Goss,PG,25,10,50,5,16,0.313,2,7,0.286,3,9,0.333,2,2,1.0,2,4,6,6,3,1,3,6,14,-0.1,0.1,0.0,2019
Zion Williamson,PF,19,24,668,210,360,0.583,6,14,0.429,204,346,0.59,114,178,0.64,64,86,150,50,16,9,59,42,540,1.5,0.4,2.0,2019
D.J. Wilson,PF,23,37,363,52,132,0.394,18,73,0.247,34,59,0.576,11,18,0.611,12,80,92,25,3,5,19,33,133,-0.3,0.6,0.3,2019
Justise Winslow,SG,23,11,352,50,129,0.388,6,27,0.222,44,102,0.431,18,27,0.667,16,57,73,44,7,5,24,38,124,-0.4,0.4,0.0,2019
Christian Wood,PF,24,62,1325,288,508,0.567,54,140,0.386,234,368,0.636,180,242,0.744,104,286,390,60,34,54,84,98,810,3.6,1.5,5.1,2019
Delon Wright,PG,27,73,1570,190,411,0.462,47,127,0.37,143,284,0.504,77,100,0.77,70,210,280,244,85,22,73,93,504,2.6,1.8,4.4,2019
Justin Wright-Foreman,PG,22,4,45,7,20,0.35,2,10,0.2,5,10,0.5,3,4,0.75,0,5,5,7,2,0,3,5,19,-0.1,0.1,0.0,2019
Thaddeus Young,PF,31,64,1591,269,601,0.448,79,222,0.356,190,379,0.501,42,72,0.583,94,221,315,117,92,23,102,134,659,-0.2,2.1,1.9,2019
Trae Young,PG,21,60,2120,546,1249,0.437,205,568,0.361,341,681,0.501,481,559,0.86,32,223,255,560,65,8,289,104,1778,5.3,0.6,5.9,2019
Cody Zeller,C,27,58,1341,251,479,0.524,18,75,0.24,233,404,0.577,122,179,0.682,160,251,411,88,40,25,75,140,642,2.3,1.3,3.6,2019
Tyler Zeller,C,30,2,4,1,4,0.25,0,0,0.0,1,4,0.25,0,0,0.0,3,1,4,0,0,0,0,0,2,0.0,0.0,0.0,2019
Ante Žižić,C,23,22,221,41,72,0.569,0,0,0.0,41,72,0.569,14,19,0.737,18,48,66,6,7,5,10,27,96,0.3,0.2,0.5,2019
Ivica Zubac,C,22,72,1326,236,385,0.613,0,2,0.0,236,383,0.616,124,166,0.747,197,346,543,82,16,66,61,168,596,4.4,2.3,6.6,2019
Precious Achiuwa,PF,21,61,737,124,228,0.544,0,1,0.0,124,227,0.546,56,110,0.509,73,135,208,29,20,28,43,91,304,0.3,1.0,1.3,2020
Jaylen Adams,PG,24,7,18,1,8,0.125,0,2,0.0,1,6,0.167,0,0,0.0,0,3,3,2,0,0,0,1,2,-0.1,0.0,-0.1,2020
Steven Adams,C,27,58,1605,189,308,0.614,0,3,0.0,189,305,0.62,60,135,0.444,213,301,514,111,54,38,78,113,438,2.3,1.7,4.0,2020
Bam Adebayo,C,23,64,2143,456,800,0.57,2,8,0.25,454,792,0.573,283,354,0.799,142,431,573,346,75,66,169,145,1197,5.6,3.2,8.8,2020
LaMarcus Aldridge,C,35,26,674,140,296,0.473,31,80,0.388,109,216,0.505,41,47,0.872,19,99,118,49,11,29,27,47,352,0.5,0.6,1.1,2020
Ty-Shon Alexander,SG,22,15,47,3,12,0.25,2,9,0.222,1,3,0.333,1,2,0.5,2,8,10,6,0,1,3,2,9,-0.1,0.0,0.0,2020
Nickeil Alexander-Walker,SG,22,46,1007,192,458,0.419,76,219,0.347,116,239,0.485,48,66,0.727,13,131,144,102,47,22,69,88,508,-0.3,1.0,0.7,2020
Grayson Allen,SG,25,50,1259,173,414,0.418,107,274,0.391,66,140,0.471,79,91,0.868,19,141,160,108,46,8,48,71,532,1.5,1.2,2.7,2020
Jarrett Allen,C,22,63,1864,298,482,0.618,6,19,0.316,292,463,0.631,204,290,0.703,196,435,631,106,32,90,100,96,806,4.3,2.1,6.4,2020
Al-Farouq Aminu,PF,30,23,434,38,99,0.384,8,37,0.216,30,62,0.484,18,22,0.818,22,88,110,31,19,9,28,29,102,-0.4,0.5,0.1,2020
Kyle Anderson,PF,27,69,1887,308,658,0.468,94,261,0.36,214,397,0.539,144,184,0.783,52,344,396,250,84,57,86,120,854,2.9,2.7,5.6,2020
Giannis Antetokounmpo,PF,26,61,2013,626,1100,0.569,67,221,0.303,559,879,0.636,398,581,0.685,97,574,671,357,72,73,207,168,1717,6.9,3.3,10.2,2020
Kostas Antetokounmpo,PF,23,15,56,3,10,0.3,0,0,0.0,3,10,0.3,6,13,0.462,4,15,19,1,2,4,11,8,12,-0.3,0.1,-0.2,2020
Thanasis Antetokounmpo,SF,28,57,551,67,137,0.489,7,29,0.241,60,108,0.556,25,49,0.51,54,70,124,46,22,10,43,74,166,0.0,0.6,0.7,2020
Carmelo Anthony,PF,36,69,1690,327,777,0.421,133,325,0.409,194,452,0.429,137,154,0.89,32,182,214,104,46,38,61,144,924,1.7,0.8,2.6,2020
Cole Anthony,PG,20,47,1273,219,552,0.397,58,172,0.337,161,380,0.424,109,131,0.832,38,183,221,192,30,18,106,98,605,-0.9,0.9,0.0,2020
OG Anunoby,SF,23,43,1433,249,519,0.48,104,261,0.398,145,258,0.562,80,102,0.784,54,183,237,94,66,32,75,114,682,1.5,1.6,3.1,2020
Ryan Arcidiacono,PG,26,44,450,49,117,0.419,25,67,0.373,24,50,0.48,13,20,0.65,5,62,67,56,9,0,10,47,136,0.5,0.4,0.9,2020
Trevor Ariza,SF,35,30,841,99,241,0.411,50,143,0.35,49,98,0.5,34,44,0.773,27,117,144,55,31,18,21,55,282,0.5,1.0,1.6,2020
D.J. Augustin,PG,33,57,1129,135,343,0.394,83,217,0.382,52,126,0.413,85,94,0.904,20,74,94,188,28,1,65,56,438,1.5,0.5,2.1,2020
Deni Avdija,SF,20,54,1257,130,312,0.417,53,168,0.315,77,144,0.535,29,45,0.644,22,240,262,63,32,15,33,140,342,0.0,1.2,1.2,2020
Deandre Ayton,C,22,69,2115,430,687,0.626,4,20,0.2,426,667,0.639,133,173,0.769,228,499,727,99,41,81,103,196,997,5.3,3.1,8.4,2020
Udoka Azubuike,C,21,15,57,4,9,0.444,0,0,0.0,4,9,0.444,8,10,0.8,4,9,13,0,1,4,3,9,16,0.0,0.1,0.1,2020
Dwayne Bacon,SG,25,72,1853,292,726,0.402,59,207,0.285,233,519,0.449,145,176,0.824,31,193,224,93,45,5,46,103,788,-0.3,0.9,0.5,2020
Marvin Bagley III,PF,21,43,1112,247,490,0.504,37,108,0.343,210,382,0.55,77,134,0.575,106,212,318,43,21,21,59,100,608,0.9,0.5,1.4,2020
LaMelo Ball,PG,19,51,1469,293,672,0.436,92,261,0.352,201,411,0.489,125,165,0.758,63,239,302,313,81,18,145,136,803,1.0,1.9,2.8,2020
Lonzo Ball,PG,23,55,1747,290,700,0.414,172,455,0.378,118,245,0.482,50,64,0.781,33,230,263,316,82,31,123,103,802,1.5,1.7,3.2,2020
Mo Bamba,C,22,46,725,142,301,0.472,38,118,0.322,104,183,0.568,45,66,0.682,76,189,265,35,14,58,36,87,367,0.7,1.1,1.8,2020
Desmond Bane,SG,22,68,1519,234,499,0.469,117,271,0.432,117,228,0.513,40,49,0.816,31,179,210,118,41,16,59,125,625,1.6,1.3,2.9,2020
Harrison Barnes,PF,28,58,2102,319,642,0.497,100,256,0.391,219,386,0.567,195,235,0.83,64,321,385,201,43,11,93,75,933,4.0,0.5,4.5,2020
RJ Barrett,SG,20,72,2511,467,1060,0.441,124,309,0.401,343,751,0.457,206,276,0.746,68,346,414,217,53,20,139,188,1264,0.9,3.1,4.1,2020
Will Barton,SF,30,56,1736,259,608,0.426,98,257,0.381,161,351,0.459,95,121,0.785,39,187,226,181,50,23,96,95,711,0.7,1.5,2.2,2020
Keita Bates-Diop,SF,25,30,245,30,67,0.448,5,17,0.294,25,50,0.5,14,21,0.667,9,40,49,12,11,5,7,11,79,0.1,0.3,0.3,2020
Nicolas Batum,SF,32,67,1835,191,412,0.464,110,272,0.404,81,140,0.579,48,58,0.828,50,266,316,148,69,37,53,102,540,2.7,2.3,5.0,2020
Aron Baynes,C,34,53,980,134,304,0.441,27,103,0.262,107,201,0.532,29,41,0.707,87,186,273,47,17,23,46,119,324,0.1,0.9,1.0,2020
Kent Bazemore,SF,31,67,1333,176,392,0.449,75,184,0.408,101,208,0.486,54,78,0.692,26,203,229,108,69,33,82,158,481,-0.2,2.1,1.8,2020
Darius Bazley,PF,20,55,1714,273,690,0.396,83,286,0.29,190,404,0.47,125,178,0.702,51,345,396,99,29,25,122,60,754,-2.3,1.4,-0.9,2020
Bradley Beal,SG,27,60,2147,670,1382,0.485,130,373,0.349,540,1009,0.535,408,459,0.889,72,211,283,265,69,22,187,140,1878,4.2,1.7,5.9,2020
Malik Beasley,SG,24,37,1214,264,600,0.44,128,321,0.399,136,279,0.487,68,80,0.85,28,134,162,88,30,7,60,62,724,0.9,0.4,1.3,2020
Jordan Bell,C,26,6,82,7,22,0.318,0,2,0.0,7,20,0.35,1,2,0.5,7,17,24,7,3,5,4,7,15,-0.1,0.1,0.0,2020
DeAndre' Bembry,SF,26,51,972,117,228,0.513,14,53,0.264,103,175,0.589,45,66,0.682,33,113,146,107,53,18,71,87,293,0.1,1.1,1.2,2020
Dāvis Bertāns,PF,28,57,1464,193,478,0.404,169,428,0.395,24,50,0.48,100,115,0.87,18,150,168,49,33,13,33,136,655,2.1,1.0,3.1,2020
Patrick Beverley,PG,32,37,832,93,220,0.423,56,141,0.397,37,79,0.468,36,45,0.8,29,90,119,76,29,28,34,108,278,1.0,1.0,2.1,2020
Saddiq Bey,SF,21,70,1909,279,691,0.404,175,460,0.38,104,231,0.45,124,147,0.844,43,275,318,95,52,14,60,110,857,1.6,1.7,3.3,2020
Tyler Bey,SF,22,18,71,7,22,0.318,1,4,0.25,6,18,0.333,3,5,0.6,8,11,19,3,0,1,3,6,18,-0.1,0.0,0.0,2020
Khem Birch,C,28,67,1529,189,380,0.497,13,52,0.25,176,328,0.537,91,129,0.705,174,213,387,89,48,50,44,113,482,2.3,1.4,3.8,2020
Goga Bitadze,C,21,45,561,83,194,0.428,20,79,0.253,63,115,0.548,45,61,0.738,60,90,150,37,9,60,17,94,231,0.7,0.8,1.5,2020
Bismack Biyombo,C,28,66,1349,142,242,0.587,0,1,0.0,142,241,0.589,47,105,0.448,137,210,347,81,17,74,71,141,331,0.9,1.4,2.3,2020
Nemanja Bjelica,PF,32,37,595,89,196,0.454,27,85,0.318,62,111,0.559,37,51,0.725,29,98,127,69,15,5,33,68,242,0.5,0.3,0.9,2020
Eric Bledsoe,SG,31,71,2111,307,730,0.421,121,355,0.341,186,375,0.496,134,195,0.687,29,215,244,268,55,24,114,112,869,1.1,1.3,2.3,2020
Keljin Blevins,SF,25,17,75,5,20,0.25,2,8,0.25,3,12,0.25,0,0,0.0,3,7,10,4,2,0,5,8,12,-0.2,0.0,-0.2,2020
Bogdan Bogdanović,SG,28,44,1305,267,565,0.473,146,333,0.438,121,232,0.522,40,44,0.909,20,140,160,147,49,13,54,99,720,2.8,1.1,3.9,2020
Bojan Bogdanović,SF,31,72,2216,406,925,0.439,180,461,0.39,226,464,0.487,233,265,0.879,40,241,281,136,45,4,128,115,1225,2.7,2.5,5.2,2020
Bol Bol,PF,21,32,160,25,58,0.431,9,24,0.375,16,34,0.471,10,15,0.667,0,24,24,7,3,10,13,14,69,-0.2,0.2,0.0,2020
Marques Bolden,C,22,6,29,1,3,0.333,0,0,0.0,1,3,0.333,5,8,0.625,3,3,6,0,2,2,2,0,7,0.0,0.0,0.0,2020
Jordan Bone,PG,23,14,196,23,54,0.426,10,32,0.313,13,22,0.591,0,0,0.0,4,20,24,18,2,0,3,11,56,0.1,0.1,0.2,2020
Isaac Bonga,SF,21,40,432,30,81,0.37,13,47,0.277,17,34,0.5,5,8,0.625,18,48,66,23,11,9,22,63,78,-0.4,0.4,0.0,2020
Devin Booker,SG,24,67,2270,623,1287,0.484,126,371,0.34,497,916,0.543,340,392,0.867,34,247,281,289,53,16,207,181,1712,2.9,2.0,4.9,2020
Chris Boucher,C,28,60,1453,288,560,0.514,90,235,0.383,198,325,0.609,152,193,0.788,117,287,404,63,35,111,46,166,818,4.0,2.1,6.1,2020
Brian Bowen,SF,22,6,15,1,4,0.25,0,1,0.0,1,3,0.333,1,1,1.0,0,3,3,0,0,0,0,1,3,0.0,0.0,0.0,2020
Avery Bradley,SG,30,27,602,64,171,0.374,33,101,0.327,31,70,0.443,12,15,0.8,8,49,57,46,21,3,28,55,173,-0.5,0.4,-0.1,2020
Tony Bradley,C,23,42,684,131,197,0.665,0,3,0.0,131,194,0.675,38,55,0.691,85,154,239,37,15,30,33,61,300,1.8,1.0,2.7,2020
Jarrell Brantley,PF,24,28,138,25,52,0.481,12,28,0.429,13,24,0.542,2,2,1.0,9,18,27,15,7,2,8,17,64,0.3,0.2,0.5,2020
Ignas Brazdeikis,SF,22,13,249,35,83,0.422,11,28,0.393,24,55,0.436,10,14,0.714,11,34,45,17,4,3,12,22,91,-0.1,0.1,0.1,2020
Mikal Bridges,SF,24,72,2348,363,669,0.543,134,315,0.425,229,354,0.647,110,131,0.84,76,233,309,152,76,63,57,116,970,5.4,2.6,8.0,2020
Miles Bridges,PF,22,66,1932,313,622,0.503,116,290,0.4,197,332,0.593,98,113,0.867,81,316,397,147,44,52,106,143,840,2.4,1.9,4.2,2020
Amida Brimah,C,26,5,29,5,8,0.625,0,0,0.0,5,8,0.625,3,3,1.0,2,6,8,1,0,5,4,4,13,0.0,0.1,0.0,2020
Oshae Brissett,SF,22,21,519,73,151,0.483,33,78,0.423,40,73,0.548,50,65,0.769,29,86,115,18,19,20,10,32,229,1.2,0.6,1.8,2020
Malcolm Brogdon,PG,28,56,1930,444,980,0.453,145,374,0.388,299,606,0.493,153,177,0.864,58,236,294,329,49,15,115,110,1186,2.9,1.3,4.2,2020
Armoni Brooks,SG,22,20,520,78,192,0.406,60,157,0.382,18,35,0.514,7,12,0.583,10,58,68,30,12,5,22,34,223,0.1,0.2,0.3,2020
Dillon Brooks,SF,25,67,1997,432,1031,0.419,128,372,0.344,304,659,0.461,159,195,0.815,53,143,196,157,78,26,119,237,1151,-0.5,1.8,1.4,2020
Bruce Brown,PG,24,65,1451,235,423,0.556,17,59,0.288,218,364,0.599,86,117,0.735,111,238,349,104,58,28,54,145,573,2.8,1.5,4.4,2020
Charlie Brown Jr.,SG,23,9,152,13,43,0.302,5,21,0.238,8,22,0.364,9,10,0.9,3,14,17,9,4,2,6,19,40,-0.2,0.1,-0.1,2020
Jaylen Brown,SG,24,58,1999,538,1111,0.484,163,411,0.397,375,700,0.536,191,250,0.764,71,276,347,195,72,32,158,168,1430,2.8,2.0,4.8,2020
Moses Brown,C,21,43,920,146,268,0.545,0,0,0.0,146,268,0.545,78,126,0.619,154,229,383,10,31,47,43,93,370,1.3,1.3,2.6,2020
Sterling Brown,SG,25,51,1229,150,335,0.448,91,215,0.423,59,120,0.492,25,31,0.806,38,186,224,72,38,12,41,97,416,1.0,0.8,1.8,2020
Troy Brown Jr.,SF,21,34,524,62,144,0.431,22,70,0.314,40,74,0.541,15,21,0.714,20,85,105,29,10,6,21,49,161,0.0,0.5,0.5,2020
Jalen Brunson,PG,24,68,1697,328,627,0.523,81,200,0.405,247,427,0.578,120,151,0.795,27,204,231,239,35,1,80,109,857,3.9,1.1,5.1,2020
Elijah Bryant,SG,25,1,32,6,13,0.462,1,5,0.2,5,8,0.625,3,3,1.0,2,4,6,3,0,1,4,4,16,0.0,0.0,0.0,2020
Thomas Bryant,C,23,10,271,59,91,0.648,9,21,0.429,50,70,0.714,16,24,0.667,18,43,61,15,4,8,11,31,143,0.7,0.2,1.0,2020
Reggie Bullock,SF,29,65,1949,248,561,0.442,163,398,0.41,85,163,0.521,50,55,0.909,16,207,223,99,52,11,45,146,709,2.3,2.3,4.6,2020
Trey Burke,PG,28,62,911,151,353,0.428,58,164,0.354,93,189,0.492,51,57,0.895,10,44,54,81,36,7,33,64,411,0.7,0.7,1.4,2020
Alec Burks,SG,29,49,1255,210,500,0.42,102,246,0.415,108,254,0.425,101,118,0.856,21,206,227,107,31,14,49,102,623,1.5,1.8,3.3,2020
Jimmy Butler,SF,31,52,1745,366,736,0.497,25,102,0.245,341,634,0.538,359,416,0.863,94,265,359,369,108,18,109,71,1116,6.6,2.7,9.3,2020
Bruno Caboclo,PF,25,6,36,8,17,0.471,0,5,0.0,8,12,0.667,1,2,0.5,3,11,14,1,0,2,4,6,17,-0.1,0.0,-0.1,2020
Devontae Cacok,PF,24,20,98,17,29,0.586,0,0,0.0,17,29,0.586,5,11,0.455,12,20,32,1,5,4,5,8,39,0.1,0.2,0.3,2020
Kentavious Caldwell-Pope,SG,27,67,1902,218,506,0.431,120,293,0.41,98,213,0.46,97,112,0.866,27,152,179,127,62,26,66,114,653,1.6,2.6,4.2,2020
Facundo Campazzo,PG,29,65,1425,120,315,0.381,76,216,0.352,44,99,0.444,80,91,0.879,22,112,134,232,79,14,73,132,396,1.6,1.5,3.1,2020
Vlatko Čančar,PF,23,41,281,33,72,0.458,9,33,0.273,24,39,0.615,10,13,0.769,11,39,50,14,11,2,14,18,85,0.0,0.3,0.3,2020
Devin Cannady,PG,24,8,74,11,28,0.393,6,16,0.375,5,12,0.417,6,7,0.857,0,5,5,1,5,1,2,9,34,0.0,0.1,0.1,2020
Clint Capela,C,26,63,1898,413,695,0.594,0,0,0.0,413,695,0.594,130,227,0.573,297,606,903,49,44,129,73,145,956,4.9,3.3,8.2,2020
Vernon Carey Jr.,C,19,19,115,18,36,0.5,1,7,0.143,17,29,0.586,9,11,0.818,6,21,27,2,1,5,5,13,46,0.0,0.1,0.2,2020
Jevon Carter,PG,25,60,717,94,223,0.422,56,151,0.371,38,72,0.528,4,7,0.571,16,76,92,71,29,9,16,56,248,0.7,0.8,1.6,2020
Wendell Carter Jr.,C,21,54,1375,230,457,0.503,15,51,0.294,215,406,0.53,131,179,0.732,132,311,443,104,35,42,78,146,606,1.7,1.7,3.4,2020
Michael Carter-Williams,SG,29,31,800,105,270,0.389,15,61,0.246,90,209,0.431,49,80,0.613,39,100,139,129,25,17,69,81,274,-1.1,0.6,-0.5,2020
Alex Caruso,PG,26,58,1216,133,305,0.436,55,137,0.401,78,168,0.464,49,76,0.645,31,139,170,160,64,15,76,108,370,0.3,2.1,2.4,2020
Willie Cauley-Stein,C,27,53,906,115,182,0.632,1,11,0.091,114,171,0.667,49,78,0.628,66,170,236,35,21,43,29,129,280,1.6,1.2,2.8,2020
Chris Chiozza,PG,25,22,232,31,88,0.352,13,42,0.31,18,46,0.391,13,17,0.765,3,21,24,65,7,6,16,19,88,0.1,0.2,0.3,2020
Marquese Chriss,PF,23,2,27,5,14,0.357,1,5,0.2,4,9,0.444,2,4,0.5,3,10,13,2,0,2,2,3,13,-0.1,0.1,0.0,2020
Gary Clark,SF,26,39,654,40,132,0.303,31,108,0.287,9,24,0.375,8,10,0.8,33,82,115,31,13,7,17,35,119,-0.3,0.4,0.1,2020
Brandon Clarke,PF,24,59,1415,256,495,0.517,20,77,0.26,236,418,0.565,78,113,0.69,97,231,328,95,60,51,33,84,610,2.2,2.0,4.2,2020
Jordan Clarkson,SG,28,68,1818,457,1075,0.425,208,599,0.347,249,476,0.523,129,144,0.896,47,227,274,168,61,10,115,110,1251,1.7,2.5,4.2,2020
Nic Claxton,C,21,32,594,90,145,0.621,1,5,0.2,89,140,0.636,31,64,0.484,43,123,166,28,23,40,18,68,212,1.0,0.9,1.9,2020
Amir Coffey,SG,23,44,394,45,103,0.437,23,56,0.411,22,47,0.468,27,38,0.711,10,34,44,22,10,0,15,30,140,0.4,0.3,0.7,2020
John Collins,PF,23,63,1848,429,771,0.556,83,208,0.399,346,563,0.615,170,204,0.833,118,349,467,78,34,63,84,193,1111,4.8,1.9,6.7,2020
Mike Conley,PG,33,51,1498,284,640,0.444,138,335,0.412,146,305,0.479,121,142,0.852,36,141,177,305,70,9,99,98,827,4.0,2.1,6.1,2020
Pat Connaughton,SG,28,69,1575,168,387,0.434,101,272,0.371,67,115,0.583,31,40,0.775,63,269,332,81,49,23,33,99,468,1.8,1.7,3.5,2020
Quinn Cook,PG,27,23,157,29,68,0.426,11,26,0.423,18,42,0.429,7,8,0.875,2,15,17,18,4,1,7,10,76,0.1,0.1,0.2,2020
Tyler Cook,SF,23,32,438,69,103,0.67,1,2,0.5,68,101,0.673,17,35,0.486,28,67,95,17,8,2,21,35,156,0.5,0.3,0.8,2020
DeMarcus Cousins,C,30,41,713,130,305,0.426,47,135,0.348,83,170,0.488,59,81,0.728,53,210,263,76,34,24,64,107,366,0.0,1.2,1.2,2020
Robert Covington,PF,30,70,2243,204,509,0.401,135,356,0.379,69,153,0.451,50,62,0.806,61,405,466,117,101,84,64,195,593,1.4,2.4,3.7,2020
Torrey Craig,SF,30,50,803,109,227,0.48,39,106,0.368,70,121,0.579,17,22,0.773,57,140,197,49,28,26,25,83,274,1.1,1.1,2.2,2020
Jae Crowder,PF,30,60,1648,199,492,0.404,148,380,0.389,51,112,0.455,57,75,0.76,32,250,282,127,48,27,55,125,603,1.4,1.9,3.3,2020
Jarrett Culver,SG,21,34,499,69,168,0.411,13,53,0.245,56,115,0.487,29,48,0.604,34,70,104,24,17,9,28,58,180,-0.4,0.3,-0.1,2020
Seth Curry,SG,30,57,1638,258,552,0.467,126,280,0.45,132,272,0.485,69,77,0.896,10,126,136,155,44,8,65,96,711,2.3,1.7,4.0,2020
Stephen Curry,PG,32,63,2152,658,1365,0.482,337,801,0.421,321,564,0.569,362,395,0.916,29,316,345,363,77,8,213,119,2015,6.5,2.5,9.0,2020
Nate Darling,SG,22,7,26,2,7,0.286,2,7,0.286,0,0,0.0,3,3,1.0,1,0,1,1,0,1,1,1,9,0.0,0.0,0.0,2020
Anthony Davis,PF,27,36,1162,301,613,0.491,26,100,0.26,275,513,0.536,158,214,0.738,62,224,286,110,45,59,74,60,786,1.3,2.4,3.7,2020
Ed Davis,C,31,23,299,19,44,0.432,0,0,0.0,19,44,0.432,10,12,0.833,46,69,115,21,13,13,7,56,48,0.5,0.4,0.8,2020
Terence Davis,SG,23,61,1074,195,456,0.428,98,267,0.367,97,189,0.513,45,55,0.818,20,134,154,83,44,14,63,97,533,0.1,0.8,0.8,2020
Gabriel Deck,PF,25,10,212,32,67,0.478,2,15,0.133,30,52,0.577,18,22,0.818,16,24,40,24,8,0,6,9,84,0.4,0.1,0.5,2020
Dewayne Dedmon,C,31,16,210,46,65,0.708,1,5,0.2,45,60,0.75,20,27,0.741,28,58,86,12,9,6,13,36,113,0.7,0.4,1.1,2020
Matthew Dellavedova,PG,30,13,224,14,56,0.25,4,25,0.16,10,31,0.323,4,4,1.0,6,18,24,58,4,1,6,21,36,-0.1,0.1,0.0,2020
DeMar DeRozan,PF,31,61,2056,455,920,0.495,19,74,0.257,436,846,0.515,387,440,0.88,40,219,259,422,56,15,119,128,1316,5.9,1.5,7.4,2020
Mamadi Diakite,PF,24,14,141,16,40,0.4,1,8,0.125,15,32,0.469,11,14,0.786,8,26,34,8,7,6,3,16,44,0.1,0.2,0.3,2020
Hamidou Diallo,SG,22,52,1226,224,470,0.477,28,82,0.341,196,388,0.505,128,200,0.64,59,213,272,101,41,24,76,134,604,0.3,1.3,1.6,2020
Gorgui Dieng,C,31,38,552,85,163,0.521,30,70,0.429,55,93,0.591,58,67,0.866,40,100,140,48,26,16,32,56,258,1.3,0.8,2.1,2020
Spencer Dinwiddie,SG,27,3,64,6,16,0.375,2,7,0.286,4,9,0.444,6,6,1.0,0,13,13,9,2,1,5,4,20,0.0,0.1,0.1,2020
Donte DiVincenzo,SG,24,66,1814,253,603,0.42,131,346,0.379,122,257,0.475,51,71,0.718,81,299,380,203,72,15,91,112,688,1.5,2.1,3.6,2020
Luka Dončić,PG,21,66,2262,647,1351,0.479,192,548,0.35,455,803,0.567,344,471,0.73,54,473,527,567,64,36,281,152,1830,5.1,2.6,7.7,2020
Luguentz Dort,SG,21,52,1543,247,639,0.387,113,329,0.343,134,310,0.432,122,164,0.744,38,151,189,88,45,19,79,134,729,-0.6,1.0,0.3,2020
Damyean Dotson,SG,26,46,907,119,293,0.406,46,159,0.289,73,134,0.545,24,36,0.667,5,88,93,91,16,4,42,42,308,-0.4,0.3,0.0,2020
Devon Dotson,PG,21,11,50,11,21,0.524,1,7,0.143,10,14,0.714,0,0,0.0,2,3,5,7,4,0,0,3,23,0.1,0.1,0.2,2020
Sekou Doumbouya,PF,20,56,869,107,282,0.379,26,115,0.226,81,167,0.485,45,64,0.703,39,104,143,47,24,9,44,94,285,-0.9,0.7,-0.2,2020
PJ Dozier,SG,24,50,1088,148,355,0.417,47,149,0.315,101,206,0.49,42,66,0.636,35,147,182,92,31,22,46,86,385,0.1,1.1,1.1,2020
Goran Dragić,PG,34,50,1337,240,555,0.432,91,244,0.373,149,311,0.479,101,122,0.828,25,144,169,219,33,8,118,113,672,0.2,1.2,1.3,2020
Andre Drummond,C,27,46,1242,282,572,0.493,0,8,0.0,282,564,0.5,123,205,0.6,166,385,551,94,63,49,124,149,687,-0.6,2.5,2.0,2020
Jared Dudley,PF,35,12,81,2,9,0.222,2,6,0.333,0,3,0.0,0,0,0.0,4,17,21,5,1,1,2,7,6,0.0,0.1,0.1,2020
Kris Dunn,PG,26,4,45,1,12,0.083,0,2,0.0,1,10,0.1,3,4,0.75,0,6,6,2,2,2,3,10,5,-0.2,0.1,-0.2,2020
Kevin Durant,PF,32,35,1157,324,603,0.537,85,189,0.45,239,414,0.577,210,238,0.882,13,234,247,195,25,45,120,70,943,3.7,1.2,5.0,2020
Anthony Edwards,SG,19,72,2314,505,1211,0.417,171,520,0.329,334,691,0.483,211,272,0.776,59,277,336,211,82,36,160,129,1392,-0.6,1.4,0.8,2020
Carsen Edwards,SG,22,31,276,47,111,0.423,18,63,0.286,29,48,0.604,11,13,0.846,3,23,26,14,7,1,7,25,123,0.1,0.2,0.3,2020
CJ Elleby,SF,20,30,192,25,66,0.379,7,34,0.206,18,32,0.563,11,15,0.733,11,21,32,10,6,3,5,27,68,0.0,0.1,0.1,2020
Henry Ellenson,PF,24,2,38,5,14,0.357,2,9,0.222,3,5,0.6,3,4,0.75,3,9,12,5,0,0,0,7,15,0.1,0.0,0.1,2020
Wayne Ellington,SG,33,46,1012,149,338,0.441,116,275,0.422,33,63,0.524,28,35,0.8,12,73,85,67,18,9,33,59,442,1.3,0.5,1.9,2020
Joel Embiid,C,26,51,1585,461,899,0.513,58,154,0.377,403,745,0.541,471,548,0.859,113,426,539,145,50,69,159,123,1451,5.6,3.2,8.8,2020
James Ennis III,SF,30,41,986,115,243,0.473,45,104,0.433,70,139,0.504,70,87,0.805,43,123,166,62,32,7,36,84,345,1.3,0.7,2.0,2020
Drew Eubanks,C,23,54,755,116,205,0.566,2,2,1.0,114,203,0.562,77,106,0.726,74,167,241,42,18,49,45,88,311,1.2,1.1,2.3,2020
Dante Exum,SG,25,6,116,10,26,0.385,2,11,0.182,8,15,0.533,1,2,0.5,2,15,17,13,4,2,7,9,23,-0.2,0.1,-0.1,2020
Tacko Fall,C,25,19,136,21,29,0.724,0,0,0.0,21,29,0.724,5,15,0.333,16,36,52,3,1,20,6,22,47,0.2,0.3,0.5,2020
Derrick Favors,C,29,68,1039,155,243,0.638,0,2,0.0,155,241,0.643,59,80,0.738,138,238,376,44,32,68,36,143,369,2.9,2.2,5.1,2020
Cristiano Felício,C,28,18,84,7,13,0.538,0,2,0.0,7,11,0.636,9,16,0.563,10,16,26,9,4,0,4,10,23,0.2,0.1,0.3,2020
Terrance Ferguson,SG,22,13,49,1,7,0.143,0,5,0.0,1,2,0.5,0,0,0.0,0,1,1,2,1,0,4,7,2,-0.2,0.0,-0.2,2020
Bruno Fernando,C,22,33,226,18,44,0.409,0,2,0.0,18,42,0.429,15,22,0.682,16,62,78,10,4,3,21,23,51,-0.3,0.3,-0.1,2020
Yogi Ferrell,PG,27,10,136,20,57,0.351,9,28,0.321,11,29,0.379,7,9,0.778,5,14,19,22,7,3,3,11,56,0.1,0.2,0.3,2020
Dorian Finney-Smith,PF,27,60,1921,220,466,0.472,119,302,0.394,101,164,0.616,31,41,0.756,98,228,326,102,52,25,48,138,590,2.8,1.6,4.4,2020
Malik Fitts,PF,23,3,11,1,3,0.333,1,2,0.5,0,1,0.0,0,0,0.0,0,3,3,0,0,0,0,3,3,0.0,0.0,0.0,2020
Malachi Flynn,PG,22,47,928,127,340,0.374,54,168,0.321,73,172,0.424,45,56,0.804,10,106,116,137,38,7,43,68,353,0.0,0.8,0.8,2020
Bryn Forbes,SG,27,70,1354,250,529,0.473,154,341,0.452,96,188,0.511,47,61,0.77,11,101,112,45,24,1,44,77,701,2.0,0.7,2.7,2020
Trent Forrest,PG,22,30,302,32,71,0.451,5,26,0.192,27,45,0.6,19,19,1.0,11,33,44,45,9,4,21,22,88,0.3,0.4,0.7,2020
Evan Fournier,SF,28,42,1259,247,541,0.457,117,283,0.413,130,258,0.504,108,137,0.788,10,118,128,144,47,19,73,96,719,1.8,1.0,2.8,2020
De'Aaron Fox,PG,23,58,2036,529,1110,0.477,103,320,0.322,426,790,0.539,300,417,0.719,33,170,203,417,87,27,174,170,1461,3.4,0.8,4.2,2020
Robert Franks,PF,24,7,101,13,28,0.464,5,15,0.333,8,13,0.615,12,13,0.923,6,8,14,5,3,3,2,8,43,0.3,0.1,0.3,2020
Tim Frazier,PG,30,5,62,3,20,0.15,0,8,0.0,3,12,0.25,2,6,0.333,0,8,8,16,2,1,4,7,8,-0.3,0.1,-0.2,2020
Enes Freedom,C,28,72,1758,339,561,0.604,1,4,0.25,338,557,0.607,127,164,0.774,284,511,795,84,33,48,78,168,806,5.7,1.7,7.5,2020
Markelle Fultz,PG,22,8,215,41,104,0.394,4,16,0.25,37,88,0.42,17,19,0.895,5,20,25,43,8,2,18,18,103,-0.3,0.1,-0.1,2020
Wenyen Gabriel,PF,23,21,241,24,60,0.4,13,32,0.406,11,28,0.393,11,17,0.647,20,34,54,11,9,8,15,32,72,0.0,0.3,0.3,2020
Daniel Gafford,C,22,54,791,154,225,0.684,0,0,0.0,154,225,0.684,72,108,0.667,94,137,231,29,26,75,41,98,380,2.1,1.3,3.5,2020
Danilo Gallinari,PF,32,51,1222,206,475,0.434,103,254,0.406,103,221,0.466,161,174,0.925,17,194,211,76,30,10,43,105,676,2.7,1.0,3.7,2020
Langston Galloway,SG,29,40,438,66,147,0.449,36,85,0.424,30,62,0.484,22,23,0.957,7,35,42,26,8,0,13,25,190,0.6,0.3,0.9,2020
Darius Garland,PG,21,54,1790,362,802,0.451,105,266,0.395,257,536,0.479,112,132,0.848,23,106,129,329,66,6,164,110,941,0.3,0.9,1.2,2020
Marc Gasol,C,36,52,993,88,194,0.454,50,122,0.41,38,72,0.528,36,50,0.72,38,177,215,109,26,58,53,115,262,0.8,1.9,2.8,2020
Rudy Gay,PF,34,63,1358,264,628,0.42,106,278,0.381,158,350,0.451,82,102,0.804,42,261,303,88,45,40,65,115,716,0.0,1.7,1.7,2020
Paul George,SF,30,54,1821,445,953,0.467,171,416,0.411,274,537,0.51,198,228,0.868,45,314,359,280,62,24,179,132,1259,3.0,2.3,5.3,2020
Taj Gibson,C,35,45,936,99,158,0.627,3,15,0.2,96,143,0.671,40,55,0.727,99,151,250,36,31,49,22,99,241,2.1,1.7,3.8,2020
Harry Giles,C,22,38,348,42,97,0.433,8,23,0.348,34,74,0.459,16,27,0.593,31,102,133,29,8,13,20,54,108,0.1,0.4,0.5,2020
Shai Gilgeous-Alexander,SG,22,35,1180,287,565,0.508,71,170,0.418,216,395,0.547,185,229,0.808,19,147,166,207,27,23,106,70,830,2.7,0.8,3.5,2020
Anthony Gill,PF,28,26,218,30,60,0.5,7,24,0.292,23,36,0.639,13,16,0.813,16,35,51,11,10,4,8,27,80,0.3,0.3,0.6,2020
Freddie Gillespie,PF,23,20,392,44,84,0.524,0,0,0.0,44,84,0.524,23,33,0.697,42,55,97,9,13,20,12,43,111,0.5,0.5,0.9,2020
Rudy Gobert,C,28,71,2187,391,579,0.675,0,4,0.0,391,575,0.68,233,374,0.623,240,720,960,89,40,190,118,163,1015,6.1,5.2,11.3,2020
Brandon Goodwin,PG,25,47,620,84,223,0.377,32,103,0.311,52,120,0.433,28,43,0.651,8,61,69,95,17,0,36,41,228,-0.2,0.4,0.2,2020
Aaron Gordon,PF,25,50,1384,231,499,0.463,59,176,0.335,172,323,0.533,97,149,0.651,77,207,284,161,33,34,97,89,618,0.7,1.2,1.9,2020
Eric Gordon,SG,32,27,789,159,367,0.433,69,210,0.329,90,157,0.573,94,114,0.825,8,50,58,71,14,13,51,44,481,0.6,0.2,0.8,2020
Devonte' Graham,PG,25,55,1659,252,669,0.377,179,477,0.375,73,192,0.38,133,158,0.842,22,126,148,295,48,6,84,77,816,2.5,0.9,3.4,2020
Jerami Grant,SF,26,54,1829,400,932,0.429,115,329,0.35,285,603,0.473,290,343,0.845,35,215,250,152,35,58,109,125,1205,1.6,1.6,3.2,2020
Danny Green,SF,33,69,1934,224,544,0.412,175,432,0.405,49,112,0.438,31,40,0.775,55,205,260,118,92,56,67,125,654,1.6,3.1,4.6,2020
Draymond Green,PF,30,63,1982,170,380,0.447,34,126,0.27,136,254,0.535,70,88,0.795,55,394,449,558,105,52,188,194,444,1.2,3.4,4.6,2020
JaMychal Green,PF,30,58,1120,173,374,0.463,79,198,0.399,94,176,0.534,46,57,0.807,85,192,277,53,26,22,53,144,471,1.4,1.2,2.6,2020
Javonte Green,SF,27,41,473,53,102,0.52,10,30,0.333,43,72,0.597,30,40,0.75,26,45,71,17,28,6,19,45,146,0.5,0.6,1.1,2020
Jeff Green,PF,34,68,1835,261,530,0.492,103,250,0.412,158,280,0.564,125,161,0.776,34,229,263,108,36,27,54,122,750,2.9,1.2,4.1,2020
Josh Green,SG,20,39,445,42,93,0.452,4,25,0.16,38,68,0.559,13,23,0.565,28,50,78,28,16,3,17,35,101,0.1,0.4,0.5,2020
Blake Griffin,PF,31,46,1186,174,411,0.423,70,205,0.341,104,206,0.505,87,117,0.744,35,190,225,140,32,15,62,111,505,0.9,1.1,2.0,2020
Kyle Guy,PG,23,31,235,29,88,0.33,13,46,0.283,16,42,0.381,16,20,0.8,5,30,35,32,6,0,11,20,87,-0.1,0.1,-0.1,2020
Rui Hachimura,PF,22,57,1797,310,648,0.478,45,137,0.328,265,511,0.519,124,161,0.77,49,263,312,82,44,7,68,120,789,0.7,1.4,2.1,2020
Ashton Hagans,PG,21,2,4,0,0,0.0,0,0,0.0,0,0,0.0,0,0,0.0,0,0,0,0,0,0,1,0,0,0.0,0.0,0.0,2020
Tyrese Haliburton,PG,20,58,1746,292,619,0.472,121,296,0.409,171,323,0.529,48,56,0.857,39,134,173,309,77,28,92,83,753,2.8,0.7,3.5,2020
Donta Hall,PF,23,13,179,25,35,0.714,0,0,0.0,25,35,0.714,23,34,0.676,24,38,62,11,5,10,8,18,73,0.6,0.2,0.8,2020
Josh Hall,SF,20,21,336,30,99,0.303,4,37,0.108,26,62,0.419,22,44,0.5,6,53,59,28,4,1,25,37,86,-1.1,0.2,-0.9,2020
R.J. Hampton,SG,19,51,888,136,313,0.435,27,87,0.31,109,226,0.482,55,82,0.671,29,150,179,87,21,10,53,61,354,-0.3,0.7,0.4,2020
Tim Hardaway Jr.,SG,28,70,1985,407,911,0.447,207,529,0.391,200,382,0.524,142,174,0.816,20,209,229,126,31,11,64,111,1163,3.2,1.2,4.3,2020
James Harden,PG,31,44,1609,342,734,0.466,121,334,0.362,221,400,0.553,278,323,0.861,35,313,348,475,53,33,177,99,1083,5.3,1.7,7.0,2020
Maurice Harkless,PF,27,37,772,69,165,0.418,23,84,0.274,46,81,0.568,33,43,0.767,13,76,89,44,30,20,22,86,194,0.2,0.4,0.6,2020
Jared Harper,PG,23,8,16,0,4,0.0,0,1,0.0,0,3,0.0,3,4,0.75,0,2,2,1,0,0,3,1,3,-0.1,0.0,-0.1,2020
Montrezl Harrell,C,27,69,1580,375,603,0.622,0,10,0.0,375,593,0.632,181,256,0.707,158,270,428,73,46,49,74,128,931,4.5,2.7,7.3,2020
Gary Harris,SG,26,39,1080,138,345,0.4,48,141,0.34,90,204,0.441,64,78,0.821,21,58,79,78,28,11,37,71,388,0.2,0.6,0.7,2020
Jalen Harris,SG,22,13,172,36,72,0.5,17,36,0.472,19,36,0.528,7,9,0.778,3,15,18,17,8,0,14,15,96,0.1,0.1,0.3,2020
Joe Harris,SF,29,69,2141,357,707,0.505,211,444,0.475,146,263,0.555,49,63,0.778,43,205,248,130,46,14,62,141,974,4.1,1.1,5.2,2020
Tobias Harris,PF,28,62,2014,473,924,0.512,82,208,0.394,391,716,0.546,182,204,0.892,62,357,419,220,55,51,107,119,1210,4.1,3.1,7.1,2020
Shaquille Harrison,SG,27,34,333,26,78,0.333,3,16,0.188,23,62,0.371,18,22,0.818,7,41,48,25,17,5,11,33,73,-0.2,0.4,0.2,2020
Josh Hart,SF,25,47,1349,151,344,0.439,63,193,0.326,88,151,0.583,69,89,0.775,53,324,377,109,38,12,49,111,434,1.4,1.3,2.7,2020
Isaiah Hartenstein,C,22,46,559,94,171,0.55,2,6,0.333,92,165,0.558,46,71,0.648,65,116,181,55,19,39,44,104,236,0.7,0.9,1.6,2020
Udonis Haslem,C,40,1,3,2,2,1.0,0,0,0.0,2,2,1.0,0,0,0.0,0,1,1,0,0,0,0,0,4,0.0,0.0,0.0,2020
Jaxson Hayes,C,20,60,964,175,280,0.625,6,14,0.429,169,266,0.635,93,120,0.775,92,165,257,35,25,38,39,101,449,2.6,1.0,3.5,2020
Killian Hayes,PG,19,26,670,71,201,0.353,20,72,0.278,51,129,0.395,14,17,0.824,6,63,69,138,27,10,83,57,176,-1.8,0.6,-1.1,2020
Gordon Hayward,SF,30,44,1496,311,658,0.473,85,205,0.415,226,453,0.499,156,185,0.843,37,221,258,181,52,14,91,74,863,2.2,1.4,3.5,2020
Juancho Hernangómez,PF,25,52,900,130,299,0.435,55,168,0.327,75,131,0.573,60,97,0.619,45,160,205,35,19,7,27,52,375,0.6,0.5,1.1,2020
Willy Hernangómez,C,26,47,846,151,268,0.563,1,10,0.1,150,258,0.581,62,93,0.667,117,217,334,50,22,23,34,68,365,1.9,1.0,2.9,2020
Tyler Herro,SG,21,54,1635,307,699,0.439,107,297,0.36,200,402,0.498,94,117,0.803,25,243,268,184,35,17,101,71,815,0.1,1.6,1.7,2020
Buddy Hield,SG,28,71,2433,403,992,0.406,282,721,0.391,121,271,0.446,88,104,0.846,29,305,334,257,63,30,130,175,1176,1.5,0.7,2.2,2020
George Hill,PG,34,30,672,95,197,0.482,31,80,0.388,64,117,0.547,40,50,0.8,16,45,61,73,23,5,31,31,261,0.9,0.6,1.4,2020
Solomon Hill,PF,29,71,1513,107,298,0.359,68,212,0.321,39,86,0.453,35,46,0.761,42,172,214,75,50,11,42,116,317,0.1,1.2,1.3,2020
Nate Hinton,SG,21,21,93,15,42,0.357,4,19,0.211,11,23,0.478,7,10,0.7,1,8,9,8,7,2,5,8,41,-0.2,0.1,0.0,2020
Jaylen Hoard,SF,21,19,320,44,88,0.5,0,11,0.0,44,77,0.571,28,41,0.683,21,44,65,24,13,5,17,19,116,0.2,0.3,0.5,2020
Aaron Holiday,PG,24,66,1176,170,436,0.39,67,182,0.368,103,254,0.406,68,83,0.819,15,74,89,123,46,13,66,94,475,-0.6,0.8,0.2,2020
Jrue Holiday,PG,30,59,1907,414,823,0.503,111,283,0.392,303,540,0.561,107,136,0.787,73,195,268,357,96,37,127,98,1046,4.3,2.2,6.6,2020
Justin Holiday,SG,31,72,2183,258,625,0.413,173,453,0.382,85,172,0.494,67,85,0.788,32,224,256,119,74,41,54,135,756,1.4,1.8,3.1,2020
Rondae Hollis-Jefferson,PF,26,11,107,9,18,0.5,0,1,0.0,9,17,0.529,9,16,0.563,11,15,26,13,2,4,2,15,27,0.3,0.1,0.3,2020
Richaun Holmes,C,27,61,1782,366,575,0.637,2,11,0.182,364,564,0.645,135,170,0.794,144,360,504,101,39,96,75,213,869,4.7,1.4,6.1,2020
Rodney Hood,SF,28,55,942,94,260,0.362,34,113,0.301,60,147,0.408,24,28,0.857,23,80,103,53,24,7,36,74,246,-0.7,0.3,-0.4,2020
Al Horford,C,34,28,782,162,360,0.45,56,152,0.368,106,208,0.51,18,22,0.818,29,159,188,94,25,26,29,48,398,0.8,0.9,1.6,2020
Talen Horton-Tucker,SG,20,65,1304,224,489,0.458,37,131,0.282,187,358,0.522,100,129,0.775,25,144,169,181,63,21,105,127,585,-0.1,2.2,2.1,2020
Danuel House Jr.,SF,27,36,932,110,272,0.404,54,156,0.346,56,116,0.483,41,63,0.651,18,114,132,69,20,16,36,67,315,0.0,0.5,0.5,2020
Dwight Howard,C,35,69,1196,178,303,0.587,5,20,0.25,173,283,0.611,121,210,0.576,190,390,580,61,30,62,112,200,482,1.3,2.6,4.0,2020
Markus Howard,SG,21,37,205,40,106,0.377,18,65,0.277,22,41,0.537,7,9,0.778,1,20,21,18,4,1,18,23,105,-0.4,0.1,-0.3,2020
Kevin Huerter,SG,22,69,2126,316,731,0.432,140,386,0.363,176,345,0.51,50,64,0.781,38,193,231,241,82,18,79,165,822,1.9,1.7,3.6,2020
Elijah Hughes,SF,22,18,64,10,30,0.333,8,23,0.348,2,7,0.286,3,4,0.75,1,8,9,6,1,1,6,1,31,-0.1,0.1,0.0,2020
De'Andre Hunter,SF,23,23,678,120,248,0.484,31,95,0.326,89,153,0.582,73,85,0.859,17,93,110,44,19,12,29,59,344,1.2,0.6,1.7,2020
Chandler Hutchison,SF,24,25,346,39,103,0.379,8,22,0.364,31,81,0.383,21,25,0.84,6,72,78,17,12,5,20,33,107,-0.5,0.4,-0.1,2020
Serge Ibaka,C,31,41,955,186,365,0.51,39,115,0.339,147,250,0.588,43,53,0.811,73,202,275,74,9,47,44,76,454,1.7,1.3,3.0,2020
Andre Iguodala,SF,37,63,1339,95,248,0.383,60,182,0.33,35,66,0.53,25,38,0.658,38,183,221,142,57,35,67,90,275,-0.1,1.8,1.7,2020
Ersan İlyasova,PF,33,17,148,21,54,0.389,18,41,0.439,3,13,0.231,5,5,1.0,7,22,29,4,10,3,8,29,65,0.1,0.3,0.4,2020
Joe Ingles,SF,33,67,1867,275,562,0.489,183,406,0.451,92,156,0.59,76,90,0.844,27,217,244,318,45,12,117,120,809,4.7,2.3,7.0,2020
Brandon Ingram,SF,23,61,2093,513,1101,0.466,143,375,0.381,370,726,0.51,281,320,0.878,34,265,299,296,42,36,154,124,1450,3.9,1.3,5.3,2020
Kyrie Irving,PG,28,54,1886,549,1086,0.506,152,378,0.402,397,708,0.561,201,218,0.922,52,205,257,324,76,37,130,140,1451,5.8,1.6,7.4,2020
Wes Iwundu,SF,26,41,539,34,102,0.333,5,41,0.122,29,61,0.475,26,31,0.839,15,75,90,18,15,4,19,49,99,-0.5,0.4,0.0,2020
Frank Jackson,PG,22,40,738,134,293,0.457,61,150,0.407,73,143,0.51,61,75,0.813,15,71,86,36,15,1,34,53,390,0.7,0.4,1.2,2020
Jaren Jackson Jr.,C,21,11,258,53,125,0.424,17,60,0.283,36,65,0.554,35,42,0.833,17,45,62,12,12,18,15,42,158,0.2,0.5,0.7,2020
Josh Jackson,SG,23,62,1560,296,707,0.419,77,257,0.3,219,450,0.487,159,218,0.729,57,197,254,143,53,47,142,178,828,-1.6,1.7,0.1,2020
Justin Jackson,SF,25,34,577,89,221,0.403,36,117,0.308,53,104,0.51,31,37,0.838,16,61,77,52,15,2,32,32,245,-0.1,0.3,0.2,2020
Reggie Jackson,SG,30,67,1544,263,585,0.45,122,282,0.433,141,303,0.465,67,82,0.817,24,168,192,205,41,7,74,127,715,2.3,1.4,3.7,2020
Justin James,SF,24,36,310,52,111,0.468,14,38,0.368,38,73,0.521,21,36,0.583,9,21,30,22,8,3,15,23,139,0.1,0.0,0.1,2020
LeBron James,PG,36,45,1504,422,823,0.513,104,285,0.365,318,538,0.591,178,255,0.698,29,317,346,350,48,25,168,70,1126,3.0,2.6,5.6,2020
Mike James,PG,30,13,236,34,92,0.37,11,31,0.355,23,61,0.377,21,27,0.778,3,29,32,54,6,1,20,10,100,0.0,0.1,0.1,2020
DaQuan Jeffries,SG,23,31,493,50,120,0.417,20,67,0.299,30,53,0.566,7,8,0.875,19,52,71,22,15,10,14,48,127,0.0,0.2,0.3,2020
Ty Jerome,SG,23,33,788,128,287,0.446,71,168,0.423,57,119,0.479,26,34,0.765,10,81,91,120,20,6,47,61,353,0.9,0.4,1.3,2020
Isaiah Joe,SG,21,41,383,48,133,0.361,39,106,0.368,9,27,0.333,18,24,0.75,6,30,36,20,12,4,11,34,153,0.2,0.4,0.6,2020
Alize Johnson,PF,24,18,189,40,68,0.588,1,6,0.167,39,62,0.629,13,13,1.0,27,63,90,14,5,5,9,16,94,0.6,0.3,0.9,2020
Cameron Johnson,PF,24,60,1437,203,483,0.42,117,335,0.349,86,148,0.581,50,59,0.847,33,166,199,86,37,16,40,85,573,1.2,1.4,2.6,2020
James Johnson,PF,33,51,1043,146,327,0.446,31,120,0.258,115,207,0.556,45,76,0.592,32,145,177,98,42,42,55,120,368,-0.1,1.3,1.2,2020
Keldon Johnson,SF,21,69,1968,338,705,0.479,60,181,0.331,278,524,0.531,145,196,0.74,93,319,412,121,40,24,78,142,881,1.6,1.7,3.3,2020
Stanley Johnson,PF,24,61,1006,89,233,0.382,45,137,0.328,44,96,0.458,44,55,0.8,29,124,153,89,52,18,54,116,267,-0.1,1.1,1.0,2020
Tyler Johnson,SG,28,39,684,72,183,0.393,48,132,0.364,24,51,0.471,18,21,0.857,6,71,77,47,14,0,17,43,210,0.4,0.3,0.7,2020
Nikola Jokić,C,25,72,2488,732,1293,0.566,92,237,0.388,640,1056,0.606,342,394,0.868,205,575,780,599,95,48,222,192,1898,12.2,3.4,15.6,2020
Damian Jones,C,25,39,547,70,103,0.68,1,5,0.2,69,98,0.704,42,58,0.724,36,85,121,29,11,29,26,77,183,1.0,0.5,1.6,2020
Derrick Jones Jr.,SF,23,58,1318,147,304,0.484,43,136,0.316,104,168,0.619,59,91,0.648,77,128,205,47,37,54,32,127,396,1.6,0.8,2.4,2020
Mason Jones,SG,22,32,334,52,123,0.423,24,66,0.364,28,57,0.491,40,64,0.625,7,48,55,42,7,1,29,24,168,0.0,0.2,0.2,2020
Tre Jones,PG,21,37,269,37,78,0.474,3,5,0.6,34,73,0.466,17,19,0.895,8,13,21,39,8,0,13,13,94,0.2,0.1,0.4,2020
Tyus Jones,PG,24,70,1222,178,413,0.431,45,140,0.321,133,273,0.487,41,45,0.911,21,119,140,259,64,6,48,31,442,1.5,1.3,2.8,2020
DeAndre Jordan,C,32,57,1246,190,249,0.763,0,1,0.0,190,248,0.766,46,92,0.5,117,310,427,93,17,65,85,116,426,2.4,1.5,3.9,2020
Cory Joseph,PG,29,63,1446,200,426,0.469,45,132,0.341,155,294,0.527,72,88,0.818,35,124,159,213,61,18,79,139,517,1.3,0.8,2.1,2020
Mfiondu Kabengele,PF,23,39,280,33,89,0.371,13,50,0.26,20,39,0.513,16,20,0.8,12,48,60,17,8,13,15,36,95,-0.2,0.3,0.2,2020
Frank Kaminsky,C,27,47,715,121,257,0.471,31,85,0.365,90,172,0.523,37,60,0.617,36,152,188,79,14,17,22,70,310,1.1,0.9,2.0,2020
Luke Kennard,SG,24,63,1232,197,414,0.476,100,224,0.446,97,190,0.511,26,31,0.839,15,146,161,104,23,9,48,91,520,1.6,1.1,2.7,2020
Louis King,SF,21,6,85,17,34,0.5,4,11,0.364,13,23,0.565,6,6,1.0,5,13,18,9,7,3,4,9,44,0.2,0.1,0.3,2020
Maxi Kleber,PF,29,50,1341,116,275,0.422,87,212,0.41,29,63,0.46,34,37,0.919,47,213,260,68,24,35,30,105,353,1.6,1.3,2.9,2020
Nathan Knight,PF,23,33,279,37,100,0.37,6,33,0.182,31,67,0.463,44,55,0.8,27,45,72,8,9,10,15,22,124,0.1,0.3,0.4,2020
Kevin Knox,SF,21,42,464,56,143,0.392,35,89,0.393,21,54,0.389,16,20,0.8,10,51,61,19,12,6,17,37,163,0.0,0.6,0.6,2020
John Konchar,SG,24,43,575,69,138,0.5,21,56,0.375,48,82,0.585,25,30,0.833,35,93,128,47,30,9,18,40,184,0.9,0.8,1.7,2020
Furkan Korkmaz,SG,23,55,1062,170,424,0.401,101,269,0.375,69,155,0.445,60,82,0.732,17,96,113,82,49,9,46,64,501,0.6,1.5,2.0,2020
Luke Kornet,C,25,31,348,44,101,0.436,15,59,0.254,29,42,0.69,3,6,0.5,14,53,67,24,4,32,7,20,106,0.2,0.5,0.7,2020
Rodions Kurucs,SF,22,21,125,11,32,0.344,6,21,0.286,5,11,0.455,3,4,0.75,5,18,23,10,9,4,13,16,31,-0.3,0.2,-0.1,2020
Kyle Kuzma,SF,25,68,1954,335,757,0.443,137,380,0.361,198,377,0.525,67,97,0.691,108,309,417,127,35,41,113,121,874,0.4,2.9,3.3,2020
Anthony Lamb,SF,23,24,415,46,118,0.39,23,71,0.324,23,47,0.489,18,21,0.857,27,43,70,23,6,5,19,34,133,0.1,0.1,0.2,2020
Jeremy Lamb,SG,28,36,765,120,276,0.435,52,128,0.406,68,148,0.459,71,75,0.947,25,106,131,53,34,23,22,72,363,1.2,0.9,2.1,2020
Romeo Langford,SG,21,18,283,21,59,0.356,5,18,0.278,16,41,0.39,9,12,0.75,12,23,35,13,6,5,10,24,56,-0.2,0.2,0.0,2020
Zach LaVine,SG,25,58,2034,569,1123,0.507,200,477,0.419,369,646,0.571,253,298,0.849,36,253,289,282,46,27,203,138,1591,4.0,1.8,5.9,2020
Jake Layman,SF,26,45,627,91,184,0.495,23,78,0.295,68,106,0.642,26,37,0.703,13,54,67,28,29,19,26,44,231,0.2,0.5,0.7,2020
T.J. Leaf,PF,23,7,35,5,10,0.5,0,0,0.0,5,10,0.5,2,2,1.0,0,5,5,1,2,1,2,1,12,0.0,0.0,0.0,2020
Jalen Lecque,PG,20,4,12,1,9,0.111,0,1,0.0,1,8,0.125,3,3,1.0,2,3,5,2,0,0,0,0,5,-0.1,0.0,-0.1,2020
Damion Lee,SG,28,57,1079,128,274,0.467,77,194,0.397,51,80,0.638,40,44,0.909,22,158,180,73,38,8,30,89,373,1.4,1.3,2.7,2020
Saben Lee,PG,21,48,781,99,210,0.471,8,23,0.348,91,187,0.487,61,89,0.685,20,77,97,174,32,13,55,76,267,0.7,0.8,1.5,2020
Alex Len,C,27,64,979,171,278,0.615,8,25,0.32,163,253,0.644,73,116,0.629,78,182,260,49,20,64,55,127,423,1.5,1.3,2.7,2020
Kawhi Leonard,SF,29,52,1773,465,908,0.512,101,254,0.398,364,654,0.557,261,295,0.885,55,282,337,269,81,21,105,82,1292,6.4,2.4,8.8,2020
Meyers Leonard,C,28,3,29,3,7,0.429,3,7,0.429,0,0,0.0,1,2,0.5,0,7,7,2,0,0,2,5,10,0.0,0.0,0.0,2020
Caris LeVert,SG,26,47,1486,359,814,0.441,84,258,0.326,275,556,0.495,146,180,0.811,33,181,214,245,66,30,102,105,948,0.9,1.5,2.4,2020
Kira Lewis Jr.,PG,19,54,904,130,337,0.386,40,120,0.333,90,217,0.415,43,51,0.843,12,59,71,124,38,10,34,88,343,0.2,0.6,0.9,2020
Damian Lillard,PG,30,67,2398,602,1334,0.451,275,704,0.391,327,630,0.519,449,484,0.928,32,251,283,505,62,17,203,102,1928,9.6,0.8,10.4,2020
Nassir Little,PF,20,48,640,78,167,0.467,28,80,0.35,50,87,0.575,36,45,0.8,32,96,128,23,5,13,18,51,220,0.9,0.2,1.1,2020
Kevon Looney,C,24,61,1161,108,197,0.548,4,17,0.235,104,180,0.578,31,48,0.646,117,205,322,119,21,22,37,136,251,2.0,1.4,3.4,2020
Brook Lopez,C,32,70,1902,322,640,0.503,95,281,0.338,227,359,0.632,120,142,0.845,104,243,347,50,40,103,64,149,859,3.1,2.2,5.3,2020
Robin Lopez,C,32,71,1354,269,425,0.633,5,18,0.278,264,407,0.649,99,137,0.723,141,131,272,55,15,44,75,109,642,2.8,0.9,3.7,2020
Didi Louzada,SF,21,3,56,3,13,0.231,2,8,0.25,1,5,0.2,0,0,0.0,1,2,3,3,2,0,3,5,8,-0.1,0.0,-0.1,2020
Kevin Love,PF,32,25,622,103,252,0.409,57,156,0.365,46,96,0.479,42,51,0.824,17,169,186,63,16,2,38,26,305,0.3,0.6,0.9,2020
Kyle Lowry,PG,34,46,1601,260,596,0.436,131,331,0.396,129,265,0.487,140,160,0.875,35,212,247,338,45,14,126,143,791,2.9,1.3,4.1,2020
Timothé Luwawu-Cabarrot,SF,25,58,1050,130,356,0.365,75,239,0.314,55,117,0.47,35,43,0.814,28,101,129,69,33,6,43,99,370,-0.3,0.7,0.3,2020
Trey Lyles,PF,25,23,358,43,90,0.478,14,40,0.35,29,50,0.58,15,23,0.652,9,77,86,14,6,1,6,13,115,0.3,0.3,0.6,2020
Will Magnay,C,22,1,3,0,1,0.0,0,1,0.0,0,0,0.0,0,0,0.0,0,0,0,0,0,0,1,1,0,0.0,0.0,0.0,2020
Thon Maker,C,23,8,76,10,18,0.556,0,2,0.0,10,16,0.625,10,11,0.909,8,10,18,4,2,4,3,7,30,0.2,0.1,0.3,2020
Théo Maledon,PG,19,65,1778,226,614,0.368,105,313,0.335,121,301,0.402,101,135,0.748,25,186,211,227,56,11,141,126,658,-1.9,1.1,-0.8,2020
Karim Mané,PG,20,10,88,3,13,0.231,1,2,0.5,2,11,0.182,4,5,0.8,1,13,14,4,0,2,3,10,11,-0.1,0.0,-0.1,2020
Terance Mann,SG,24,67,1263,178,350,0.509,38,91,0.418,140,259,0.541,78,94,0.83,56,186,242,104,29,13,40,126,472,2.4,1.3,3.7,2020
Nico Mannion,PG,19,30,364,39,114,0.342,22,60,0.367,17,54,0.315,23,28,0.821,6,40,46,70,16,1,31,29,123,-0.2,0.4,0.2,2020
Boban Marjanović,C,32,33,271,62,122,0.508,1,8,0.125,61,114,0.535,31,38,0.816,47,81,128,10,2,6,12,29,156,0.7,0.3,1.0,2020
Lauri Markkanen,PF,23,51,1317,250,521,0.48,119,296,0.402,131,225,0.582,76,92,0.826,35,233,268,45,26,15,52,75,695,1.7,1.3,3.0,2020
Naji Marshall,SF,23,32,700,82,209,0.392,29,83,0.349,53,126,0.421,53,75,0.707,15,133,148,88,26,10,38,58,246,0.2,0.7,0.9,2020
Caleb Martin,SF,25,53,818,96,256,0.375,31,125,0.248,65,131,0.496,41,64,0.641,31,110,141,67,37,12,33,62,264,-0.4,0.9,0.5,2020
Cody Martin,SF,25,52,849,83,188,0.441,16,58,0.276,67,130,0.515,25,43,0.581,52,109,161,86,37,12,40,52,207,0.2,0.9,1.1,2020
Jeremiah Martin,PG,24,9,75,9,33,0.273,3,12,0.25,6,21,0.286,1,5,0.2,2,5,7,4,5,2,6,1,22,-0.4,0.1,-0.3,2020
Kelan Martin,SF,25,35,322,62,138,0.449,24,60,0.4,38,78,0.487,9,10,0.9,18,60,78,17,10,10,16,35,157,0.1,0.4,0.4,2020
KJ Martin,SF,20,45,1068,162,318,0.509,35,96,0.365,127,222,0.572,60,84,0.714,73,169,242,48,30,41,38,89,419,1.3,0.9,2.2,2020
Frank Mason III,PG,26,4,79,9,24,0.375,2,5,0.4,7,19,0.368,5,7,0.714,3,9,12,12,0,0,5,7,25,0.0,0.0,0.0,2020
Garrison Mathews,SG,24,64,1038,97,237,0.409,76,198,0.384,21,39,0.538,84,95,0.884,16,71,87,26,29,7,10,106,354,1.7,0.6,2.3,2020
Dakota Mathias,SG,25,8,123,19,48,0.396,8,26,0.308,11,22,0.5,2,6,0.333,1,6,7,13,1,3,1,7,48,0.0,0.1,0.2,2020
Wesley Matthews,SG,34,58,1130,89,252,0.353,66,197,0.335,23,55,0.418,35,41,0.854,20,73,93,54,38,17,26,80,279,0.2,1.5,1.7,2020
Tyrese Maxey,SG,20,61,935,198,429,0.462,31,103,0.301,167,326,0.512,61,70,0.871,11,93,104,120,26,13,41,79,488,0.8,1.1,1.9,2020
Skylar Mays,SG,23,33,269,44,98,0.449,14,40,0.35,30,58,0.517,22,25,0.88,10,25,35,30,14,2,9,15,124,0.5,0.3,0.8,2020
Patrick McCaw,SF,25,5,33,1,1,1.0,0,0,0.0,1,1,1.0,3,3,1.0,1,2,3,4,2,0,0,6,5,0.1,0.0,0.1,2020
CJ McCollum,SG,29,47,1600,405,884,0.458,169,420,0.402,236,464,0.509,108,133,0.812,30,155,185,223,44,21,65,87,1087,4.1,0.6,4.7,2020
T.J. McConnell,PG,28,69,1796,274,490,0.559,15,48,0.313,259,442,0.586,33,48,0.688,55,201,256,456,128,23,135,113,596,2.6,2.2,4.8,2020
Jaden McDaniels,PF,20,63,1511,164,367,0.447,72,198,0.364,92,169,0.544,27,45,0.6,52,180,232,71,35,60,47,172,427,0.5,0.9,1.4,2020
Jalen McDaniels,SF,23,47,904,133,284,0.468,35,105,0.333,98,179,0.547,45,64,0.703,45,124,169,53,28,19,45,95,346,0.3,0.9,1.2,2020
Doug McDermott,PF,29,66,1619,354,665,0.532,111,286,0.388,243,379,0.641,80,98,0.816,60,161,221,85,20,6,53,117,899,3.1,0.7,3.8,2020
Sean McDermott,SF,24,18,158,13,33,0.394,5,22,0.227,8,11,0.727,8,8,1.0,6,13,19,4,2,3,4,8,39,0.1,0.1,0.2,2020
JaVale McGee,C,33,46,678,144,282,0.511,5,24,0.208,139,258,0.539,44,67,0.657,77,162,239,39,19,54,60,121,337,-0.1,1.1,1.0,2020
Rodney McGruder,SG,29,16,194,37,70,0.529,11,24,0.458,26,46,0.565,6,8,0.75,8,14,22,16,8,1,7,12,91,0.3,0.2,0.5,2020
Alfonzo McKinnie,SF,28,39,258,48,93,0.516,16,39,0.41,32,54,0.593,10,18,0.556,22,32,54,6,7,0,5,26,122,0.5,0.3,0.8,2020
Jordan McLaughlin,PG,24,51,938,100,242,0.413,33,92,0.359,67,150,0.447,23,30,0.767,21,87,108,193,51,6,51,44,256,0.6,0.6,1.2,2020
Ben McLemore,SG,27,53,905,135,365,0.37,97,280,0.346,38,85,0.447,39,53,0.736,15,85,100,39,23,9,42,88,406,-0.5,0.7,0.2,2020
Nicolò Melli,PF,30,45,566,46,141,0.326,23,85,0.271,23,56,0.411,19,25,0.76,29,93,122,44,14,3,12,58,134,0.1,0.5,0.6,2020
De'Anthony Melton,PG,22,52,1045,172,393,0.438,87,211,0.412,85,182,0.467,41,51,0.804,30,131,161,132,60,31,66,85,472,0.7,1.5,2.2,2020
Sam Merrill,SG,24,30,233,32,72,0.444,21,47,0.447,11,25,0.44,4,4,1.0,6,24,30,21,8,1,10,17,89,0.3,0.2,0.5,2020
Chimezie Metu,C,23,36,488,91,179,0.508,13,37,0.351,78,142,0.549,31,43,0.721,31,81,112,28,14,18,29,59,226,0.3,0.3,0.6,2020
Khris Middleton,SF,29,68,2269,511,1074,0.476,151,365,0.414,360,709,0.508,212,236,0.898,54,352,406,370,74,9,178,160,1385,4.1,2.2,6.4,2020
Darius Miller,SF,30,18,197,22,48,0.458,17,42,0.405,5,6,0.833,12,12,1.0,2,22,24,21,13,5,8,13,73,0.4,0.2,0.6,2020
Patty Mills,PG,32,68,1685,252,611,0.412,161,429,0.375,91,182,0.5,71,78,0.91,18,98,116,162,42,3,66,81,736,1.3,0.8,2.2,2020
Paul Millsap,PF,35,56,1162,191,401,0.476,49,143,0.343,142,258,0.55,71,98,0.724,76,186,262,98,51,36,51,111,502,1.7,1.6,3.2,2020
Shake Milton,SG,24,63,1461,300,667,0.45,71,203,0.35,229,464,0.494,146,176,0.83,33,115,148,193,39,18,103,130,817,1.1,1.6,2.8,2020
Donovan Mitchell,PG,24,53,1771,478,1091,0.438,178,461,0.386,300,630,0.476,267,316,0.845,50,185,235,277,52,15,147,117,1401,3.9,2.2,6.2,2020
Adam Mokoka,SG,22,14,56,7,19,0.368,1,10,0.1,6,9,0.667,0,1,0.0,1,4,5,5,2,1,5,5,15,-0.2,0.1,-0.1,2020
Malik Monk,SG,22,42,878,173,399,0.434,85,212,0.401,88,187,0.471,59,72,0.819,14,87,101,87,19,4,55,47,490,0.5,0.5,1.0,2020
E'Twaun Moore,SG,31,27,389,55,121,0.455,11,35,0.314,44,86,0.512,12,14,0.857,14,31,45,40,15,5,23,32,133,0.0,0.4,0.4,2020
Ja Morant,PG,21,63,2053,430,957,0.449,73,241,0.303,357,716,0.499,271,372,0.728,59,193,252,465,57,13,203,87,1204,1.6,1.6,3.2,2020
Juwan Morgan,PF,23,29,147,14,30,0.467,4,13,0.308,10,17,0.588,3,7,0.429,9,19,28,9,4,1,4,21,35,0.1,0.2,0.3,2020
Marcus Morris,PF,31,57,1502,276,584,0.473,140,296,0.473,136,288,0.472,73,89,0.82,35,199,234,58,34,15,57,117,765,2.1,1.5,3.6,2020
Markieff Morris,PF,31,61,1200,153,378,0.405,65,209,0.311,88,169,0.521,36,50,0.72,48,218,266,73,22,19,54,105,407,-0.2,1.8,1.6,2020
Monte Morris,PG,25,47,1196,186,387,0.481,51,134,0.381,135,253,0.534,58,73,0.795,11,85,96,150,34,13,34,48,481,2.0,0.8,2.9,2020
Mychal Mulder,PG,26,60,766,119,265,0.449,85,214,0.397,34,51,0.667,14,22,0.636,8,52,60,26,12,12,16,56,337,0.6,0.6,1.2,2020
Dejounte Murray,PG,24,67,2139,441,974,0.453,63,199,0.317,378,775,0.488,106,134,0.791,58,415,473,363,101,7,117,135,1051,0.7,2.6,3.3,2020
Jamal Murray,PG,23,48,1704,378,792,0.477,129,316,0.408,249,476,0.523,133,153,0.869,37,157,194,231,64,13,108,95,1018,3.1,1.5,4.6,2020
Mike Muscala,C,29,35,645,119,267,0.446,68,184,0.37,51,83,0.614,33,36,0.917,19,113,132,28,8,11,21,54,339,0.9,0.4,1.3,2020
Svi Mykhailiuk,SF,23,66,1324,208,506,0.411,105,314,0.334,103,192,0.536,38,50,0.76,24,139,163,110,51,12,88,63,559,-0.8,1.1,0.3,2020
Abdel Nader,SF,27,24,355,57,116,0.491,18,43,0.419,39,73,0.534,28,37,0.757,7,55,62,19,10,9,19,34,160,0.3,0.4,0.7,2020
Larry Nance Jr.,PF,28,35,1091,128,272,0.471,41,114,0.36,87,158,0.551,30,49,0.612,54,181,235,107,61,17,55,72,327,0.5,1.3,1.8,2020
Aaron Nesmith,SF,21,46,669,78,178,0.438,40,108,0.37,38,70,0.543,22,28,0.786,28,99,127,23,15,9,23,87,218,0.5,0.6,1.1,2020
Raul Neto,PG,28,64,1403,209,447,0.468,64,164,0.39,145,283,0.512,75,85,0.882,28,128,156,146,73,6,53,109,557,1.5,1.3,2.8,2020
Georges Niang,PF,27,72,1154,177,405,0.437,124,292,0.425,53,113,0.469,22,23,0.957,28,148,176,59,25,8,51,116,500,1.2,1.4,2.6,2020
Zeke Nnaji,PF,20,42,397,50,104,0.481,24,59,0.407,26,45,0.578,12,15,0.8,14,51,65,10,8,4,7,29,136,0.6,0.3,0.9,2020
Nerlens Noel,C,26,64,1547,137,223,0.614,0,3,0.0,137,220,0.623,50,70,0.714,142,266,408,46,70,141,65,176,324,1.6,3.6,5.2,2020
Jaylen Nowell,SG,21,42,759,142,335,0.424,50,150,0.333,92,185,0.497,45,55,0.818,19,76,95,62,22,12,28,72,379,0.3,0.4,0.7,2020
Frank Ntilikina,PG,22,33,322,29,79,0.367,23,48,0.479,6,31,0.194,8,18,0.444,6,25,31,19,18,4,11,45,89,0.0,0.5,0.5,2020
Kendrick Nunn,PG,25,56,1650,319,658,0.485,122,320,0.381,197,338,0.583,56,60,0.933,21,158,179,148,52,14,80,108,816,1.4,1.5,2.9,2020
James Nunnally,SF,30,9,48,5,13,0.385,4,12,0.333,1,1,1.0,1,2,0.5,2,7,9,3,0,0,2,1,15,0.0,0.0,0.0,2020
Jusuf Nurkić,C,26,37,880,171,333,0.514,12,30,0.4,159,303,0.525,70,113,0.619,86,246,332,125,38,39,73,103,424,1.2,1.2,2.4,2020
David Nwaba,SF,28,30,679,106,218,0.486,17,63,0.27,89,155,0.574,47,68,0.691,40,78,118,31,30,21,17,60,276,0.7,0.6,1.3,2020
Jordan Nwora,SF,22,30,274,62,135,0.459,28,62,0.452,34,73,0.466,19,25,0.76,9,51,60,7,16,7,24,22,171,0.0,0.4,0.4,2020
Royce O'Neale,SF,27,71,2241,175,394,0.444,107,278,0.385,68,116,0.586,39,46,0.848,88,397,485,181,57,32,83,182,496,2.3,3.3,5.6,2020
Semi Ojeleye,PF,26,56,950,89,221,0.403,58,158,0.367,31,63,0.492,24,32,0.75,31,116,147,37,17,0,21,56,260,0.7,0.6,1.2,2020
Jahlil Okafor,C,25,27,347,63,102,0.618,2,9,0.222,61,93,0.656,17,24,0.708,23,43,66,13,6,5,21,39,145,0.3,0.3,0.6,2020
Chuma Okeke,PF,22,45,1133,135,324,0.417,49,141,0.348,86,183,0.47,30,40,0.75,42,139,181,101,48,22,38,48,349,0.3,1.0,1.3,2020
Josh Okogie,SG,22,59,1197,102,254,0.402,29,108,0.269,73,146,0.5,83,108,0.769,63,93,156,63,54,28,43,123,316,0.5,0.8,1.3,2020
Onyeka Okongwu,C,20,50,601,96,149,0.644,0,3,0.0,96,146,0.658,36,57,0.632,62,101,163,18,23,33,29,100,228,1.1,0.8,1.9,2020
Isaac Okoro,SG,20,67,2173,235,559,0.42,62,214,0.29,173,345,0.501,114,157,0.726,68,138,206,128,62,24,86,185,646,-0.1,1.0,0.9,2020
KZ Okpala,PF,21,37,447,36,96,0.375,12,50,0.24,24,46,0.522,8,15,0.533,21,47,68,19,10,11,15,59,92,-0.3,0.4,0.1,2020
Victor Oladipo,SG,28,33,1080,235,576,0.408,78,239,0.326,157,337,0.466,104,138,0.754,12,148,160,151,46,14,83,81,652,-0.6,1.0,0.4,2020
Cameron Oliver,SF,24,4,87,19,33,0.576,4,13,0.308,15,20,0.75,1,4,0.25,5,16,21,5,2,4,3,11,43,0.1,0.1,0.2,2020
Kelly Olynyk,C,29,70,1997,337,697,0.484,126,368,0.342,211,329,0.641,145,175,0.829,87,402,489,203,79,42,126,207,945,2.5,2.6,5.1,2020
Miye Oni,SG,23,54,519,35,99,0.354,30,88,0.341,5,11,0.455,5,6,0.833,23,61,84,28,11,8,16,61,105,0.2,0.7,0.9,2020
Cedi Osman,SF,25,59,1510,219,586,0.374,99,324,0.306,120,262,0.458,76,95,0.8,38,163,201,174,53,9,80,119,613,-0.5,1.0,0.5,2020
Daniel Oturu,C,21,30,161,22,52,0.423,1,5,0.2,21,47,0.447,9,12,0.75,21,27,48,10,4,7,9,24,54,0.0,0.2,0.3,2020
Kelly Oubre Jr.,SF,25,55,1687,318,724,0.439,90,285,0.316,228,439,0.519,123,177,0.695,82,247,329,73,57,42,70,121,849,0.0,2.2,2.2,2020
Jabari Parker,PF,25,13,165,30,55,0.545,2,11,0.182,28,44,0.636,10,13,0.769,10,32,42,11,1,5,10,13,72,0.2,0.1,0.3,2020
Eric Paschall,PF,24,40,695,148,298,0.497,18,54,0.333,130,244,0.533,67,94,0.713,28,100,128,51,12,7,43,68,381,0.2,0.7,0.9,2020
Anžejs Pasečņiks,C,25,1,6,0,1,0.0,0,1,0.0,0,0,0.0,0,0,0.0,1,0,1,1,0,0,5,2,0,-0.1,0.0,-0.1,2020
Patrick Patterson,PF,31,38,582,72,165,0.436,40,112,0.357,32,53,0.604,13,17,0.765,19,56,75,29,14,8,11,45,197,0.7,0.5,1.2,2020
Justin Patton,C,23,13,247,29,70,0.414,9,34,0.265,20,36,0.556,3,4,0.75,14,35,49,14,12,14,4,34,70,0.1,0.3,0.4,2020
Chris Paul,PG,35,70,2199,439,879,0.499,102,258,0.395,337,621,0.543,169,181,0.934,25,287,312,622,99,19,156,166,1149,6.5,2.7,9.2,2020
Cameron Payne,PG,26,60,1079,191,395,0.484,73,166,0.44,118,229,0.515,50,56,0.893,16,128,144,217,36,16,60,97,505,2.4,1.2,3.6,2020
Elfrid Payton,PG,26,63,1484,269,622,0.432,28,98,0.286,241,524,0.46,73,107,0.682,64,152,216,203,47,9,103,116,639,-0.9,1.9,1.0,2020
Gary Payton II,PG,28,10,40,10,13,0.769,2,4,0.5,8,9,0.889,3,4,0.75,2,9,11,1,6,1,1,8,25,0.2,0.1,0.3,2020
Norvel Pelle,C,27,13,84,8,15,0.533,0,0,0.0,8,15,0.533,4,6,0.667,6,13,19,2,1,9,3,14,20,0.1,0.1,0.2,2020
Reggie Perry,PF,20,26,211,32,78,0.41,4,21,0.19,28,57,0.491,10,13,0.769,27,46,73,14,6,6,15,40,78,-0.1,0.2,0.2,2020
Theo Pinson,SG,25,17,34,1,9,0.111,0,8,0.0,1,1,1.0,0,0,0.0,0,5,5,1,0,0,1,4,2,-0.2,0.0,-0.1,2020
Mason Plumlee,C,30,56,1499,234,381,0.614,0,7,0.0,234,374,0.626,113,169,0.669,145,374,519,202,43,50,105,186,581,3.0,2.1,5.1,2020
Jakob Poeltl,C,25,69,1845,265,430,0.616,0,0,0.0,265,430,0.616,63,124,0.508,219,328,547,134,47,123,83,172,593,3.2,2.5,5.7,2020
Vincent Poirier,C,27,10,39,3,12,0.25,0,1,0.0,3,11,0.273,2,6,0.333,6,8,14,2,0,3,4,8,8,-0.2,0.1,-0.1,2020
Aleksej Pokusevski,PF,19,45,1090,139,408,0.341,58,207,0.28,81,201,0.403,31,42,0.738,30,182,212,97,20,42,99,58,367,-2.9,1.0,-1.9,2020
Jordan Poole,SG,21,51,988,205,474,0.432,97,276,0.351,108,198,0.545,105,119,0.882,15,77,92,99,26,9,51,86,612,1.1,0.9,1.9,2020
Jontay Porter,PF,21,11,54,8,15,0.533,3,8,0.375,5,7,0.714,3,5,0.6,4,10,14,1,3,1,7,12,22,-0.1,0.1,0.0,2020
Kevin Porter Jr.,SG,20,26,835,156,367,0.425,50,161,0.311,106,206,0.515,69,94,0.734,20,79,99,164,19,8,91,61,431,-0.3,0.3,0.0,2020
Michael Porter Jr.,SF,22,61,1912,443,817,0.542,170,382,0.445,273,435,0.628,106,134,0.791,91,354,445,70,40,54,77,126,1162,4.8,2.1,6.9,2020
Otto Porter Jr.,SF,27,28,606,98,227,0.432,39,104,0.375,59,123,0.48,36,42,0.857,28,124,152,55,16,4,25,41,271,0.6,0.7,1.3,2020
Bobby Portis,C,25,66,1372,313,598,0.523,74,157,0.471,239,441,0.542,54,73,0.74,124,342,466,71,52,26,56,115,754,2.8,2.0,4.8,2020
Kristaps Porziņģis,C,25,43,1327,325,683,0.476,97,258,0.376,228,425,0.536,118,138,0.855,82,299,381,68,20,58,51,115,865,2.6,1.7,4.3,2020
Dwight Powell,C,29,58,966,120,194,0.619,5,21,0.238,115,173,0.665,97,124,0.782,80,154,234,63,36,30,40,135,342,2.6,1.2,3.8,2020
Norman Powell,SG,27,69,2205,438,918,0.477,171,416,0.411,267,502,0.532,236,271,0.871,42,173,215,129,82,18,119,160,1283,3.4,1.3,4.7,2020
Taurean Prince,PF,26,41,905,131,327,0.401,62,155,0.4,69,172,0.401,65,76,0.855,19,123,142,76,28,23,47,75,389,0.2,0.8,1.0,2020
Payton Pritchard,SG,23,66,1268,184,418,0.44,102,248,0.411,82,170,0.482,40,45,0.889,33,125,158,120,37,9,53,104,510,1.6,0.9,2.5,2020
Immanuel Quickley,PG,21,64,1243,229,580,0.395,118,303,0.389,111,277,0.401,155,174,0.891,25,112,137,127,30,12,58,114,731,1.8,1.4,3.2,2020
Jahmi'us Ramsey,SG,19,13,94,15,38,0.395,5,19,0.263,10,19,0.526,5,5,1.0,2,8,10,6,4,1,3,8,40,0.0,0.0,0.0,2020
Chasson Randle,PG,27,41,837,92,237,0.388,44,130,0.338,48,107,0.449,38,48,0.792,7,75,82,74,22,5,46,64,266,-0.4,0.4,0.0,2020
Julius Randle,PF,26,71,2667,602,1321,0.456,160,389,0.411,442,932,0.474,348,429,0.811,84,639,723,427,64,18,241,225,1712,3.4,4.3,7.8,2020
Cam Reddish,SF,21,26,750,96,263,0.365,33,126,0.262,63,137,0.46,67,82,0.817,22,82,104,35,33,9,34,68,292,-0.3,0.7,0.4,2020
JJ Redick,SG,36,44,723,106,267,0.397,66,178,0.371,40,89,0.449,49,52,0.942,4,60,64,51,11,3,36,50,327,0.4,0.3,0.7,2020
Paul Reed,PF,21,26,177,42,78,0.538,0,6,0.0,42,72,0.583,4,8,0.5,30,31,61,12,10,13,12,29,88,0.2,0.4,0.6,2020
Naz Reid,C,21,70,1347,304,581,0.523,61,174,0.351,243,407,0.597,115,166,0.693,82,240,322,72,34,76,69,179,784,1.9,1.3,3.2,2020
Cameron Reynolds,SF,25,5,40,6,18,0.333,3,12,0.25,3,6,0.5,0,0,0.0,2,3,5,2,0,0,0,2,15,0.0,0.0,0.0,2020
Nick Richards,PF,23,18,63,4,9,0.444,0,1,0.0,4,8,0.5,7,11,0.636,4,7,11,2,0,0,3,7,15,0.0,0.0,0.0,2020
Josh Richardson,SG,27,59,1790,264,618,0.427,88,267,0.33,176,351,0.501,99,108,0.917,51,144,195,153,61,24,79,130,715,1.0,1.4,2.4,2020
Grant Riller,PG,23,7,27,8,12,0.667,2,4,0.5,6,8,0.75,0,0,0.0,0,1,1,3,1,0,1,0,18,0.1,0.0,0.1,2020
Austin Rivers,SG,28,36,845,104,245,0.424,55,149,0.369,49,96,0.51,22,31,0.71,8,74,82,81,30,2,36,64,285,0.4,0.9,1.3,2020
Andre Roberson,SG,29,5,63,2,14,0.143,1,8,0.125,1,6,0.167,1,2,0.5,7,8,15,4,3,1,2,4,6,-0.1,0.1,-0.1,2020
Duncan Robinson,SF,26,72,2262,315,717,0.439,250,613,0.408,65,104,0.625,62,75,0.827,7,243,250,127,43,20,81,181,942,1.9,1.8,3.7,2020
Glenn Robinson III,SF,27,23,369,42,99,0.424,16,44,0.364,26,55,0.473,21,23,0.913,11,34,45,20,4,3,11,23,121,0.3,0.0,0.3,2020
Jerome Robinson,SG,23,17,305,28,95,0.295,11,42,0.262,17,53,0.321,16,20,0.8,4,34,38,25,12,6,19,31,83,-0.7,0.3,-0.4,2020
Justin Robinson,PG,23,9,88,7,21,0.333,4,14,0.286,3,7,0.429,3,5,0.6,1,6,7,9,3,0,2,10,21,0.0,0.0,0.0,2020
Mitchell Robinson,C,22,31,853,115,176,0.653,0,0,0.0,115,176,0.653,26,53,0.491,113,139,252,17,35,45,26,86,256,1.8,1.7,3.4,2020
Isaiah Roby,PF,22,61,1425,207,429,0.483,32,109,0.294,175,320,0.547,87,117,0.744,89,252,341,107,52,37,113,162,533,-0.3,1.5,1.3,2020
Rajon Rondo,PG,34,45,770,95,215,0.442,36,89,0.404,59,126,0.468,16,17,0.941,18,92,110,199,37,4,79,53,242,0.5,0.8,1.3,2020
Derrick Rose,PG,32,50,1279,287,611,0.47,50,129,0.388,237,482,0.492,110,127,0.866,20,110,130,209,49,19,78,56,734,1.6,1.6,3.1,2020
Terrence Ross,SG,29,46,1347,254,616,0.412,89,264,0.337,165,352,0.469,120,138,0.87,15,143,158,108,47,21,74,88,717,-0.1,1.0,0.9,2020
Terry Rozier,SG,26,69,2383,510,1134,0.45,222,571,0.389,288,563,0.512,165,202,0.817,47,255,302,293,87,26,128,119,1407,3.3,2.0,5.2,2020
Ricky Rubio,PG,30,68,1772,193,498,0.388,66,214,0.308,127,284,0.447,130,150,0.867,28,195,223,433,98,4,111,139,582,1.9,1.3,3.1,2020
D'Angelo Russell,PG,24,42,1196,281,652,0.431,120,310,0.387,161,342,0.471,114,149,0.765,16,95,111,244,45,18,112,68,796,1.0,0.6,1.6,2020
Domantas Sabonis,PF,24,62,2231,484,904,0.535,52,162,0.321,432,742,0.582,240,328,0.732,150,592,742,415,76,33,213,203,1260,4.0,3.0,6.9,2020
Luka Šamanić,PF,21,33,308,47,105,0.448,12,43,0.279,35,62,0.565,16,29,0.552,16,52,68,15,8,8,20,43,122,-0.2,0.3,0.1,2020
JaKarr Sampson,PF,27,29,316,56,113,0.496,3,15,0.2,53,98,0.541,19,29,0.655,27,50,77,4,2,14,15,52,134,0.0,0.3,0.3,2020
Dario Šarić,C,26,50,871,153,342,0.447,47,135,0.348,106,207,0.512,84,99,0.848,46,144,190,65,30,4,57,95,437,0.7,1.0,1.7,2020
Tomáš Satoranský,SG,29,58,1307,169,329,0.514,42,118,0.356,127,211,0.602,67,79,0.848,30,112,142,271,40,14,96,89,447,1.9,1.1,3.1,2020
Dennis Schröder,SG,27,61,1956,332,760,0.437,71,212,0.335,261,548,0.476,206,243,0.848,30,181,211,351,70,13,163,159,941,1.0,2.7,3.8,2020
Mike Scott,PF,32,51,852,76,211,0.36,53,155,0.342,23,56,0.411,8,12,0.667,11,109,120,40,24,14,19,72,213,-0.1,1.1,1.0,2020
Jay Scrubb,SG,20,4,84,14,36,0.389,2,9,0.222,12,27,0.444,5,5,1.0,2,12,14,1,4,0,7,5,35,-0.2,0.1,-0.1,2020
Collin Sexton,SG,22,60,2115,525,1105,0.475,98,264,0.371,427,841,0.508,312,383,0.815,58,129,187,262,62,10,167,157,1460,2.6,0.9,3.5,2020
Landry Shamet,SG,23,61,1403,186,456,0.408,129,333,0.387,57,123,0.463,66,78,0.846,11,101,112,99,31,10,48,93,567,1.2,0.6,1.8,2020
Iman Shumpert,SG,30,2,11,1,4,0.25,0,3,0.0,1,1,1.0,0,0,0.0,1,0,1,0,1,0,1,0,2,-0.1,0.0,0.0,2020
Pascal Siakam,PF,26,56,2006,437,961,0.455,73,246,0.297,364,715,0.509,249,301,0.827,95,310,405,250,64,37,130,174,1196,2.3,2.0,4.2,2020
Chris Silva,PF,24,15,92,10,16,0.625,1,1,1.0,9,15,0.6,11,15,0.733,7,20,27,6,1,6,10,24,32,0.1,0.1,0.2,2020
Ben Simmons,PG,24,58,1877,325,583,0.557,3,10,0.3,322,573,0.562,176,287,0.613,93,324,417,401,93,35,173,171,829,2.7,3.3,6.0,2020
Anfernee Simons,SG,21,64,1104,168,401,0.419,120,282,0.426,48,119,0.403,46,57,0.807,14,126,140,89,18,8,43,96,502,1.5,0.3,1.8,2020
Deividas Sirvydis,SG,20,20,133,14,40,0.35,10,28,0.357,4,12,0.333,3,6,0.5,0,29,29,5,2,0,5,9,41,-0.1,0.1,0.0,2020
Alen Smailagić,PF,20,15,84,11,27,0.407,4,10,0.4,7,17,0.412,2,6,0.333,6,10,16,4,3,5,5,11,28,-0.1,0.1,0.0,2020
Marcus Smart,PG,26,48,1581,203,510,0.398,93,282,0.33,110,228,0.482,128,162,0.79,36,131,167,273,72,23,96,126,627,1.8,1.5,3.3,2020
Dennis Smith Jr.,PG,23,23,420,58,145,0.4,19,58,0.328,39,87,0.448,19,26,0.731,12,43,55,77,23,14,26,37,154,0.1,0.5,0.6,2020
Ish Smith,PG,32,44,924,129,297,0.434,18,49,0.367,111,248,0.448,19,33,0.576,22,128,150,172,32,13,41,62,295,0.2,0.9,1.1,2020
Jalen Smith,PF,20,27,156,22,50,0.44,4,17,0.235,18,33,0.545,5,7,0.714,7,30,37,4,1,5,7,16,53,-0.1,0.2,0.1,2020
Tony Snell,SG,29,47,992,88,171,0.515,62,109,0.569,26,62,0.419,11,11,1.0,18,94,112,59,13,11,21,75,249,1.6,0.5,2.0,2020
Ray Spalding,C,23,2,19,2,4,0.5,0,1,0.0,2,3,0.667,0,2,0.0,2,2,4,0,0,2,3,3,4,-0.1,0.0,-0.1,2020
Cassius Stanley,SG,21,24,93,13,43,0.302,3,13,0.231,10,30,0.333,7,9,0.778,8,12,20,1,1,2,1,14,36,-0.2,0.1,-0.1,2020
Lamar Stevens,PF,23,40,499,62,136,0.456,4,25,0.16,58,111,0.523,37,51,0.725,24,72,96,25,17,13,23,53,165,0.0,0.5,0.4,2020
Isaiah Stewart,C,19,68,1455,226,409,0.553,21,63,0.333,205,346,0.592,64,92,0.696,159,294,453,59,39,86,67,184,537,1.9,2.1,4.0,2020
Max Strus,SF,24,39,507,85,187,0.455,50,148,0.338,35,39,0.897,16,24,0.667,5,36,41,24,11,2,8,43,236,0.6,0.3,0.9,2020
Edmond Sumner,SG,25,53,861,148,282,0.525,35,88,0.398,113,194,0.582,68,83,0.819,18,76,94,49,33,10,51,88,399,0.7,0.7,1.4,2020
Jae'Sean Tate,SF,25,70,2043,316,625,0.506,60,195,0.308,256,430,0.595,102,147,0.694,132,242,374,178,85,36,98,222,794,2.2,1.6,3.8,2020
Jayson Tatum,SF,22,64,2290,605,1318,0.459,187,485,0.386,418,833,0.502,295,340,0.868,50,422,472,276,75,31,171,122,1692,4.1,2.5,6.5,2020
Jeff Teague,PG,32,55,950,123,284,0.433,36,82,0.439,87,202,0.431,89,105,0.848,15,73,88,132,34,12,64,56,371,0.8,0.8,1.6,2020
Garrett Temple,SG,34,56,1528,158,381,0.415,67,200,0.335,91,181,0.503,40,50,0.8,29,131,160,124,43,30,58,126,423,0.2,1.4,1.6,2020
Tyrell Terry,PG,20,11,56,5,16,0.313,0,7,0.0,5,9,0.556,1,3,0.333,0,6,6,6,5,0,2,2,11,-0.1,0.1,-0.1,2020
Daniel Theis,C,28,65,1601,252,466,0.541,49,152,0.322,203,314,0.646,74,110,0.673,93,263,356,108,41,57,66,167,627,2.4,1.8,4.3,2020
Brodric Thomas,SG,24,32,399,39,108,0.361,16,59,0.271,23,49,0.469,31,46,0.674,8,45,53,30,15,10,22,40,125,-0.3,0.3,0.1,2020
Isaiah Thomas,PG,31,3,48,9,27,0.333,3,12,0.25,6,15,0.4,2,2,1.0,1,3,4,5,1,0,6,3,23,-0.2,0.0,-0.2,2020
Khyri Thomas,SG,24,5,153,32,66,0.485,9,27,0.333,23,39,0.59,9,9,1.0,7,11,18,25,9,6,6,8,82,0.4,0.1,0.5,2020
Matt Thomas,SG,26,45,326,50,127,0.394,27,80,0.338,23,47,0.489,12,14,0.857,7,37,44,19,4,0,14,18,139,0.0,0.2,0.2,2020
Tristan Thompson,C,29,54,1287,169,326,0.518,0,3,0.0,169,323,0.523,71,120,0.592,169,270,439,67,24,33,62,119,409,1.5,1.4,2.9,2020
Sindarius Thornwell,SG,26,21,217,15,46,0.326,7,23,0.304,8,23,0.348,4,8,0.5,3,15,18,21,13,2,7,15,41,-0.2,0.2,0.0,2020
Matisse Thybulle,SG,23,65,1298,102,243,0.42,43,143,0.301,59,100,0.59,8,18,0.444,30,94,124,63,105,71,32,127,255,0.1,2.7,2.8,2020
Killian Tillie,C,22,18,182,19,57,0.333,10,33,0.303,9,24,0.375,9,11,0.818,6,18,24,8,5,8,2,20,57,0.0,0.2,0.2,2020
Xavier Tillman Sr.,PF,22,59,1085,167,299,0.559,22,65,0.338,145,234,0.62,34,53,0.642,74,182,256,75,44,33,45,116,390,1.4,1.5,2.9,2020
Anthony Tolliver,PF,35,11,99,4,17,0.235,4,14,0.286,0,3,0.0,5,6,0.833,3,7,10,2,3,2,3,7,17,-0.1,0.1,0.1,2020
Obi Toppin,PF,22,62,683,104,209,0.498,26,85,0.306,78,124,0.629,19,26,0.731,26,112,138,29,17,15,23,55,253,0.5,1.0,1.5,2020
Juan Toscano-Anderson,SG,27,53,1107,121,209,0.579,37,92,0.402,84,117,0.718,22,31,0.71,29,205,234,150,41,26,61,111,301,1.4,1.6,3.0,2020
Axel Toupane,SF,28,8,61,4,11,0.364,1,2,0.5,3,9,0.333,5,7,0.714,0,6,6,4,2,3,0,6,14,0.1,0.1,0.1,2020
Karl-Anthony Towns,C,25,50,1689,425,875,0.486,122,315,0.387,303,560,0.541,267,311,0.859,133,396,529,225,39,57,160,186,1239,3.8,1.6,5.4,2020
Gary Trent Jr.,SG,22,58,1802,320,785,0.408,165,429,0.385,155,356,0.435,83,106,0.783,27,125,152,80,56,10,43,92,888,1.0,0.7,1.7,2020
P.J. Tucker,PF,35,52,1356,66,177,0.373,40,119,0.336,26,58,0.448,21,28,0.75,51,153,204,61,39,20,40,125,193,0.1,0.9,1.0,2020
Rayjon Tucker,PG,23,14,68,9,18,0.5,2,7,0.286,7,11,0.636,14,19,0.737,1,10,11,6,2,0,4,8,34,0.1,0.1,0.2,2020
Myles Turner,C,24,47,1455,206,432,0.477,69,206,0.335,137,226,0.606,111,142,0.782,63,243,306,48,40,159,67,165,592,1.1,2.2,3.3,2020
Jonas Valančiūnas,C,28,62,1755,440,743,0.592,21,57,0.368,419,686,0.611,157,203,0.773,253,523,776,112,35,57,100,179,1058,5.1,2.6,7.8,2020
Denzel Valentine,SG,27,62,1036,155,416,0.373,80,242,0.331,75,174,0.431,16,17,0.941,24,173,197,105,30,7,42,70,406,-0.4,1.1,0.7,2020
Jarred Vanderbilt,PF,21,64,1139,143,236,0.606,1,5,0.2,142,231,0.615,57,102,0.559,118,250,368,76,64,46,53,123,344,1.6,1.5,3.1,2020
Fred VanVleet,SG,26,52,1899,338,870,0.389,174,476,0.366,164,394,0.416,169,191,0.885,32,188,220,328,87,37,95,119,1019,2.4,1.8,4.3,2020
Anderson Varejão,C,38,5,36,4,16,0.25,0,1,0.0,4,15,0.267,5,9,0.556,7,13,20,3,0,2,1,3,13,-0.1,0.0,0.0,2020
Devin Vassell,SF,20,62,1056,123,303,0.406,52,150,0.347,71,153,0.464,43,51,0.843,24,150,174,56,43,18,22,88,341,0.4,1.1,1.5,2020
Gabe Vincent,PG,24,50,655,88,233,0.378,46,149,0.309,42,84,0.5,20,23,0.87,10,46,56,67,21,2,34,79,242,-0.4,0.5,0.2,2020
Noah Vonleh,C,25,4,11,0,3,0.0,0,2,0.0,0,1,0.0,0,0,0.0,0,1,1,1,0,0,2,2,0,-0.1,0.0,-0.1,2020
Nikola Vučević,C,30,70,2348,666,1396,0.477,176,440,0.4,490,956,0.513,131,156,0.84,146,671,817,269,65,48,126,137,1639,3.3,3.0,6.3,2020
Dean Wade,PF,24,63,1212,134,311,0.431,78,213,0.366,56,98,0.571,30,39,0.769,38,177,215,74,35,21,30,78,376,1.1,0.9,2.0,2020
Moritz Wagner,C,23,45,722,104,229,0.454,31,91,0.341,73,138,0.529,71,87,0.816,27,119,146,50,26,18,43,108,310,0.5,0.8,1.2,2020
Kemba Walker,PG,30,43,1369,284,676,0.42,127,353,0.36,157,323,0.486,134,149,0.899,16,154,170,212,48,12,88,61,829,2.1,1.1,3.3,2020
Lonnie Walker IV,SG,22,60,1522,256,609,0.42,100,282,0.355,156,327,0.477,57,70,0.814,14,141,155,101,29,15,65,101,669,-0.5,0.9,0.4,2020
John Wall,PG,30,40,1288,293,726,0.404,79,249,0.317,214,477,0.449,158,211,0.749,17,112,129,275,42,31,141,46,823,-1.0,0.8,-0.2,2020
Brad Wanamaker,PG,31,61,1053,115,299,0.385,16,85,0.188,99,214,0.463,90,101,0.891,18,87,105,174,43,11,71,94,336,-0.2,1.0,0.9,2020
T.J. Warren,SF,27,4,117,27,51,0.529,0,7,0.0,27,44,0.614,8,10,0.8,2,12,14,5,2,0,4,16,62,0.1,0.1,0.1,2020
P.J. Washington,PF,22,64,1954,302,686,0.44,112,290,0.386,190,396,0.48,108,145,0.745,93,325,418,161,69,79,128,171,824,0.3,2.4,2.7,2020
Yuta Watanabe,SF,26,50,723,79,180,0.439,36,90,0.4,43,90,0.478,24,29,0.828,36,123,159,40,26,19,19,57,218,0.7,0.8,1.5,2020
Tremont Waters,PG,23,26,238,34,84,0.405,15,38,0.395,19,46,0.413,16,17,0.941,5,16,21,62,15,1,27,17,99,0.2,0.2,0.4,2020
Paul Watson,SF,26,27,297,38,82,0.463,30,64,0.469,8,18,0.444,5,8,0.625,4,41,45,17,6,3,9,36,111,0.4,0.2,0.6,2020
Quinndary Weatherspoon,SG,24,20,121,16,35,0.457,1,6,0.167,15,29,0.517,13,16,0.813,3,8,11,8,8,2,10,18,46,-0.1,0.1,0.1,2020
Russell Westbrook,PG,32,65,2369,544,1238,0.439,86,273,0.315,458,965,0.475,271,413,0.656,109,641,750,763,89,23,312,190,1445,0.5,3.2,3.7,2020
Coby White,PG,20,69,2156,375,902,0.416,163,454,0.359,212,448,0.473,128,142,0.901,28,256,284,328,38,15,156,179,1041,0.7,1.7,2.4,2020
Derrick White,SG,26,36,1064,186,453,0.411,84,243,0.346,102,210,0.486,97,114,0.851,13,94,107,127,26,36,45,91,553,1.0,0.9,1.9,2020
Hassan Whiteside,C,31,36,546,126,224,0.563,0,1,0.0,126,223,0.565,41,79,0.519,61,154,215,20,9,46,40,73,293,0.3,0.6,0.9,2020
Greg Whittington,PF,27,4,12,0,3,0.0,0,2,0.0,0,1,0.0,0,0,0.0,0,0,0,0,0,0,0,0,0,-0.1,0.0,-0.1,2020
Andrew Wiggins,PF,25,71,2364,505,1058,0.477,140,368,0.38,365,690,0.529,170,238,0.714,82,265,347,167,67,70,126,159,1320,1.2,2.7,3.9,2020
Grant Williams,PF,22,63,1138,108,247,0.437,48,129,0.372,60,118,0.508,30,51,0.588,48,130,178,64,32,24,56,161,294,0.1,1.0,1.1,2020
Kenrich Williams,PF,26,66,1426,219,411,0.533,52,117,0.444,167,294,0.568,36,63,0.571,84,189,273,152,55,17,76,143,526,1.6,1.2,2.8,2020
Lou Williams,PG,34,66,1423,265,646,0.41,69,173,0.399,196,473,0.414,150,173,0.867,21,117,138,225,47,6,108,62,749,0.5,1.2,1.7,2020
Patrick Williams,PF,19,71,1983,255,528,0.483,54,138,0.391,201,390,0.515,91,125,0.728,66,261,327,99,64,46,98,126,655,0.3,2.2,2.5,2020
Robert Williams,C,23,52,985,186,258,0.721,0,2,0.0,186,256,0.727,45,73,0.616,133,225,358,94,43,91,52,105,417,3.4,1.9,5.3,2020
Zion Williamson,PF,20,61,2026,634,1037,0.611,10,34,0.294,624,1003,0.622,369,529,0.698,167,274,441,226,57,39,167,135,1647,7.1,1.6,8.7,2020
D.J. Wilson,PF,24,35,433,68,168,0.405,30,87,0.345,38,81,0.469,17,25,0.68,20,92,112,23,11,16,22,44,183,-0.2,0.5,0.3,2020
Dylan Windler,SF,24,31,513,57,130,0.438,26,77,0.338,31,53,0.585,21,27,0.778,20,87,107,33,19,12,32,37,161,0.0,0.5,0.5,2020
Justise Winslow,SF,24,26,507,74,210,0.352,10,54,0.185,64,156,0.41,20,35,0.571,18,100,118,50,15,12,37,47,178,-1.3,0.6,-0.7,2020
Cassius Winston,PG,22,22,98,14,33,0.424,8,17,0.471,6,16,0.375,5,6,0.833,0,9,9,12,2,1,5,8,41,0.1,0.1,0.1,2020
James Wiseman,C,19,39,836,191,368,0.519,12,38,0.316,179,330,0.542,54,86,0.628,55,171,226,26,11,36,60,121,448,-0.4,1.2,0.7,2020
Christian Wood,C,25,41,1326,329,640,0.514,77,206,0.374,252,434,0.581,125,198,0.631,76,319,395,71,34,48,80,88,860,1.4,1.4,2.8,2020
Robert Woodard II,SF,21,13,45,8,20,0.4,1,6,0.167,7,14,0.5,3,8,0.375,4,12,16,2,0,3,1,4,20,0.0,0.0,0.0,2020
Delon Wright,PG,28,63,1748,240,518,0.463,64,172,0.372,176,346,0.509,101,126,0.802,65,204,269,278,101,30,83,75,645,2.5,1.8,4.3,2020
Thaddeus Young,PF,32,68,1652,370,662,0.559,12,45,0.267,358,617,0.58,71,113,0.628,168,255,423,291,74,40,137,152,823,2.8,2.2,5.1,2020
Trae Young,PG,22,63,2125,487,1112,0.438,136,397,0.343,351,715,0.491,484,546,0.886,38,207,245,594,53,12,261,111,1594,5.9,1.3,7.2,2020
Cody Zeller,C,28,48,1005,181,324,0.559,4,28,0.143,177,296,0.598,85,119,0.714,119,209,328,86,27,17,51,121,451,2.1,1.1,3.3,2020
Ivica Zubac,C,23,72,1609,257,394,0.652,1,4,0.25,256,390,0.656,135,171,0.789,189,330,519,90,24,62,81,187,650,4.8,2.1,6.9,2020
Precious Achiuwa,C,22,73,1725,265,603,0.439,56,156,0.359,209,447,0.468,78,131,0.595,146,327,473,82,37,41,84,151,664,0.4,2.1,2.5,2021
Steven Adams,C,28,76,1999,210,384,0.547,0,1,0.0,210,383,0.548,108,199,0.543,349,411,760,256,65,60,115,153,528,3.8,3.0,6.8,2021
Bam Adebayo,C,24,56,1825,406,729,0.557,0,6,0.0,406,723,0.562,256,340,0.753,137,427,564,190,80,44,148,171,1068,3.6,3.5,7.2,2021
Santi Aldama,PF,21,32,360,53,132,0.402,6,48,0.125,47,84,0.56,20,32,0.625,33,54,87,21,6,10,16,36,132,-0.1,0.4,0.3,2021
LaMarcus Aldridge,C,36,47,1050,252,458,0.55,14,46,0.304,238,412,0.578,89,102,0.873,73,185,258,42,14,47,44,78,607,2.1,1.0,3.1,2021
Nickeil Alexander-Walker,SG,23,65,1466,253,680,0.372,105,338,0.311,148,342,0.433,81,109,0.743,37,150,187,156,46,23,93,103,692,-1.1,1.1,0.1,2021
Grayson Allen,SG,26,66,1805,255,569,0.448,159,389,0.409,96,180,0.533,64,74,0.865,32,190,222,100,46,18,43,96,733,2.8,1.4,4.2,2021
Jarrett Allen,C,23,56,1810,369,545,0.677,1,10,0.1,368,535,0.688,165,233,0.708,192,410,602,92,44,75,94,97,904,5.4,3.0,8.5,2021
Jose Alvarado,PG,23,54,834,131,294,0.446,32,110,0.291,99,184,0.538,36,53,0.679,25,75,100,152,71,7,40,73,330,1.0,1.1,2.1,2021
Justin Anderson,SF,28,16,316,36,95,0.379,15,59,0.254,21,36,0.583,15,19,0.789,4,42,46,33,8,6,8,22,102,0.2,0.2,0.4,2021
Kyle Anderson,PF,28,69,1484,209,469,0.446,36,109,0.33,173,360,0.481,67,105,0.638,69,299,368,183,77,45,71,108,521,1.0,2.5,3.5,2021
Giannis Antetokounmpo,PF,27,67,2204,689,1245,0.553,71,242,0.293,618,1003,0.616,553,766,0.722,134,644,778,388,72,91,219,212,2002,9.2,3.7,12.9,2021
Thanasis Antetokounmpo,SF,29,48,473,70,128,0.547,2,14,0.143,68,114,0.596,29,46,0.63,40,61,101,22,16,12,26,68,171,0.4,0.5,0.9,2021
Carmelo Anthony,PF,37,69,1793,319,723,0.441,149,397,0.375,170,326,0.521,132,159,0.83,62,226,288,68,47,52,59,166,919,2.2,1.4,3.6,2021
Cole Anthony,PG,21,65,2059,357,912,0.391,132,391,0.338,225,521,0.432,216,253,0.854,32,316,348,369,46,17,170,171,1062,-0.1,1.7,1.6,2021
OG Anunoby,SF,24,48,1728,309,697,0.443,115,317,0.363,194,380,0.511,89,118,0.754,74,190,264,125,71,25,80,131,822,1.8,1.9,3.7,2021
Ryan Arcidiacono,PG,27,10,76,6,12,0.5,4,9,0.444,2,3,0.667,0,0,0.0,0,8,8,4,1,0,3,5,16,0.0,0.1,0.1,2021
Trevor Ariza,SF,36,24,462,33,99,0.333,20,74,0.27,13,25,0.52,10,18,0.556,10,72,82,27,13,6,11,20,96,-0.2,0.4,0.2,2021
D.J. Augustin,PG,34,55,883,94,222,0.423,68,164,0.415,26,58,0.448,38,43,0.884,11,57,68,107,17,1,56,39,294,0.7,0.1,0.8,2021
Deni Avdija,SF,21,82,1984,250,579,0.432,82,259,0.317,168,320,0.525,103,136,0.757,52,373,425,167,59,44,87,190,685,0.6,1.8,2.4,2021
Joel Ayayi,SG,21,7,20,1,6,0.167,0,1,0.0,1,5,0.2,0,0,0.0,1,2,3,4,0,0,0,0,2,0.0,0.0,0.0,2021
Deandre Ayton,C,23,58,1713,442,697,0.634,7,19,0.368,435,678,0.642,106,142,0.746,149,444,593,84,40,40,91,142,997,4.1,3.1,7.3,2021
Udoka Azubuike,C,22,17,195,37,49,0.755,0,0,0.0,37,49,0.755,6,11,0.545,18,53,71,0,1,11,12,25,80,0.3,0.3,0.6,2021
Marvin Bagley III,PF,22,48,1153,225,446,0.504,23,97,0.237,202,349,0.579,67,101,0.663,105,233,338,36,22,18,39,93,540,1.2,0.9,2.0,2021
LaMelo Ball,PG,20,75,2422,538,1254,0.429,220,565,0.389,318,689,0.462,212,243,0.872,108,393,501,571,119,30,245,237,1508,3.4,2.5,5.8,2021
Lonzo Ball,PG,24,35,1212,162,383,0.423,110,260,0.423,52,123,0.423,21,28,0.75,35,155,190,178,64,31,82,85,455,0.8,1.4,2.2,2021
Mo Bamba,C,23,71,1824,296,617,0.48,107,281,0.381,189,336,0.563,57,73,0.781,148,424,572,85,38,118,77,182,756,1.8,2.7,4.5,2021
Desmond Bane,SG,23,76,2266,508,1101,0.461,228,523,0.436,280,578,0.484,140,155,0.903,46,288,334,208,92,29,111,196,1384,4.5,2.7,7.2,2021
Dalano Banton,PG,22,64,696,83,202,0.411,13,51,0.255,70,151,0.464,26,44,0.591,38,86,124,99,28,10,53,68,205,-0.4,0.8,0.4,2021
Cat Barber,PG,27,3,13,0,4,0.0,0,0,0.0,0,4,0.0,0,4,0.0,1,2,3,3,0,0,1,1,0,-0.1,0.0,-0.1,2021
Harrison Barnes,PF,29,77,2580,391,834,0.469,142,360,0.394,249,474,0.525,341,413,0.826,82,350,432,186,53,14,118,94,1265,5.0,1.0,6.0,2021
Scottie Barnes,PF,20,74,2617,459,932,0.492,58,193,0.301,401,739,0.543,158,215,0.735,195,362,557,256,80,55,136,192,1134,3.7,2.9,6.6,2021
RJ Barrett,SF,21,70,2417,487,1194,0.408,138,404,0.342,349,790,0.442,290,406,0.714,66,342,408,208,43,16,151,142,1402,0.1,2.2,2.3,2021
Will Barton,SG,31,71,2277,392,896,0.438,157,430,0.365,235,466,0.504,102,127,0.803,44,296,340,276,55,31,127,114,1043,1.2,1.9,3.2,2021
Paris Bass,SF,26,2,7,2,6,0.333,0,2,0.0,2,4,0.5,2,2,1.0,2,2,4,0,1,0,2,2,6,0.0,0.0,0.0,2021
Charles Bassey,C,21,23,168,30,47,0.638,0,4,0.0,30,43,0.698,9,12,0.75,22,40,62,7,5,17,8,32,69,0.4,0.3,0.8,2021
Keita Bates-Diop,SF,26,59,957,136,263,0.517,17,55,0.309,119,208,0.572,46,61,0.754,62,169,231,41,27,14,45,61,335,0.6,1.0,1.6,2021
Nicolas Batum,PF,33,59,1463,179,387,0.463,108,270,0.4,71,117,0.607,25,38,0.658,29,225,254,100,58,42,40,80,491,1.6,2.1,3.7,2021
Kent Bazemore,SF,32,39,545,45,139,0.324,29,80,0.363,16,59,0.271,13,17,0.765,13,56,69,34,25,9,21,70,132,-0.4,0.5,0.1,2021
Darius Bazley,PF,21,69,1924,274,649,0.422,80,269,0.297,194,380,0.511,117,170,0.688,71,365,436,97,58,70,90,68,745,-0.5,2.2,1.8,2021
Bradley Beal,SG,28,40,1439,348,771,0.451,63,210,0.3,285,561,0.508,169,203,0.833,38,151,189,265,36,15,135,95,928,0.6,0.7,1.4,2021
Malik Beasley,SG,25,79,1976,332,850,0.391,240,637,0.377,92,213,0.432,49,60,0.817,26,201,227,116,43,12,43,88,953,1.7,1.2,2.9,2021
Jordan Bell,C,27,1,2,0,0,0.0,0,0,0.0,0,0,0.0,0,0,0.0,1,0,1,0,1,0,0,2,0,0.0,0.0,0.0,2021
DeAndre' Bembry,SF,27,56,1026,124,221,0.561,15,36,0.417,109,185,0.589,21,35,0.6,42,121,163,66,49,25,31,113,284,1.1,1.1,2.2,2021
Dāvis Bertāns,PF,29,56,806,99,275,0.36,77,230,0.335,22,45,0.489,36,40,0.9,12,105,117,31,17,12,19,85,311,0.2,0.7,0.9,2021
Patrick Beverley,PG,33,58,1476,177,436,0.406,83,242,0.343,94,194,0.485,96,133,0.722,62,178,240,268,67,52,73,174,533,2.3,1.7,4.1,2021
Saddiq Bey,SF,22,82,2704,450,1136,0.396,211,610,0.346,239,526,0.454,210,254,0.827,107,334,441,233,73,16,96,128,1321,2.4,1.6,4.0,2021
Khem Birch,C,29,55,991,97,200,0.485,0,14,0.0,97,186,0.522,53,71,0.746,122,117,239,56,30,26,29,104,247,1.5,1.1,2.6,2021
Goga Bitadze,C,22,50,729,131,252,0.52,23,80,0.288,108,172,0.628,64,94,0.681,79,98,177,55,21,42,46,107,349,1.3,0.6,1.9,2021
Bismack Biyombo,C,29,36,506,86,145,0.593,0,0,0.0,86,145,0.593,38,71,0.535,63,104,167,23,12,26,25,70,210,0.9,0.9,1.8,2021
Nemanja Bjelica,C,33,71,1143,160,342,0.468,54,149,0.362,106,193,0.549,59,81,0.728,62,232,294,159,41,26,87,128,433,1.0,2.1,3.0,2021
Eric Bledsoe,PG,32,54,1361,197,468,0.421,51,163,0.313,146,305,0.479,89,117,0.761,28,154,182,225,69,19,116,85,534,-0.5,1.8,1.3,2021
Keljin Blevins,SF,26,31,349,34,111,0.306,21,72,0.292,13,39,0.333,6,11,0.545,16,29,45,19,13,1,17,29,95,-0.6,0.1,-0.5,2021
Bogdan Bogdanović,SG,29,63,1848,342,794,0.431,169,459,0.368,173,335,0.516,97,115,0.843,29,221,250,194,68,14,70,132,950,2.5,1.2,3.7,2021
Bojan Bogdanović,PF,32,69,2131,422,928,0.455,181,468,0.387,241,460,0.524,223,260,0.858,58,238,296,120,34,1,118,116,1248,3.6,1.6,5.2,2021
Bol Bol,PF,22,14,81,15,27,0.556,1,4,0.25,14,23,0.609,2,5,0.4,4,16,20,5,1,2,4,4,33,0.0,0.1,0.1,2021
Leandro Bolmaro,SF,21,35,241,17,54,0.315,5,18,0.278,12,36,0.333,11,13,0.846,16,27,43,21,6,0,13,26,50,-0.1,0.2,0.0,2021
Isaac Bonga,SF,22,15,69,3,13,0.231,1,4,0.25,2,9,0.222,5,8,0.625,4,3,7,4,8,2,2,10,12,-0.1,0.1,0.1,2021
Devin Booker,SG,25,68,2345,662,1421,0.466,183,478,0.383,479,943,0.508,315,363,0.868,45,297,342,329,77,26,162,180,1822,4.3,3.3,7.6,2021
Brandon Boston Jr.,SG,20,51,760,125,325,0.385,34,111,0.306,91,214,0.425,59,72,0.819,17,94,111,51,26,13,31,43,343,-0.5,0.9,0.4,2021
Chris Boucher,SF,29,80,1690,268,577,0.464,68,229,0.297,200,348,0.575,150,193,0.777,179,315,494,25,49,75,42,174,754,3.5,2.4,6.0,2021
James Bouknight,SG,21,31,304,49,141,0.348,17,49,0.347,32,92,0.348,27,31,0.871,22,30,52,26,7,1,15,29,142,-0.1,0.1,0.0,2021
Avery Bradley,SG,31,62,1406,148,350,0.423,82,210,0.39,66,140,0.471,16,18,0.889,31,105,136,47,53,9,38,118,394,0.3,0.9,1.2,2021
Tony Bradley,C,24,55,549,72,123,0.585,0,0,0.0,72,123,0.585,19,29,0.655,67,119,186,27,10,33,34,62,163,0.6,0.7,1.3,2021
Ignas Brazdeikis,SF,23,42,536,81,188,0.431,27,87,0.31,54,101,0.535,21,32,0.656,23,49,72,37,10,3,17,48,210,0.2,0.3,0.5,2021
Mikal Bridges,SF,25,82,2854,458,858,0.534,115,312,0.369,343,546,0.628,131,157,0.834,74,273,347,185,96,36,68,150,1162,5.2,3.7,8.9,2021
Miles Bridges,PF,23,80,2837,596,1214,0.491,154,465,0.331,442,749,0.59,267,333,0.802,90,469,559,300,74,67,150,193,1613,5.0,2.3,7.2,2021
Oshae Brissett,SF,23,67,1564,208,506,0.411,83,237,0.35,125,269,0.465,114,164,0.695,108,250,358,72,44,29,54,116,613,1.4,0.9,2.2,2021
Malcolm Brogdon,PG,29,36,1206,243,543,0.448,58,186,0.312,185,357,0.518,143,167,0.856,33,152,185,212,30,14,77,71,687,2.2,0.4,2.7,2021
Armoni Brooks,SG,23,54,844,98,289,0.339,74,249,0.297,24,40,0.6,18,21,0.857,20,83,103,62,28,11,27,74,288,-0.1,0.4,0.2,2021
Dillon Brooks,SF,26,32,885,227,526,0.432,46,149,0.309,181,377,0.48,90,106,0.849,29,73,102,88,36,8,50,105,590,0.7,0.9,1.6,2021
Bruce Brown,SF,25,72,1774,256,506,0.506,38,94,0.404,218,412,0.529,97,128,0.758,100,245,345,148,77,52,56,176,647,2.8,2.0,4.8,2021
Charlie Brown Jr.,SG,24,22,178,10,39,0.256,1,12,0.083,9,27,0.333,9,10,0.9,14,18,32,6,10,4,5,18,30,-0.2,0.2,0.0,2021
Chaundee Brown Jr.,SG,23,5,104,10,32,0.313,6,18,0.333,4,14,0.286,5,6,0.833,1,15,16,4,2,0,1,7,31,0.0,0.0,0.0,2021
Greg Brown III,SF,20,48,640,81,190,0.426,19,61,0.311,62,129,0.481,44,65,0.677,38,97,135,35,26,24,36,90,225,-0.1,0.5,0.4,2021
Jaylen Brown,SF,25,66,2220,576,1217,0.473,166,464,0.358,410,753,0.544,241,318,0.758,53,351,404,231,70,18,178,163,1559,2.3,3.4,5.8,2021
Moses Brown,C,22,40,344,64,108,0.593,0,0,0.0,64,108,0.593,43,72,0.597,39,96,135,1,7,16,20,53,171,0.5,0.7,1.2,2021
Sterling Brown,SG,26,49,628,59,155,0.381,28,92,0.304,31,63,0.492,14,15,0.933,26,123,149,34,14,7,23,56,160,-0.1,0.9,0.8,2021
Troy Brown Jr.,SF,22,66,1055,108,258,0.419,47,133,0.353,61,125,0.488,20,26,0.769,39,164,203,66,36,5,26,62,283,0.5,0.9,1.4,2021
Jalen Brunson,SG,25,79,2524,506,1008,0.502,94,252,0.373,412,756,0.545,179,213,0.84,43,266,309,377,66,3,124,151,1285,4.9,2.7,7.5,2021
Thomas Bryant,C,24,27,439,77,148,0.52,12,42,0.286,65,106,0.613,35,40,0.875,26,82,108,23,6,21,19,43,201,0.7,0.4,1.1,2021
Shaq Buchanan,SG,25,2,10,1,4,0.25,0,2,0.0,1,2,0.5,0,0,0.0,1,1,2,2,1,0,2,1,2,-0.1,0.0,0.0,2021
Reggie Bullock,SF,30,68,1902,201,501,0.401,141,392,0.36,60,109,0.55,40,48,0.833,33,208,241,83,41,14,40,111,583,1.2,2.0,3.2,2021
Trey Burke,PG,29,42,441,84,215,0.391,26,82,0.317,58,133,0.436,20,23,0.87,4,29,33,57,12,0,26,39,214,-0.4,0.4,0.0,2021
Alec Burks,SG,30,81,2318,285,728,0.391,157,389,0.404,128,339,0.378,217,264,0.822,47,350,397,239,85,26,91,215,944,3.2,2.9,6.1,2021
Jared Butler,SG,21,42,360,61,151,0.404,28,88,0.318,33,63,0.524,11,16,0.688,5,40,45,63,17,8,33,47,161,0.0,0.5,0.4,2021
Jimmy Butler,SF,32,57,1931,398,829,0.48,27,116,0.233,371,713,0.52,396,455,0.87,102,234,336,312,94,27,121,88,1219,6.2,2.9,9.2,2021
Devontae Cacok,PF,25,15,121,21,31,0.677,0,0,0.0,21,31,0.677,4,7,0.571,8,34,42,6,8,7,3,16,46,0.3,0.3,0.5,2021
Kentavious Caldwell-Pope,SG,28,77,2329,361,829,0.435,159,408,0.39,202,421,0.48,137,154,0.89,41,220,261,145,83,26,97,139,1018,1.4,1.4,2.8,2021
Facundo Campazzo,PG,30,65,1184,107,296,0.361,58,193,0.301,49,103,0.476,60,78,0.769,23,94,117,220,63,23,67,124,332,0.6,1.3,2.0,2021
Vlatko Čančar,PF,24,15,176,23,41,0.561,7,12,0.583,16,29,0.552,9,14,0.643,8,23,31,17,2,3,9,18,62,0.3,0.1,0.4,2021
Devin Cannady,PG,25,5,145,15,44,0.341,15,37,0.405,0,7,0.0,5,7,0.714,1,5,6,10,5,3,5,9,50,0.0,0.1,0.1,2021
Clint Capela,C,27,74,2042,370,604,0.613,0,1,0.0,370,603,0.614,80,169,0.473,279,598,877,92,55,93,44,166,820,5.6,2.7,8.3,2021
Vernon Carey Jr.,C,20,7,44,7,13,0.538,0,0,0.0,7,13,0.538,6,13,0.462,8,4,12,0,2,1,3,4,20,0.0,0.0,0.1,2021
Jevon Carter,PG,26,66,905,98,253,0.387,66,170,0.388,32,83,0.386,15,18,0.833,14,96,110,96,24,14,34,67,277,0.5,0.7,1.2,2021
Wendell Carter Jr.,PF,22,62,1852,359,684,0.525,70,214,0.327,289,470,0.615,143,207,0.691,139,509,648,171,36,43,117,169,931,2.6,2.4,5.0,2021
Alex Caruso,SG,27,41,1147,102,256,0.398,42,126,0.333,60,130,0.462,58,73,0.795,33,115,148,165,71,15,57,106,304,0.7,1.2,2.0,2021
Willie Cauley-Stein,C,28,20,183,16,35,0.457,1,2,0.5,15,33,0.455,1,2,0.5,13,27,40,10,6,3,7,19,34,0.0,0.3,0.2,2021
Ahmad Caver,SG,25,1,1,1,1,1.0,0,0,0.0,1,1,1.0,0,0,0.0,0,0,0,0,0,0,0,0,2,0.0,0.0,0.0,2021
Justin Champagnie,SF,20,36,281,31,67,0.463,10,28,0.357,21,39,0.538,9,9,1.0,37,35,72,11,8,4,8,32,81,0.5,0.3,0.8,2021
Zylan Cheatham,SF,26,1,5,0,3,0.0,0,2,0.0,0,1,0.0,0,0,0.0,0,0,0,0,0,0,0,0,0,-0.1,0.0,-0.1,2021
Chris Chiozza,PG,26,34,372,24,81,0.296,17,53,0.321,7,28,0.25,2,3,0.667,9,27,36,65,13,0,32,32,67,-0.5,0.5,0.0,2021
Marquese Chriss,PF,24,34,346,62,134,0.463,8,25,0.32,54,109,0.495,22,33,0.667,33,70,103,17,13,12,17,64,154,0.2,0.6,0.8,2021
Josh Christopher,SG,20,74,1334,224,500,0.448,56,189,0.296,168,311,0.54,83,113,0.735,52,134,186,150,65,13,114,97,587,-0.4,0.7,0.3,2021
Gary Clark,PF,27,38,378,33,88,0.375,28,70,0.4,5,18,0.278,7,10,0.7,23,67,90,18,13,7,10,20,101,0.3,0.4,0.7,2021
Brandon Clarke,PF,25,64,1246,288,447,0.644,5,22,0.227,283,425,0.666,85,130,0.654,135,207,342,86,39,68,34,122,666,4.4,1.9,6.3,2021
Jordan Clarkson,SG,29,79,2141,466,1113,0.419,190,597,0.318,276,516,0.535,144,174,0.828,67,206,273,194,66,16,129,149,1266,1.5,2.0,3.5,2021
Nic Claxton,C,22,47,974,178,264,0.674,0,0,0.0,178,264,0.674,54,93,0.581,91,173,264,43,24,51,38,110,410,2.3,1.2,3.5,2021
Amir Coffey,SG,24,69,1567,211,466,0.453,96,254,0.378,115,212,0.542,101,117,0.863,26,171,197,124,38,15,45,87,619,2.3,1.5,3.8,2021
John Collins,PF,24,54,1663,339,644,0.526,64,176,0.364,275,468,0.588,134,169,0.793,93,329,422,98,33,56,60,164,876,3.6,1.4,5.1,2021
Zach Collins,C,24,28,502,76,155,0.49,14,41,0.341,62,114,0.544,52,65,0.8,46,107,153,61,13,23,45,67,218,0.6,0.7,1.2,2021
Darren Collison,PG,34,3,37,2,7,0.286,0,3,0.0,2,4,0.5,0,0,0.0,0,4,4,2,1,0,1,5,4,-0.1,0.0,-0.1,2021
Mike Conley,PG,34,72,2058,344,791,0.435,169,414,0.408,175,377,0.464,129,162,0.796,47,170,217,385,96,21,123,142,986,4.4,2.3,6.7,2021
Pat Connaughton,SF,29,65,1691,227,496,0.458,146,370,0.395,81,126,0.643,45,54,0.833,45,228,273,82,59,15,35,86,645,2.8,1.6,4.4,2021
Tyler Cook,PF,24,20,200,23,38,0.605,0,0,0.0,23,38,0.605,21,32,0.656,16,37,53,3,4,4,7,28,67,0.4,0.2,0.5,2021
Sharife Cooper,PG,20,13,39,3,14,0.214,1,6,0.167,2,8,0.25,0,0,0.0,0,5,5,5,0,0,5,1,7,-0.2,0.0,-0.2,2021
Petr Cornelie,PF,26,13,38,5,15,0.333,1,8,0.125,4,7,0.571,3,4,0.75,7,7,14,3,1,1,4,7,14,-0.1,0.0,0.0,2021
DeMarcus Cousins,C,31,48,717,149,324,0.46,37,122,0.303,112,202,0.554,95,125,0.76,74,196,270,71,35,21,85,139,430,0.3,1.3,1.6,2021
Robert Covington,PF,31,71,1939,209,498,0.42,128,339,0.378,81,159,0.509,58,69,0.841,59,332,391,92,103,91,75,190,604,0.8,2.4,3.2,2021
Torrey Craig,SF,31,78,1596,200,441,0.454,77,234,0.329,123,207,0.594,39,52,0.75,86,224,310,91,46,36,67,151,516,0.9,1.4,2.3,2021
Jae Crowder,PF,31,67,1886,217,544,0.399,127,365,0.348,90,179,0.503,71,90,0.789,30,324,354,124,95,30,55,173,632,0.9,3.4,4.3,2021
Jarrett Culver,SG,22,37,338,51,135,0.378,12,47,0.255,39,88,0.443,16,34,0.471,13,35,48,33,20,5,20,42,130,-0.4,0.5,0.1,2021
Jarron Cumberland,SG,24,3,12,1,2,0.5,0,1,0.0,1,1,1.0,0,0,0.0,1,2,3,1,0,0,0,2,2,0.0,0.0,0.0,2021
Cade Cunningham,SG,20,64,2088,429,1031,0.416,114,363,0.314,315,668,0.472,142,168,0.845,58,296,354,356,78,43,234,200,1114,-2.4,1.9,-0.5,2021
Seth Curry,SG,31,64,2134,360,739,0.487,158,374,0.422,202,365,0.553,82,94,0.872,21,179,200,230,53,14,109,148,960,2.7,1.5,4.2,2021
Stephen Curry,PG,33,64,2211,535,1224,0.437,285,750,0.38,250,474,0.527,275,298,0.923,34,301,335,404,85,23,206,130,1630,4.6,3.4,8.0,2021
Anthony Davis,C,28,40,1404,370,695,0.532,13,70,0.186,357,625,0.571,174,244,0.713,106,288,394,122,49,90,82,97,927,2.6,2.0,4.5,2021
Ed Davis,C,32,31,201,11,16,0.688,0,0,0.0,11,16,0.688,6,14,0.429,14,50,64,7,3,9,5,33,28,0.2,0.3,0.5,2021
Terence Davis,SG,24,30,536,113,267,0.423,49,149,0.329,64,118,0.542,36,44,0.818,11,83,94,40,25,11,33,70,311,0.0,0.5,0.5,2021
Gabriel Deck,PF,26,7,56,8,14,0.571,2,4,0.5,6,10,0.6,0,0,0.0,1,5,6,5,1,0,2,2,18,0.1,0.0,0.1,2021
Dewayne Dedmon,C,32,67,1065,164,290,0.566,19,47,0.404,145,243,0.597,75,100,0.75,105,281,386,47,24,42,70,174,422,1.5,2.0,3.5,2021
Sam Dekker,PF,27,1,1,0,0,0.0,0,0,0.0,0,0,0.0,0,0,0.0,0,0,0,0,0,0,0,0,0,0.0,0.0,0.0,2021
Javin DeLaurier,C,23,1,3,0,0,0.0,0,0,0.0,0,0,0.0,0,0,0.0,0,1,1,0,1,0,0,1,0,0.0,0.0,0.0,2021
DeMar DeRozan,PF,32,76,2743,774,1535,0.504,50,142,0.352,724,1393,0.52,520,593,0.877,56,336,392,374,68,24,181,178,2118,7.0,1.8,8.8,2021
Mamadi Diakite,PF,25,13,188,25,47,0.532,0,5,0.0,25,42,0.595,6,11,0.545,17,42,59,2,5,9,7,33,56,0.1,0.3,0.3,2021
Cheick Diallo,C,25,3,31,3,8,0.375,0,0,0.0,3,8,0.375,5,6,0.833,4,8,12,0,1,0,1,6,11,0.0,0.0,0.1,2021
Hamidou Diallo,SG,23,58,1269,261,526,0.496,23,93,0.247,238,433,0.55,91,140,0.65,69,208,277,73,71,17,58,143,636,0.6,1.5,2.1,2021
Gorgui Dieng,C,32,44,371,53,112,0.473,29,68,0.426,24,44,0.545,19,26,0.731,32,89,121,34,11,13,20,52,154,0.8,0.4,1.2,2021
Spencer Dinwiddie,PG,28,67,1980,306,735,0.416,112,330,0.339,194,405,0.479,195,252,0.774,45,234,279,346,44,13,104,150,919,2.7,1.4,4.1,2021
Donte DiVincenzo,SG,25,42,1005,118,336,0.351,74,218,0.339,44,118,0.373,70,83,0.843,40,130,170,118,48,8,72,69,380,-0.1,0.9,0.7,2021
Luka Dončić,PG,22,65,2301,641,1403,0.457,201,569,0.353,440,834,0.528,364,489,0.744,56,537,593,568,75,36,292,145,1847,3.8,3.8,7.6,2021
Luguentz Dort,SG,22,51,1665,293,726,0.404,130,391,0.332,163,335,0.487,161,191,0.843,38,174,212,88,46,18,88,149,877,0.2,1.1,1.4,2021
Ayo Dosunmu,SG,22,77,2110,278,535,0.52,70,186,0.376,208,349,0.596,53,78,0.679,27,187,214,256,60,29,108,182,679,1.7,1.3,3.0,2021
Damyean Dotson,SG,27,2,21,2,4,0.5,0,1,0.0,2,3,0.667,0,0,0.0,0,2,2,1,0,0,0,0,4,0.0,0.0,0.0,2021
Devon Dotson,PG,22,11,85,11,23,0.478,2,9,0.222,9,14,0.643,5,9,0.556,1,8,9,15,1,0,5,11,29,0.1,0.0,0.1,2021
Sekou Doumbouya,PF,21,2,16,5,8,0.625,1,2,0.5,4,6,0.667,3,4,0.75,2,4,6,0,3,2,2,1,14,0.0,0.1,0.1,2021
Jeff Dowtin,PG,24,9,108,8,26,0.308,1,9,0.111,7,17,0.412,2,2,1.0,8,10,18,10,5,1,5,5,19,-0.1,0.1,0.0,2021
PJ Dozier,SG,25,18,340,36,99,0.364,15,48,0.313,21,51,0.412,10,13,0.769,14,49,63,29,11,6,13,33,97,-0.1,0.4,0.3,2021
Goran Dragić,PG,35,21,497,57,151,0.377,16,63,0.254,41,88,0.466,27,33,0.818,13,52,65,86,19,4,34,45,157,-0.1,0.4,0.4,2021
Andre Drummond,C,28,73,1437,247,433,0.57,0,3,0.0,247,430,0.574,86,164,0.524,229,451,680,131,78,68,115,192,580,2.0,3.1,5.1,2021
Chris Duarte,SG,24,55,1541,268,621,0.432,94,255,0.369,174,366,0.475,90,112,0.804,41,185,226,114,56,10,90,95,720,0.2,0.7,0.9,2021
David Duke Jr.,PG,22,22,341,39,108,0.361,9,37,0.243,30,71,0.423,17,21,0.81,30,37,67,17,14,7,9,36,104,0.0,0.3,0.3,2021
Kris Dunn,PG,27,14,336,44,102,0.431,1,11,0.091,43,91,0.473,17,18,0.944,9,40,49,79,23,3,32,38,106,-0.1,0.3,0.2,2021
Kevin Durant,PF,33,55,2047,578,1115,0.518,115,300,0.383,463,815,0.568,372,409,0.91,29,378,407,351,48,52,191,113,1643,6.4,2.0,8.4,2021
Jaime Echenique,C,24,1,3,0,0,0.0,0,0,0.0,0,0,0.0,0,0,0.0,0,0,0,0,0,0,0,0,0,0.0,0.0,0.0,2021
Anthony Edwards,SG,20,72,2466,549,1245,0.441,215,602,0.357,334,643,0.519,220,280,0.786,62,281,343,275,105,46,190,164,1533,1.8,2.4,4.3,2021
Carsen Edwards,SG,23,4,79,9,30,0.3,4,16,0.25,5,14,0.357,1,1,1.0,2,4,6,14,2,0,5,4,23,-0.1,0.0,-0.1,2021
Kessler Edwards,SF,21,48,987,110,267,0.412,48,136,0.353,62,131,0.473,16,19,0.842,44,128,172,31,29,24,42,85,284,-0.2,0.9,0.6,2021
Rob Edwards,SG,25,2,11,1,4,0.25,1,4,0.25,0,0,0.0,0,0,0.0,0,3,3,0,0,0,1,0,3,-0.1,0.0,0.0,2021
CJ Elleby,SF,21,58,1174,121,308,0.393,37,126,0.294,84,182,0.462,60,84,0.714,66,161,227,87,35,19,56,116,339,-0.1,0.5,0.4,2021
Wayne Ellington,SG,34,43,810,98,237,0.414,82,211,0.389,16,26,0.615,9,11,0.818,10,67,77,30,23,5,19,42,287,0.6,0.4,1.0,2021
Joel Embiid,C,27,68,2297,666,1334,0.499,93,251,0.371,573,1083,0.529,654,803,0.814,146,650,796,284,77,99,214,181,2079,7.9,4.1,12.0,2021
James Ennis III,SF,31,7,56,11,24,0.458,3,8,0.375,8,16,0.5,4,5,0.8,5,7,12,3,2,2,2,5,29,0.1,0.1,0.1,2021
Drew Eubanks,C,24,71,1245,221,371,0.596,5,23,0.217,216,348,0.621,99,130,0.762,130,252,382,85,31,40,81,122,546,2.2,1.1,3.4,2021
Tacko Fall,C,26,11,59,5,12,0.417,0,0,0.0,5,12,0.417,2,7,0.286,7,16,23,2,0,6,3,3,12,-0.1,0.1,0.1,2021
Derrick Favors,C,30,39,653,94,182,0.516,2,16,0.125,92,166,0.554,16,25,0.64,58,126,184,25,17,12,9,62,206,0.8,0.7,1.4,2021
Bruno Fernando,C,23,30,153,36,55,0.655,1,2,0.5,35,53,0.66,15,24,0.625,18,37,55,7,1,11,14,24,88,0.2,0.2,0.4,2021
Dorian Finney-Smith,PF,28,80,2644,326,692,0.471,172,435,0.395,154,257,0.599,56,83,0.675,122,253,375,150,88,39,80,183,880,3.4,3.2,6.6,2021
Malik Fitts,PF,24,15,63,8,19,0.421,5,10,0.5,3,9,0.333,0,0,0.0,2,15,17,5,0,0,2,4,21,0.1,0.1,0.1,2021
Malachi Flynn,PG,23,44,537,72,183,0.393,30,90,0.333,42,93,0.452,15,24,0.625,10,53,63,70,20,4,13,45,189,0.5,0.5,1.0,2021
Bryn Forbes,SG,28,75,1286,231,539,0.429,122,295,0.414,109,244,0.447,79,87,0.908,10,83,93,75,25,5,56,95,663,0.8,0.6,1.4,2021
Aleem Ford,SF,24,5,74,6,20,0.3,2,15,0.133,4,5,0.8,0,0,0.0,2,13,15,2,1,0,4,7,14,-0.2,0.1,-0.2,2021
Trent Forrest,PG,23,60,765,76,155,0.49,5,27,0.185,71,128,0.555,38,48,0.792,23,76,99,106,30,6,48,43,195,0.5,0.8,1.3,2021
Evan Fournier,SG,29,80,2358,402,965,0.417,241,619,0.389,161,346,0.465,80,113,0.708,34,176,210,171,79,20,105,180,1125,1.5,2.2,3.7,2021
De'Aaron Fox,PG,24,59,2084,516,1092,0.473,74,249,0.297,442,843,0.524,261,348,0.75,25,206,231,330,68,25,168,172,1367,1.5,1.0,2.5,2021
Melvin Frazier,SG,25,3,120,13,48,0.271,1,21,0.048,12,27,0.444,5,7,0.714,5,8,13,1,1,0,3,8,32,-0.4,0.0,-0.4,2021
Tim Frazier,PG,31,12,208,14,45,0.311,6,17,0.353,8,28,0.286,5,9,0.556,5,14,19,34,3,1,15,27,39,-0.3,0.1,-0.2,2021
Enes Freedom,C,29,35,411,51,97,0.526,2,5,0.4,49,92,0.533,24,28,0.857,61,99,160,8,5,14,20,42,128,0.6,0.7,1.4,2021
Markelle Fultz,PG,23,18,360,83,175,0.474,4,17,0.235,79,158,0.5,25,31,0.806,4,45,49,99,20,5,40,22,195,0.0,0.4,0.4,2021
Wenyen Gabriel,PF,24,26,359,54,110,0.491,8,28,0.286,46,82,0.561,25,42,0.595,39,58,97,14,5,11,16,68,141,0.4,0.3,0.7,2021
Daniel Gafford,C,23,72,1444,285,411,0.693,0,1,0.0,285,410,0.695,107,153,0.699,155,252,407,68,30,99,65,170,677,4.4,1.6,6.0,2021
Danilo Gallinari,PF,33,66,1672,259,597,0.434,112,294,0.381,147,303,0.485,141,156,0.904,35,273,308,101,28,12,38,93,771,2.8,0.8,3.6,2021
Langston Galloway,SG,30,7,107,6,26,0.231,2,16,0.125,4,10,0.4,0,0,0.0,3,15,18,12,1,0,6,7,14,-0.3,0.1,-0.2,2021
Darius Garland,PG,22,68,2430,542,1173,0.462,174,454,0.383,368,719,0.512,215,241,0.892,39,185,224,583,89,7,248,115,1473,3.8,2.5,6.3,2021
Marcus Garrett,SG,23,12,128,5,21,0.238,1,4,0.25,4,17,0.235,2,5,0.4,9,14,23,7,5,3,2,16,13,-0.1,0.2,0.1,2021
Usman Garuba,PF,19,24,240,19,44,0.432,5,20,0.25,14,24,0.583,5,7,0.714,21,62,83,17,10,11,6,28,48,0.2,0.3,0.5,2021
Luka Garza,C,23,32,389,66,147,0.449,16,49,0.327,50,98,0.51,38,61,0.623,58,42,100,20,9,6,18,55,186,0.5,0.2,0.8,2021
Rudy Gay,PF,35,55,1038,157,379,0.414,70,203,0.345,87,176,0.494,62,79,0.785,55,187,242,56,25,19,47,95,446,0.8,1.3,2.1,2021
Paul George,PF,31,31,1077,268,636,0.421,91,257,0.354,177,379,0.467,127,148,0.858,12,201,213,176,67,13,126,74,754,-0.6,1.9,1.3,2021
Taj Gibson,C,36,52,946,86,166,0.518,15,38,0.395,71,128,0.555,42,52,0.808,88,141,229,32,22,40,27,137,229,1.4,1.2,2.7,2021
Josh Giddey,SF,19,54,1700,281,670,0.419,56,213,0.263,225,457,0.492,56,79,0.709,98,323,421,345,51,20,171,88,674,-1.3,1.7,0.4,2021
Shai Gilgeous-Alexander,PG,23,56,1942,477,1052,0.453,89,297,0.3,388,755,0.514,328,405,0.81,37,241,278,331,71,46,154,142,1371,2.8,1.8,4.6,2021
Anthony Gill,PF,29,44,463,62,109,0.569,14,26,0.538,48,83,0.578,42,52,0.808,33,52,85,27,5,11,18,58,180,1.1,0.2,1.4,2021
Freddie Gillespie,PF,24,9,119,9,22,0.409,0,1,0.0,9,21,0.429,3,7,0.429,13,23,36,5,3,9,5,18,21,-0.1,0.2,0.1,2021
Rudy Gobert,C,29,66,2120,362,508,0.713,0,4,0.0,362,504,0.718,303,439,0.69,241,727,968,72,45,137,119,176,1027,7.3,4.3,11.7,2021
Brandon Goodwin,PG,26,36,502,64,154,0.416,19,55,0.345,45,99,0.455,24,38,0.632,14,53,67,91,25,1,36,39,171,0.1,0.7,0.7,2021
Jordan Goodwin,SG,23,2,6,0,3,0.0,0,1,0.0,0,2,0.0,0,0,0.0,0,1,1,0,0,0,0,1,0,-0.1,0.0,-0.1,2021
Aaron Gordon,PF,26,75,2376,434,834,0.52,87,260,0.335,347,574,0.605,171,230,0.743,125,314,439,188,44,44,133,148,1126,3.2,2.0,5.2,2021
Eric Gordon,SG,33,57,1670,268,564,0.475,124,301,0.412,144,263,0.548,105,135,0.778,15,98,113,154,28,18,107,63,765,1.5,-0.1,1.4,2021
Devonte' Graham,PG,26,76,2162,296,815,0.363,192,563,0.341,104,252,0.413,118,140,0.843,37,140,177,316,71,12,105,95,902,1.6,1.2,2.8,2021
Jerami Grant,PF,27,47,1500,298,699,0.426,91,254,0.358,207,445,0.465,217,259,0.838,28,163,191,111,44,49,85,107,904,1.2,1.1,2.3,2021
Hassani Gravett,PG,25,8,171,18,38,0.474,11,26,0.423,7,12,0.583,3,4,0.75,1,20,21,20,5,1,9,13,50,0.1,0.1,0.3,2021
Danny Green,SF,34,62,1353,126,320,0.394,103,271,0.38,23,49,0.469,11,14,0.786,32,125,157,64,60,37,45,105,366,0.3,1.6,1.9,2021
Draymond Green,PF,31,46,1329,135,257,0.525,16,54,0.296,119,203,0.586,60,91,0.659,45,291,336,320,61,50,139,136,346,0.8,2.8,3.6,2021
Jalen Green,SG,19,67,2138,406,954,0.426,157,458,0.343,249,496,0.502,188,236,0.797,33,193,226,176,44,18,135,103,1157,0.5,0.2,0.7,2021
JaMychal Green,PF,31,67,1085,159,327,0.486,33,124,0.266,126,203,0.621,81,93,0.871,81,200,281,59,43,26,57,158,432,1.2,1.4,2.7,2021
Javonte Green,SF,28,65,1519,176,325,0.542,36,101,0.356,140,224,0.625,80,96,0.833,91,185,276,60,67,32,30,132,468,2.9,1.5,4.4,2021
Jeff Green,PF,35,75,1849,277,529,0.524,53,168,0.315,224,361,0.62,165,198,0.833,41,190,231,96,28,27,71,151,772,2.7,1.2,3.9,2021
Josh Green,SG,21,67,1039,130,256,0.508,28,78,0.359,102,178,0.573,31,45,0.689,52,109,161,79,45,14,44,115,319,1.0,1.4,2.4,2021
Blake Griffin,C,32,56,958,133,313,0.425,38,145,0.262,95,168,0.565,55,76,0.724,60,168,228,105,27,14,31,95,359,1.2,0.9,2.1,2021
Quentin Grimes,SG,21,46,786,95,235,0.404,72,189,0.381,23,46,0.5,13,19,0.684,24,70,94,44,31,11,28,72,275,0.6,0.9,1.4,2021
Kyle Guy,SG,24,19,186,26,65,0.4,14,40,0.35,12,25,0.48,8,12,0.667,4,13,17,17,7,1,13,12,74,-0.1,0.2,0.1,2021
Rui Hachimura,PF,23,42,943,187,381,0.491,55,123,0.447,132,258,0.512,46,66,0.697,25,135,160,48,23,9,33,53,475,0.9,0.6,1.4,2021
Tyrese Haliburton,SG,21,77,2694,430,909,0.473,161,389,0.414,269,520,0.517,160,190,0.842,61,250,311,628,134,49,199,121,1181,5.2,1.8,7.0,2021
Tyler Hall,SG,24,1,2,0,0,0.0,0,0,0.0,0,0,0.0,0,0,0.0,0,0,0,0,0,0,0,0,0,0.0,0.0,0.0,2021
R.J. Hampton,SG,20,64,1402,175,457,0.383,64,183,0.35,111,274,0.405,75,117,0.641,23,171,194,158,42,13,87,101,489,-1.3,1.1,-0.2,2021
Tim Hardaway Jr.,SG,29,42,1245,209,530,0.394,102,304,0.336,107,226,0.473,78,103,0.757,13,143,156,92,38,6,34,74,598,0.5,1.5,2.0,2021
James Harden,PG,32,65,2420,407,992,0.41,148,448,0.33,259,544,0.476,470,536,0.877,55,445,500,667,82,36,284,153,1432,4.9,2.7,7.6,2021
Maurice Harkless,SF,28,47,863,83,181,0.459,31,101,0.307,52,80,0.65,20,28,0.714,12,100,112,23,29,24,31,77,217,-0.1,0.6,0.5,2021
Jared Harper,PG,24,5,43,14,26,0.538,5,12,0.417,9,14,0.643,4,4,1.0,2,0,2,14,4,1,2,5,37,0.3,0.1,0.4,2021
Montrezl Harrell,C,28,71,1640,358,555,0.645,4,17,0.235,354,538,0.658,212,296,0.716,149,282,431,145,29,43,72,137,932,6.1,1.2,7.3,2021
Gary Harris,SG,27,61,1730,240,553,0.434,116,302,0.384,124,251,0.494,83,95,0.874,36,86,122,108,59,9,61,112,679,1.1,1.0,2.2,2021
Joe Harris,SF,30,14,423,56,124,0.452,41,88,0.466,15,36,0.417,5,6,0.833,5,51,56,14,7,2,16,31,158,0.3,0.2,0.5,2021
Tobias Harris,PF,29,73,2543,493,1022,0.482,101,275,0.367,392,747,0.525,170,202,0.842,77,419,496,252,47,43,116,164,1257,3.0,2.6,5.6,2021
Shaquille Harrison,SG,28,2,23,2,6,0.333,0,2,0.0,2,4,0.5,0,0,0.0,1,3,4,3,1,1,2,3,4,-0.1,0.0,0.0,2021
Josh Hart,SG,26,54,1791,287,569,0.504,73,213,0.343,214,356,0.601,160,211,0.758,62,326,388,224,61,13,114,150,807,2.8,1.5,4.4,2021
Isaiah Hartenstein,C,23,68,1216,229,366,0.626,14,30,0.467,215,336,0.64,91,132,0.689,117,215,332,160,50,77,84,167,563,3.3,2.2,5.5,2021
Udonis Haslem,C,41,13,83,14,31,0.452,1,4,0.25,13,27,0.481,3,3,1.0,4,21,25,4,1,1,5,15,32,-0.1,0.1,0.1,2021
Sam Hauser,SF,24,26,158,23,50,0.46,19,44,0.432,4,6,0.667,0,0,0.0,5,24,29,10,1,2,2,7,65,0.4,0.2,0.6,2021
Jaxson Hayes,C,21,70,1398,245,398,0.616,20,57,0.351,225,341,0.66,144,188,0.766,115,200,315,43,33,55,54,155,654,3.7,1.3,5.1,2021
Killian Hayes,PG,20,66,1647,176,459,0.383,44,167,0.263,132,292,0.452,57,74,0.77,36,174,210,277,78,35,111,183,453,-1.0,1.5,0.5,2021
Gordon Hayward,SF,31,49,1564,283,617,0.459,86,220,0.391,197,397,0.496,126,149,0.846,38,186,224,177,47,22,81,85,778,1.9,1.0,2.8,2021
Aaron Henry,SF,22,6,17,1,5,0.2,0,1,0.0,1,4,0.25,0,0,0.0,0,1,1,0,0,2,2,2,2,-0.1,0.0,-0.1,2021
Juancho Hernangómez,PF,26,40,445,44,106,0.415,24,69,0.348,20,37,0.541,19,34,0.559,28,72,100,20,14,10,16,25,131,0.3,0.6,0.9,2021
Willy Hernangómez,C,27,50,839,170,327,0.52,4,12,0.333,166,315,0.527,109,141,0.773,143,195,338,63,21,19,51,97,453,2.2,0.9,3.2,2021
Tyler Herro,SG,22,66,2151,501,1122,0.447,175,439,0.399,326,683,0.477,190,219,0.868,32,297,329,263,44,8,174,95,1367,1.3,2.4,3.8,2021
Buddy Hield,SG,29,81,2499,446,1098,0.406,262,716,0.366,184,382,0.482,111,127,0.874,66,287,353,229,73,25,153,184,1265,0.8,1.1,1.9,2021
Haywood Highsmith,SF,25,19,163,16,46,0.348,9,28,0.321,7,18,0.389,2,5,0.4,10,16,26,6,2,3,3,13,43,0.0,0.2,0.1,2021
George Hill,PG,35,54,1253,118,275,0.429,41,134,0.306,77,141,0.546,57,62,0.919,38,117,155,120,42,6,41,70,334,1.3,1.0,2.3,2021
Malcolm Hill,SF,26,19,212,24,52,0.462,13,36,0.361,11,16,0.688,11,14,0.786,11,24,35,8,7,3,3,24,72,0.4,0.2,0.6,2021
Solomon Hill,SF,30,13,139,3,20,0.15,2,13,0.154,1,7,0.143,0,0,0.0,6,17,23,12,4,2,1,16,8,-0.1,0.1,0.0,2021
Nate Hinton,SG,22,2,2,0,1,0.0,0,0,0.0,0,1,0.0,0,0,0.0,0,0,0,0,0,0,1,0,0,-0.1,0.0,-0.1,2021
Jaylen Hoard,SF,22,7,240,44,90,0.489,9,25,0.36,35,65,0.538,6,14,0.429,30,54,84,17,6,5,8,14,103,0.3,0.3,0.6,2021
Aaron Holiday,PG,25,63,1021,151,338,0.447,39,103,0.379,112,235,0.477,59,68,0.868,24,98,122,153,42,9,67,92,400,0.5,0.9,1.5,2021
Jrue Holiday,PG,31,67,2208,478,954,0.501,132,321,0.411,346,633,0.547,137,180,0.761,69,232,301,457,108,29,183,133,1225,4.5,2.4,6.9,2021
Justin Holiday,SF,32,74,2057,261,662,0.394,177,482,0.367,84,180,0.467,50,62,0.806,29,161,190,128,57,33,70,154,749,0.8,0.6,1.4,2021
Richaun Holmes,C,28,45,1074,198,300,0.66,2,5,0.4,196,295,0.664,70,90,0.778,93,224,317,48,17,41,56,128,468,2.4,0.9,3.2,2021
Rodney Hood,PF,29,52,709,58,157,0.369,30,91,0.33,28,66,0.424,17,19,0.895,15,62,77,38,15,6,11,31,163,0.2,0.5,0.7,2021
Scotty Hopson,SG,32,1,18,2,4,0.5,0,1,0.0,2,3,0.667,0,0,0.0,0,1,1,1,0,0,2,1,4,-0.1,0.0,0.0,2021
Al Horford,C,35,69,2005,266,569,0.467,89,265,0.336,177,304,0.582,80,95,0.842,108,422,530,232,49,92,65,130,701,3.7,3.8,7.6,2021
Talen Horton-Tucker,SG,21,60,1511,224,538,0.416,49,182,0.269,175,356,0.492,100,125,0.8,37,156,193,159,59,29,82,148,597,-0.2,1.2,1.1,2021
Danuel House Jr.,SF,28,42,727,80,198,0.404,44,117,0.376,36,81,0.444,44,58,0.759,18,93,111,44,21,17,33,51,248,0.4,0.7,1.0,2021
Dwight Howard,C,36,60,971,134,219,0.612,8,15,0.533,126,204,0.618,96,146,0.658,118,238,356,35,34,36,47,115,372,2.2,1.3,3.5,2021
Markus Howard,SG,22,31,176,39,101,0.386,28,70,0.4,11,31,0.355,20,23,0.87,2,10,12,7,9,0,7,17,126,0.1,0.2,0.3,2021
Kevin Huerter,SF,23,74,2188,345,760,0.454,160,411,0.389,185,349,0.53,42,52,0.808,32,222,254,203,55,26,91,185,892,1.8,1.0,2.8,2021
Jay Huff,C,23,4,20,0,3,0.0,0,2,0.0,0,1,0.0,0,0,0.0,1,3,4,1,1,1,1,1,0,-0.1,0.0,0.0,2021
Elijah Hughes,SG,23,36,434,47,144,0.326,25,95,0.263,22,49,0.449,7,9,0.778,6,52,58,22,14,8,17,39,126,-0.6,0.3,-0.4,2021
Feron Hunt,SF,22,2,8,0,2,0.0,0,0,0.0,0,2,0.0,0,0,0.0,1,0,1,1,1,0,1,1,0,-0.1,0.0,0.0,2021
De'Andre Hunter,SF,24,53,1577,254,575,0.442,74,195,0.379,180,380,0.474,127,166,0.765,26,150,176,68,36,21,69,155,709,0.4,0.7,1.1,2021
Chandler Hutchison,SF,25,6,22,1,2,0.5,0,0,0.0,1,2,0.5,2,2,1.0,0,5,5,2,0,0,4,1,4,-0.1,0.0,0.0,2021
Bones Hyland,SG,21,69,1310,230,571,0.403,131,358,0.366,99,213,0.465,107,125,0.856,14,174,188,191,41,20,86,153,698,1.1,1.3,2.4,2021
Serge Ibaka,C,32,54,878,148,296,0.5,37,99,0.374,111,197,0.563,32,44,0.727,62,188,250,49,11,33,43,102,365,0.8,1.1,2.0,2021
Andre Iguodala,SF,38,31,603,46,121,0.38,17,74,0.23,29,47,0.617,15,20,0.75,21,79,100,114,27,22,28,34,124,0.5,1.1,1.6,2021
Joe Ingles,SF,34,45,1122,115,285,0.404,78,225,0.347,37,60,0.617,17,22,0.773,12,119,131,158,23,5,46,82,325,1.3,0.9,2.2,2021
Brandon Ingram,SF,24,55,1869,453,983,0.461,74,226,0.327,379,757,0.501,266,322,0.826,35,285,320,307,34,26,151,119,1246,2.5,1.3,3.9,2021
Kyrie Irving,PG,29,29,1091,289,616,0.469,100,239,0.418,189,377,0.501,118,129,0.915,16,111,127,167,41,17,73,81,796,2.4,0.9,3.3,2021
Wes Iwundu,SF,27,3,82,8,18,0.444,3,5,0.6,5,13,0.385,3,4,0.75,3,10,13,0,1,0,1,8,22,0.1,0.0,0.1,2021
Frank Jackson,PG,23,53,1164,194,483,0.402,86,279,0.308,108,204,0.529,86,104,0.827,19,68,87,55,27,9,38,89,560,0.3,0.4,0.7,2021
Isaiah Jackson,C,20,36,541,116,206,0.563,5,16,0.313,111,190,0.584,60,88,0.682,60,89,149,10,25,52,40,92,297,0.7,0.7,1.4,2021
Jaren Jackson Jr.,PF,22,78,2126,430,1036,0.415,128,401,0.319,302,635,0.476,284,345,0.823,119,335,454,86,73,177,130,272,1272,1.7,3.7,5.4,2021
Josh Jackson,SF,24,51,830,120,300,0.4,33,130,0.254,87,170,0.512,55,77,0.714,21,120,141,54,26,22,47,88,328,-0.7,0.7,0.0,2021
Justin Jackson,SF,26,7,36,5,15,0.333,3,9,0.333,2,6,0.333,2,2,1.0,1,6,7,2,0,0,1,3,15,0.0,0.0,0.0,2021
Reggie Jackson,SG,31,75,2337,479,1222,0.392,167,512,0.326,312,710,0.439,138,163,0.847,39,232,271,359,55,15,173,159,1263,-1.7,2.0,0.4,2021
LeBron James,C,37,56,2084,640,1221,0.524,161,448,0.359,479,773,0.62,254,336,0.756,63,396,459,349,73,59,196,121,1695,5.2,2.3,7.5,2021
DeJon Jarreau,SG,24,1,1,0,0,0.0,0,0,0.0,0,0,0.0,0,0,0.0,0,0,0,0,0,0,0,0,0,0.0,0.0,0.0,2021
DaQuan Jeffries,SG,24,3,9,1,2,0.5,0,1,0.0,1,1,1.0,0,0,0.0,0,2,2,1,0,0,0,1,2,0.0,0.0,0.0,2021
Ty Jerome,SG,24,48,801,124,328,0.378,54,186,0.29,70,142,0.493,38,47,0.809,19,59,78,109,30,5,37,73,340,0.0,0.5,0.5,2021
Isaiah Joe,SG,22,55,609,62,177,0.35,45,135,0.333,17,42,0.405,29,31,0.935,6,50,56,35,14,3,19,47,198,0.0,0.4,0.4,2021
Alize Johnson,PF,25,23,167,17,39,0.436,0,4,0.0,17,35,0.486,7,12,0.583,28,33,61,9,5,0,12,18,41,0.0,0.1,0.1,2021
B.J. Johnson,SF,26,4,65,11,25,0.44,4,10,0.4,7,15,0.467,0,0,0.0,6,9,15,0,0,1,0,4,26,0.1,0.0,0.1,2021
Cameron Johnson,PF,25,66,1730,279,607,0.46,166,391,0.425,113,216,0.523,98,114,0.86,42,231,273,99,57,16,47,113,822,3.2,2.4,5.6,2021
David Johnson,SG,20,2,2,0,1,0.0,0,1,0.0,0,0,0.0,0,0,0.0,0,0,0,0,0,0,0,0,0,0.0,0.0,0.0,2021
Jalen Johnson,PF,20,22,120,22,41,0.537,3,13,0.231,19,28,0.679,5,7,0.714,2,24,26,3,3,2,9,9,52,-0.1,0.1,0.0,2021
James Johnson,PF,34,62,1191,144,307,0.469,23,85,0.271,121,222,0.545,29,55,0.527,51,164,215,130,30,34,48,162,340,0.6,1.1,1.7,2021
Joe Johnson,SG,40,1,2,1,1,1.0,0,0,0.0,1,1,1.0,0,0,0.0,0,0,0,0,0,0,0,0,2,0.0,0.0,0.0,2021
Keldon Johnson,SF,22,75,2392,471,1011,0.466,159,399,0.398,312,612,0.51,177,234,0.756,80,377,457,158,58,14,92,148,1278,2.9,2.0,4.9,2021
Keon Johnson,SG,19,37,696,96,272,0.353,34,100,0.34,62,172,0.36,41,51,0.804,24,57,81,76,28,12,46,69,267,-0.8,0.4,-0.5,2021
Stanley Johnson,PF,25,48,1094,117,251,0.466,33,105,0.314,84,146,0.575,53,74,0.716,34,121,155,80,43,14,35,109,320,0.9,0.9,1.8,2021
Tyler Johnson,PG,29,6,91,6,20,0.3,5,13,0.385,1,7,0.143,0,0,0.0,3,9,12,7,3,3,2,7,17,0.0,0.1,0.1,2021
Nikola Jokić,C,26,74,2476,764,1311,0.583,97,288,0.337,667,1023,0.652,379,468,0.81,206,813,1019,584,109,63,281,191,2004,10.8,4.5,15.2,2021
Carlik Jones,PG,24,5,23,1,9,0.111,0,1,0.0,1,8,0.125,2,2,1.0,1,2,3,5,1,0,3,0,4,-0.2,0.0,-0.1,2021
Damian Jones,C,26,56,1017,175,266,0.658,10,29,0.345,165,237,0.696,94,131,0.718,75,171,246,69,26,47,59,130,454,2.4,0.9,3.3,2021
Derrick Jones Jr.,PF,24,51,899,105,195,0.538,20,61,0.328,85,134,0.634,56,70,0.8,60,109,169,30,25,33,30,105,286,1.4,0.8,2.2,2021
Herbert Jones,PF,23,78,2335,274,576,0.476,57,169,0.337,217,407,0.533,137,163,0.84,98,198,296,167,130,60,100,238,742,2.1,2.5,4.6,2021
Jemerrio Jones,SF,26,2,15,2,3,0.667,0,0,0.0,2,3,0.667,0,0,0.0,2,1,3,0,1,0,0,2,4,0.0,0.0,0.1,2021
Kai Jones,C,21,21,63,9,14,0.643,1,2,0.5,8,12,0.667,3,8,0.375,3,8,11,4,1,2,6,8,22,0.0,0.0,0.0,2021
Mason Jones,SG,23,4,51,7,15,0.467,1,4,0.25,6,11,0.545,12,15,0.8,1,9,10,4,2,0,1,8,27,0.2,0.0,0.2,2021
Tre Jones,PG,22,69,1148,166,339,0.49,10,51,0.196,156,288,0.542,71,91,0.78,29,126,155,233,42,7,46,78,413,1.9,0.9,2.9,2021
Tyus Jones,PG,25,73,1549,249,552,0.451,80,205,0.39,169,347,0.487,54,66,0.818,17,159,176,324,66,2,46,32,632,3.4,1.6,5.1,2021
DeAndre Jordan,C,33,48,622,92,143,0.643,0,0,0.0,92,143,0.643,22,40,0.55,83,181,264,21,12,35,37,71,206,0.9,1.0,1.9,2021
Cory Joseph,PG,30,65,1600,178,400,0.445,65,157,0.414,113,243,0.465,100,113,0.885,29,145,174,237,42,17,85,147,521,1.7,0.8,2.5,2021
Georgios Kalaitzakis,SF,23,13,213,31,67,0.463,10,26,0.385,21,41,0.512,14,30,0.467,6,15,21,12,11,2,20,19,86,-0.3,0.2,-0.1,2021
Frank Kaminsky,C,28,9,181,36,66,0.545,5,15,0.333,31,51,0.608,18,20,0.9,11,30,41,13,8,7,5,14,95,0.5,0.3,0.9,2021
Luke Kennard,SG,25,70,1919,287,639,0.449,190,423,0.449,97,216,0.449,69,77,0.896,20,209,229,146,42,6,60,101,833,2.8,1.7,4.5,2021
Braxton Key,SF,24,11,197,33,72,0.458,6,21,0.286,27,51,0.529,7,13,0.538,13,37,50,11,10,11,11,26,79,-0.1,0.3,0.2,2021
George King,SF,28,4,19,0,5,0.0,0,4,0.0,0,1,0.0,1,2,0.5,0,5,5,0,0,0,1,4,1,-0.1,0.0,-0.1,2021
Louis King,SF,22,10,104,15,47,0.319,8,27,0.296,7,20,0.35,7,10,0.7,0,12,12,9,2,1,0,14,45,0.0,0.0,0.0,2021
Corey Kispert,SF,22,77,1801,234,514,0.455,112,320,0.35,122,194,0.629,54,62,0.871,53,156,209,85,35,22,50,93,634,1.6,0.7,2.3,2021
Maxi Kleber,PF,30,59,1450,141,354,0.398,83,255,0.325,58,99,0.586,46,65,0.708,70,280,350,68,30,58,47,137,411,0.7,2.3,3.0,2021
Brandon Knight,PG,30,5,65,10,25,0.4,4,17,0.235,6,8,0.75,8,8,1.0,0,8,8,8,1,0,4,5,32,0.1,0.1,0.1,2021
Nathan Knight,PF,24,37,267,45,88,0.511,4,13,0.308,41,75,0.547,44,60,0.733,32,53,85,22,7,8,18,42,138,0.6,0.3,1.0,2021
Kevin Knox,SF,22,30,222,31,85,0.365,15,54,0.278,16,31,0.516,16,22,0.727,14,30,44,10,4,2,7,19,93,0.1,0.2,0.2,2021
John Konchar,SG,25,72,1292,135,262,0.515,52,126,0.413,83,136,0.61,27,49,0.551,87,242,329,109,45,22,29,90,349,2.4,1.8,4.2,2021
Furkan Korkmaz,SG,24,67,1414,182,470,0.387,77,266,0.289,105,204,0.515,68,84,0.81,22,153,175,127,33,9,48,58,509,0.1,1.1,1.2,2021
Luke Kornet,C,26,15,103,13,27,0.481,0,5,0.0,13,22,0.591,4,6,0.667,13,16,29,9,3,3,0,9,30,0.2,0.2,0.4,2021
Vit Krejci,SG,21,30,690,68,167,0.407,32,98,0.327,36,69,0.522,19,22,0.864,18,83,101,57,19,8,29,65,187,0.1,0.5,0.6,2021
Arnoldas Kulboka,SF,24,2,5,0,1,0.0,0,1,0.0,0,0,0.0,0,0,0.0,0,0,0,0,0,0,0,1,0,0.0,0.0,0.0,2021
Jonathan Kuminga,SF,19,70,1185,236,460,0.513,50,149,0.336,186,311,0.598,130,190,0.684,54,180,234,64,31,22,74,146,652,1.3,1.8,3.0,2021
Kyle Kuzma,PF,26,66,2204,423,936,0.452,128,375,0.341,295,561,0.526,156,219,0.712,70,491,561,233,42,57,169,128,1130,0.0,2.0,2.0,2021
Anthony Lamb,SF,24,2,8,0,2,0.0,0,2,0.0,0,0,0.0,0,0,0.0,0,1,1,2,0,0,0,0,0,0.0,0.0,0.0,2021
Jeremy Lamb,SF,29,56,935,133,347,0.383,55,170,0.324,78,177,0.441,89,106,0.84,26,128,154,81,31,22,37,59,410,0.6,0.6,1.2,2021
Jock Landale,C,26,54,589,101,204,0.495,29,89,0.326,72,115,0.626,34,41,0.829,63,75,138,45,10,14,31,53,265,1.0,0.4,1.5,2021
Romeo Langford,SG,22,48,771,83,191,0.435,29,85,0.341,54,106,0.509,23,42,0.548,30,78,108,21,22,16,16,47,218,0.3,1.0,1.3,2021
Zach LaVine,SG,26,67,2328,565,1186,0.476,185,475,0.389,380,711,0.534,320,375,0.853,22,286,308,303,41,23,171,120,1635,4.5,1.3,5.8,2021
Jake Layman,SF,27,34,231,30,73,0.411,8,35,0.229,22,38,0.579,13,18,0.722,6,30,36,9,7,5,10,12,81,-0.1,0.2,0.1,2021
Damion Lee,SG,29,63,1256,169,383,0.441,63,187,0.337,106,196,0.541,66,75,0.88,27,176,203,63,39,6,38,95,467,0.9,1.8,2.7,2021
Saben Lee,PG,22,37,604,69,177,0.39,14,60,0.233,55,117,0.47,56,71,0.789,18,69,87,107,36,12,36,44,208,0.3,0.7,0.9,2021
Alex Len,C,28,39,620,94,176,0.534,6,21,0.286,88,155,0.568,41,63,0.651,52,109,161,45,13,25,43,100,235,0.4,0.5,0.9,2021
Caris LeVert,SG,27,58,1780,379,854,0.444,82,256,0.32,297,598,0.497,146,193,0.756,43,171,214,248,51,23,108,131,986,1.2,1.0,2.2,2021
Kira Lewis Jr.,PG,20,24,341,59,146,0.404,13,58,0.224,46,88,0.523,10,12,0.833,9,30,39,49,11,1,26,17,141,-0.3,0.2,-0.1,2021
Scottie Lewis,SG,21,2,7,0,0,0.0,0,0,0.0,0,0,0.0,1,2,0.5,0,0,0,1,1,0,0,0,1,0.0,0.0,0.0,2021
Damian Lillard,PG,31,29,1056,222,552,0.402,92,284,0.324,130,268,0.485,159,181,0.878,13,107,120,212,17,11,83,37,695,1.7,0.1,1.7,2021
Nassir Little,SF,21,42,1088,145,315,0.46,51,154,0.331,94,161,0.584,69,94,0.734,58,178,236,54,25,36,40,82,410,1.2,0.6,1.7,2021
Isaiah Livers,SF,23,19,383,41,90,0.456,27,64,0.422,14,26,0.538,12,14,0.857,15,42,57,21,13,7,15,37,121,0.4,0.3,0.7,2021
Kevon Looney,C,25,82,1732,208,364,0.571,0,1,0.0,208,363,0.573,75,125,0.6,208,388,596,165,50,52,67,215,491,3.5,3.2,6.8,2021
Brook Lopez,C,33,13,298,61,131,0.466,19,53,0.358,42,78,0.538,20,23,0.87,19,34,53,6,8,15,12,34,161,0.3,0.3,0.7,2021
Robin Lopez,C,33,36,612,110,199,0.553,2,6,0.333,108,193,0.56,32,54,0.593,68,58,126,54,2,18,44,67,254,0.5,0.3,0.8,2021
Didi Louzada,SG,22,9,129,12,33,0.364,9,23,0.391,3,10,0.3,2,2,1.0,5,12,17,5,2,2,5,13,35,0.0,0.0,0.0,2021
Kevin Love,C,33,74,1665,327,761,0.43,187,477,0.392,140,284,0.493,166,198,0.838,87,449,536,160,26,18,98,101,1007,3.2,2.5,5.7,2021
Kyle Lowry,PG,35,63,2133,276,627,0.44,144,382,0.377,132,245,0.539,148,174,0.851,33,249,282,474,67,17,168,177,844,3.7,2.7,6.4,2021
Gabriel Lundberg,SG,27,4,44,5,19,0.263,3,8,0.375,2,11,0.182,0,0,0.0,2,5,7,11,3,0,3,7,13,-0.1,0.1,0.0,2021
Timothé Luwawu-Cabarrot,SF,26,52,685,74,186,0.398,44,122,0.361,30,64,0.469,35,41,0.854,17,65,82,40,18,6,20,76,227,0.6,0.3,0.9,2021
Trey Lyles,PF,26,75,1536,262,562,0.466,67,209,0.321,195,353,0.552,195,243,0.802,89,290,379,88,29,32,73,123,786,2.4,1.2,3.5,2021
Théo Maledon,PG,20,51,908,119,317,0.375,44,150,0.293,75,167,0.449,79,100,0.79,20,111,131,111,31,11,65,67,361,-0.5,0.8,0.3,2021
Sandro Mamukelashvili,PF,22,41,407,57,115,0.496,22,52,0.423,35,63,0.556,18,22,0.818,35,47,82,22,9,9,15,28,154,0.8,0.3,1.1,2021
Terance Mann,SF,25,81,2317,334,690,0.484,76,208,0.365,258,482,0.535,128,164,0.78,104,321,425,209,55,21,84,178,872,3.1,2.4,5.5,2021
Tre Mann,PG,20,60,1367,231,588,0.393,98,272,0.36,133,316,0.421,65,82,0.793,25,146,171,91,47,12,71,102,625,-1.0,1.0,0.1,2021
Boban Marjanović,C,33,23,128,42,70,0.6,1,4,0.25,41,66,0.621,13,22,0.591,8,31,39,3,0,3,15,24,98,-0.1,0.2,0.1,2021
Lauri Markkanen,SF,24,61,1878,313,703,0.445,136,380,0.358,177,323,0.548,138,159,0.868,59,286,345,81,45,30,54,130,900,2.7,2.3,5.0,2021
Naji Marshall,SF,24,55,735,109,269,0.405,21,105,0.2,88,164,0.537,74,93,0.796,38,104,142,62,33,8,46,69,313,0.0,0.7,0.8,2021
Caleb Martin,SF,26,60,1372,208,410,0.507,64,155,0.413,144,255,0.565,71,93,0.763,70,160,230,64,58,30,52,104,551,1.9,2.1,4.0,2021
Cody Martin,SF,26,71,1866,204,423,0.482,61,159,0.384,143,264,0.542,75,107,0.701,82,203,285,179,88,32,61,116,544,2.4,1.5,3.9,2021
Kelan Martin,SF,26,30,450,70,171,0.409,22,75,0.293,48,96,0.5,9,13,0.692,17,38,55,21,13,9,14,36,171,-0.1,0.2,0.0,2021
KJ Martin,SF,21,79,1656,279,523,0.533,60,168,0.357,219,355,0.617,78,123,0.634,80,217,297,101,34,40,60,113,696,2.3,0.6,2.9,2021
Garrison Mathews,SG,25,65,1712,184,461,0.399,139,386,0.36,45,75,0.6,143,180,0.794,32,158,190,64,57,24,41,168,650,2.2,0.5,2.8,2021
Dakota Mathias,SG,26,6,16,2,6,0.333,2,6,0.333,0,0,0.0,0,0,0.0,0,2,2,1,1,0,0,1,6,0.0,0.0,0.0,2021
Wesley Matthews,SG,35,49,1002,87,220,0.395,53,157,0.338,34,63,0.54,22,28,0.786,30,62,92,36,23,8,18,87,249,0.6,0.6,1.2,2021
Tyrese Maxey,PG,21,75,2650,483,995,0.485,132,309,0.427,351,686,0.512,213,246,0.866,26,214,240,321,55,32,88,156,1311,5.4,1.9,7.3,2021
Skylar Mays,SG,24,28,220,32,64,0.5,8,25,0.32,24,39,0.615,8,9,0.889,5,20,25,17,7,0,10,9,80,0.2,0.1,0.3,2021
Miles McBride,PG,21,40,372,32,108,0.296,17,68,0.25,15,40,0.375,8,12,0.667,4,38,42,41,14,1,5,45,89,-0.1,0.4,0.2,2021
Mac McClung,SG,23,2,24,3,6,0.5,1,3,0.333,2,3,0.667,1,1,1.0,0,3,3,1,1,1,3,5,8,0.0,0.0,0.0,2021
CJ McCollum,SG,30,62,2145,536,1164,0.46,182,469,0.388,354,695,0.509,116,170,0.682,53,216,269,315,70,22,127,121,1370,2.6,1.0,3.6,2021
T.J. McConnell,PG,29,27,652,100,208,0.481,10,33,0.303,90,175,0.514,19,23,0.826,20,70,90,131,29,10,29,53,229,1.0,0.4,1.3,2021
Jaden McDaniels,PF,21,70,1803,255,554,0.46,80,252,0.317,175,302,0.579,57,71,0.803,76,217,293,79,52,54,75,224,647,0.7,1.7,2.4,2021
Jalen McDaniels,SF,24,55,895,123,254,0.484,41,108,0.38,82,146,0.562,53,72,0.736,37,133,170,58,26,22,36,93,340,1.0,0.7,1.7,2021
Doug McDermott,PF,30,51,1223,215,465,0.462,108,256,0.422,107,209,0.512,40,51,0.784,18,97,115,64,13,6,43,79,578,1.1,0.5,1.6,2021
JaVale McGee,C,34,74,1172,288,458,0.629,2,9,0.222,286,449,0.637,102,146,0.699,163,333,496,42,22,81,98,181,680,2.4,2.6,4.9,2021
Cameron McGriff,SF,24,3,46,5,14,0.357,2,6,0.333,3,8,0.375,2,2,1.0,6,9,15,3,0,1,0,7,14,0.1,0.0,0.1,2021
Rodney McGruder,SG,30,51,754,98,225,0.436,58,146,0.397,40,79,0.506,19,26,0.731,31,80,111,48,21,7,24,58,273,0.7,0.4,1.2,2021
Alfonzo McKinnie,SF,29,17,206,24,61,0.393,9,27,0.333,15,34,0.441,2,8,0.25,13,20,33,5,2,3,7,26,59,-0.2,0.1,-0.1,2021
JaQuori McLaughlin,PG,24,4,11,0,2,0.0,0,1,0.0,0,1,0.0,0,0,0.0,0,0,0,2,0,0,0,1,0,0.0,0.0,0.0,2021
Jordan McLaughlin,PG,25,62,902,88,200,0.44,27,85,0.318,61,115,0.53,30,40,0.75,22,72,94,180,57,10,38,54,233,1.3,1.0,2.3,2021
Ben McLemore,SG,28,64,1285,216,539,0.401,151,417,0.362,65,122,0.533,72,88,0.818,12,91,103,59,38,10,55,103,655,0.7,0.2,0.8,2021
De'Anthony Melton,SG,23,73,1657,281,695,0.404,139,372,0.374,142,323,0.44,90,120,0.75,64,264,328,194,104,39,112,128,791,0.9,2.8,3.7,2021
Sam Merrill,SG,25,6,58,8,24,0.333,7,23,0.304,1,1,1.0,2,4,0.5,1,6,7,4,0,0,2,3,25,0.0,0.0,0.0,2021
Chimezie Metu,C,24,60,1279,203,449,0.452,57,186,0.306,146,263,0.555,71,91,0.78,34,301,335,60,51,32,61,93,534,0.1,1.4,1.5,2021
Khris Middleton,SF,30,66,2141,452,1021,0.443,162,434,0.373,290,587,0.494,259,291,0.89,41,315,356,358,76,18,190,160,1325,3.2,2.2,5.3,2021
C.J. Miles,SG,34,1,2,0,0,0.0,0,0,0.0,0,0,0.0,0,0,0.0,0,0,0,0,0,0,0,1,0,0.0,0.0,0.0,2021
Patty Mills,SG,33,81,2346,324,794,0.408,227,568,0.4,97,226,0.429,48,59,0.814,18,138,156,183,51,17,73,112,923,1.9,0.9,2.8,2021
Paul Millsap,C,36,33,375,45,115,0.391,8,35,0.229,37,80,0.463,17,24,0.708,41,73,114,29,10,13,19,67,115,0.0,0.5,0.5,2021
Shake Milton,SG,25,55,1179,173,403,0.429,43,133,0.323,130,270,0.481,61,73,0.836,30,112,142,139,28,17,44,99,450,0.7,1.0,1.7,2021
Davion Mitchell,PG,23,75,2076,352,843,0.418,101,320,0.316,251,523,0.48,56,85,0.659,33,133,166,313,55,24,114,141,861,-0.5,0.6,0.1,2021
Donovan Mitchell,SG,25,67,2266,617,1376,0.448,232,654,0.355,385,722,0.533,267,313,0.853,55,227,282,358,99,12,200,164,1733,4.7,2.5,7.2,2021
Evan Mobley,PF,20,69,2331,422,830,0.508,23,92,0.25,399,738,0.541,167,252,0.663,143,427,570,174,56,115,133,147,1034,1.5,3.7,5.2,2021
Malik Monk,SG,23,76,2139,391,826,0.473,173,442,0.391,218,384,0.568,93,117,0.795,37,219,256,218,61,29,122,138,1048,2.3,1.4,3.6,2021
Greg Monroe,C,31,14,195,32,57,0.561,0,0,0.0,32,57,0.561,12,23,0.522,30,34,64,22,8,10,12,24,76,0.4,0.3,0.7,2021
Moses Moody,SG,19,52,607,80,183,0.437,40,110,0.364,40,73,0.548,28,36,0.778,17,63,80,23,7,10,13,43,228,0.6,0.7,1.3,2021
Xavier Moon,SG,27,10,137,25,51,0.49,5,14,0.357,20,37,0.541,3,5,0.6,2,12,14,24,7,3,6,9,58,0.2,0.2,0.3,2021
Matt Mooney,SG,25,1,2,0,1,0.0,0,1,0.0,0,0,0.0,0,0,0.0,0,0,0,0,1,0,1,0,0,-0.1,0.0,0.0,2021
Ja Morant,PG,22,57,1889,580,1177,0.493,88,256,0.344,492,921,0.534,316,415,0.761,77,248,325,384,66,22,196,86,1564,4.6,2.1,6.7,2021
Juwan Morgan,PF,24,2,31,2,3,0.667,1,2,0.5,1,1,1.0,0,0,0.0,2,2,4,1,0,0,0,3,5,0.1,0.0,0.1,2021
Jaylen Morris,SG,26,3,16,0,6,0.0,0,2,0.0,0,4,0.0,2,4,0.5,0,2,2,2,0,0,1,2,2,-0.1,0.0,-0.1,2021
Marcus Morris,PF,32,54,1564,300,691,0.434,101,275,0.367,199,416,0.478,129,148,0.872,26,213,239,113,28,18,69,115,830,0.9,1.5,2.4,2021
Markieff Morris,PF,32,17,298,54,114,0.474,13,39,0.333,41,75,0.547,8,9,0.889,17,28,45,23,6,1,20,33,129,0.0,0.3,0.3,2021
Monte Morris,PG,26,75,2239,374,773,0.484,124,314,0.395,250,459,0.545,73,84,0.869,27,199,226,333,56,14,78,92,945,3.9,1.5,5.4,2021
Emmanuel Mudiay,PG,25,2,11,0,2,0.0,0,0,0.0,0,2,0.0,3,4,0.75,0,0,0,4,1,0,1,1,3,0.0,0.0,0.0,2021
Mychal Mulder,PG,27,17,240,24,77,0.312,17,54,0.315,7,23,0.304,4,4,1.0,2,22,24,5,4,2,8,13,69,-0.4,0.1,-0.2,2021
Ade Murkey,SG,24,1,1,0,0,0.0,0,0,0.0,0,0,0.0,0,0,0.0,0,0,0,0,0,0,0,0,0,0.0,0.0,0.0,2021
Trey Murphy III,SF,21,62,864,109,277,0.394,71,186,0.382,38,91,0.418,45,51,0.882,47,100,147,38,23,7,16,60,334,1.3,0.6,1.9,2021
Dejounte Murray,PG,25,68,2366,573,1241,0.462,96,294,0.327,477,947,0.504,196,247,0.794,80,483,563,627,138,23,180,138,1438,3.9,3.4,7.3,2021
Mike Muscala,C,30,43,592,113,248,0.456,70,163,0.429,43,85,0.506,48,57,0.842,21,108,129,22,18,26,14,58,344,1.4,0.7,2.1,2021
Svi Mykhailiuk,SF,24,56,716,91,234,0.389,41,134,0.306,50,100,0.5,32,37,0.865,20,72,92,45,26,4,32,54,255,0.1,0.7,0.8,2021
Abdel Nader,SF,28,14,145,12,35,0.343,4,14,0.286,8,21,0.381,6,10,0.6,4,23,27,7,8,4,11,20,34,-0.3,0.3,0.0,2021
Larry Nance Jr.,C,29,46,1040,129,247,0.522,23,70,0.329,106,177,0.599,40,57,0.702,72,176,248,81,43,20,37,84,321,1.5,0.8,2.3,2021
RJ Nembhard Jr.,SG,22,14,63,6,18,0.333,0,2,0.0,6,16,0.375,3,4,0.75,3,4,7,12,1,0,3,2,15,0.0,0.0,0.0,2021
Aaron Nesmith,SF,22,52,574,72,182,0.396,31,115,0.27,41,67,0.612,21,26,0.808,15,74,89,22,20,5,31,70,196,-0.4,0.9,0.4,2021
Raul Neto,PG,29,70,1372,204,441,0.463,35,120,0.292,169,321,0.526,83,108,0.769,13,121,134,217,55,3,79,104,526,0.7,0.8,1.5,2021
Malik Newman,PG,24,1,8,3,5,0.6,0,1,0.0,3,4,0.75,2,2,1.0,0,1,1,1,0,0,1,0,8,0.0,0.0,0.0,2021
Georges Niang,PF,28,76,1736,246,563,0.437,156,387,0.403,90,176,0.511,52,59,0.881,25,178,203,102,30,13,59,190,700,1.5,1.3,2.8,2021
Daishen Nix,SG,19,24,261,27,67,0.403,7,26,0.269,20,41,0.488,16,30,0.533,7,26,33,40,15,0,26,21,77,-0.3,0.1,-0.2,2021
Zeke Nnaji,PF,21,41,698,96,186,0.516,37,80,0.463,59,106,0.557,41,65,0.631,56,91,147,17,16,13,23,79,270,1.2,0.6,1.8,2021
Nerlens Noel,C,27,25,562,32,60,0.533,0,3,0.0,32,57,0.561,21,30,0.7,48,93,141,23,30,31,20,67,85,0.4,1.0,1.5,2021
Jaylen Nowell,SG,22,62,975,196,413,0.475,63,160,0.394,133,253,0.526,72,92,0.783,22,101,123,130,27,10,36,73,527,2.1,0.7,2.8,2021
Frank Ntilikina,SG,23,58,685,89,223,0.399,38,111,0.342,51,112,0.455,24,25,0.96,12,67,79,69,27,7,31,61,240,0.1,0.9,0.9,2021
Jusuf Nurkić,C,27,56,1579,321,600,0.535,15,56,0.268,306,544,0.563,185,268,0.69,167,452,619,157,62,34,143,189,842,2.0,1.7,3.6,2021
David Nwaba,SF,29,46,609,85,176,0.483,15,49,0.306,70,127,0.551,48,67,0.716,41,110,151,35,28,20,21,55,233,0.8,0.5,1.3,2021
Jordan Nwora,SF,23,62,1185,186,462,0.403,79,227,0.348,107,235,0.455,36,43,0.837,37,184,221,59,25,17,57,78,487,-0.4,1.1,0.6,2021
Royce O'Neale,SF,28,77,2406,203,444,0.457,119,306,0.389,84,138,0.609,45,56,0.804,64,304,368,191,86,32,79,183,570,2.7,2.8,5.5,2021
Semi Ojeleye,PF,27,30,406,30,99,0.303,15,50,0.3,15,49,0.306,23,29,0.793,27,47,74,9,7,6,9,30,98,-0.1,0.3,0.2,2021
Chuma Okeke,PF,23,70,1749,216,575,0.376,118,371,0.318,98,204,0.48,55,65,0.846,47,300,347,118,97,42,57,95,605,-0.3,2.5,2.2,2021
Josh Okogie,SG,23,49,516,42,104,0.404,14,47,0.298,28,57,0.491,35,51,0.686,29,41,70,25,26,12,23,53,133,0.1,0.5,0.7,2021
Onyeka Okongwu,C,21,48,992,156,226,0.69,0,0,0.0,156,226,0.69,80,110,0.727,115,168,283,53,31,60,44,149,392,3.1,1.1,4.2,2021
Isaac Okoro,SF,21,67,1981,207,431,0.48,55,157,0.35,152,274,0.555,119,155,0.768,72,129,201,121,56,22,58,164,588,2.4,1.9,4.2,2021
KZ Okpala,PF,22,21,244,30,69,0.435,9,26,0.346,21,43,0.488,8,11,0.727,11,30,41,14,4,7,5,25,77,0.2,0.3,0.5,2021
Victor Oladipo,SG,29,8,173,35,73,0.479,15,36,0.417,20,37,0.541,14,19,0.737,3,20,23,28,5,1,16,13,99,0.2,0.2,0.4,2021
Cameron Oliver,SF,25,2,43,10,15,0.667,1,3,0.333,9,12,0.75,2,3,0.667,2,4,6,3,1,1,0,5,23,0.2,0.0,0.2,2021
Kelly Olynyk,C,30,40,764,128,286,0.448,40,119,0.336,88,167,0.527,69,89,0.775,54,123,177,111,31,19,58,100,365,0.8,0.8,1.6,2021
Eugene Omoruyi,SF,24,4,18,2,5,0.4,1,2,0.5,1,3,0.333,2,4,0.5,2,5,7,2,0,0,0,2,7,0.1,0.0,0.1,2021
Miye Oni,SG,24,16,44,2,9,0.222,1,8,0.125,1,1,1.0,0,1,0.0,1,6,7,5,0,0,1,7,5,-0.1,0.0,0.0,2021
Cedi Osman,SF,26,66,1462,247,572,0.432,128,359,0.357,119,213,0.559,87,131,0.664,25,121,146,135,52,10,67,127,709,1.3,1.6,2.9,2021
Daniel Oturu,C,22,3,27,3,6,0.5,0,1,0.0,3,5,0.6,3,5,0.6,1,4,5,0,0,2,0,1,9,0.0,0.0,0.1,2021
Kelly Oubre Jr.,SF,26,76,1999,410,932,0.44,191,553,0.345,219,379,0.578,126,189,0.667,79,223,302,84,77,31,67,189,1137,1.8,1.4,3.3,2021
Jaysean Paige,PG,27,1,7,0,3,0.0,0,2,0.0,0,1,0.0,0,0,0.0,0,1,1,1,0,0,1,2,0,-0.1,0.0,-0.1,2021
Trayvon Palmer,SG,27,1,17,0,1,0.0,0,0,0.0,0,1,0.0,0,0,0.0,0,2,2,0,0,0,1,2,0,-0.1,0.0,0.0,2021
Kevin Pangos,PG,29,24,166,15,46,0.326,6,26,0.231,9,20,0.45,3,4,0.75,2,9,11,30,3,0,7,11,39,-0.1,0.1,0.1,2021
Jabari Parker,PF,26,12,112,18,38,0.474,8,16,0.5,10,22,0.455,9,9,1.0,5,23,28,6,4,1,8,13,53,0.1,0.2,0.3,2021
Eric Paschall,PF,25,58,737,114,235,0.485,40,108,0.37,74,127,0.583,66,86,0.767,30,76,106,36,9,5,27,51,334,1.4,0.5,2.0,2021
Chris Paul,PG,36,65,2139,363,736,0.493,63,199,0.317,300,537,0.559,169,202,0.837,22,261,283,702,121,20,153,134,958,5.8,3.6,9.4,2021
Cameron Payne,PG,27,58,1278,240,587,0.409,71,211,0.336,169,376,0.449,75,89,0.843,24,151,175,282,40,17,103,119,626,0.2,1.8,1.9,2021
Elfrid Payton,PG,27,50,549,67,175,0.383,4,18,0.222,63,157,0.401,12,32,0.375,21,67,88,99,25,6,47,38,150,-1.0,0.8,-0.2,2021
Gary Payton II,SG,29,71,1248,212,344,0.616,43,120,0.358,169,224,0.754,35,58,0.603,72,175,247,64,96,22,40,131,502,2.5,2.6,5.2,2021
Norvel Pelle,C,28,3,19,3,5,0.6,0,0,0.0,3,5,0.6,0,0,0.0,3,3,6,0,0,1,2,1,6,0.0,0.0,0.0,2021
Reggie Perry,PF,21,10,187,40,79,0.506,3,16,0.188,37,63,0.587,9,15,0.6,15,32,47,12,9,6,11,33,92,0.1,0.2,0.2,2021
Jamorko Pickett,PF,24,13,176,18,50,0.36,13,39,0.333,5,11,0.455,1,2,0.5,6,26,32,7,0,7,5,12,50,0.0,0.1,0.1,2021
Theo Pinson,SF,26,19,148,14,39,0.359,10,30,0.333,4,9,0.444,10,10,1.0,2,19,21,17,5,2,5,12,48,0.2,0.2,0.4,2021
Mason Plumlee,C,31,73,1793,205,320,0.641,0,2,0.0,205,318,0.645,67,171,0.392,176,389,565,226,61,52,100,224,477,2.7,2.0,4.7,2021
Jakob Poeltl,C,26,68,1970,410,663,0.618,1,1,1.0,409,662,0.618,94,190,0.495,262,372,634,189,45,118,109,212,915,4.4,2.5,6.9,2021
Aleksej Pokusevski,PF,20,61,1233,186,456,0.408,57,197,0.289,129,259,0.498,35,50,0.7,73,245,318,131,39,38,94,88,464,-1.1,1.5,0.4,2021
Yves Pons,SF,22,12,71,5,16,0.313,3,9,0.333,2,7,0.286,0,2,0.0,5,7,12,1,1,4,1,6,13,0.0,0.1,0.0,2021
Jordan Poole,SG,22,76,2283,474,1058,0.448,211,580,0.364,263,478,0.55,246,266,0.925,34,226,260,304,60,23,187,206,1405,3.1,2.9,6.0,2021
Kevin Porter Jr.,PG,21,61,1907,335,808,0.415,155,413,0.375,180,395,0.456,124,193,0.642,43,224,267,376,69,22,192,156,949,0.0,0.8,0.8,2021
Michael Porter Jr.,SF,23,9,265,37,103,0.359,10,48,0.208,27,55,0.491,5,9,0.556,9,50,59,17,10,2,12,16,89,-0.5,0.3,-0.2,2021
Otto Porter Jr.,PF,28,63,1396,193,416,0.464,80,216,0.37,113,200,0.565,49,61,0.803,86,276,362,94,68,29,37,83,515,2.2,2.7,4.9,2021
Bobby Portis,C,26,72,2028,417,871,0.479,133,338,0.393,284,533,0.533,85,113,0.752,180,477,657,86,53,51,90,174,1052,2.9,2.6,5.5,2021
Kristaps Porziņģis,PF,26,51,1481,352,767,0.459,78,252,0.31,274,515,0.532,248,286,0.867,102,309,411,119,37,84,81,137,1030,3.2,2.4,5.6,2021
Micah Potter,C,23,3,31,5,11,0.455,0,2,0.0,5,9,0.556,2,2,1.0,4,5,9,0,1,1,1,4,12,0.0,0.0,0.0,2021
Dwight Powell,C,30,82,1798,269,401,0.671,13,37,0.351,256,364,0.703,166,212,0.783,173,231,404,97,37,39,64,220,717,6.0,2.2,8.2,2021
Myles Powell,PG,24,11,52,5,17,0.294,1,6,0.167,4,11,0.364,2,2,1.0,1,5,6,3,1,0,3,8,13,-0.2,0.0,-0.1,2021
Norman Powell,SF,28,45,1458,279,605,0.461,106,253,0.419,173,352,0.491,189,233,0.811,20,125,145,96,42,21,69,106,853,2.4,0.4,2.8,2021
Joshua Primo,SF,19,50,965,101,270,0.374,42,137,0.307,59,133,0.444,44,59,0.746,32,81,113,81,20,23,57,79,288,-0.6,0.6,0.0,2021
Taurean Prince,PF,27,69,1177,177,390,0.454,86,229,0.376,91,161,0.565,62,82,0.756,26,148,174,68,47,23,53,116,502,1.0,1.2,2.2,2021
Payton Pritchard,PG,24,71,1001,160,373,0.429,101,245,0.412,59,128,0.461,21,21,1.0,32,102,134,139,25,6,41,61,442,1.8,1.2,3.1,2021
Trevelin Queen,SG,24,10,74,15,33,0.455,9,24,0.375,6,9,0.667,4,4,1.0,7,9,16,4,5,1,7,6,43,0.1,0.1,0.1,2021
Neemias Queta,C,22,15,120,17,38,0.447,0,0,0.0,17,38,0.447,11,17,0.647,14,17,31,6,1,8,6,18,45,0.0,0.1,0.1,2021
Immanuel Quickley,PG,22,78,1802,284,724,0.392,137,396,0.346,147,328,0.448,177,201,0.881,31,216,247,275,54,3,99,167,882,2.5,1.8,4.2,2021
Jahmi'us Ramsey,SG,20,19,134,24,58,0.414,5,18,0.278,19,40,0.475,7,14,0.5,4,9,13,7,1,1,5,10,60,-0.1,0.0,-0.1,2021
Julius Randle,PF,27,72,2544,512,1246,0.411,120,390,0.308,392,856,0.458,303,401,0.756,125,591,716,370,53,39,245,205,1447,-0.3,3.4,3.1,2021
Austin Reaves,SG,23,61,1418,146,318,0.459,53,167,0.317,93,151,0.616,99,118,0.839,45,148,193,110,29,20,40,87,444,2.1,0.8,2.9,2021
Cam Reddish,SF,22,49,1012,165,408,0.404,66,184,0.359,99,224,0.442,101,112,0.902,25,80,105,48,47,15,57,60,497,0.2,0.8,1.0,2021
Davon Reed,SG,26,48,668,81,161,0.503,37,86,0.43,44,75,0.587,10,15,0.667,14,94,108,53,24,9,16,63,209,0.9,0.7,1.6,2021
Paul Reed,C,22,38,302,54,96,0.563,2,8,0.25,52,88,0.591,6,14,0.429,44,48,92,16,33,14,10,57,116,0.6,0.7,1.3,2021
Naz Reid,C,22,77,1215,233,476,0.489,57,166,0.343,176,310,0.568,114,149,0.765,102,199,301,71,40,71,82,172,637,1.5,1.6,3.2,2021
Nick Richards,C,24,50,367,60,90,0.667,0,0,0.0,60,90,0.667,30,43,0.698,34,52,86,13,9,21,24,51,150,0.6,0.3,1.0,2021
Josh Richardson,SG,28,65,1600,234,534,0.438,102,246,0.415,132,288,0.458,96,108,0.889,42,143,185,115,56,29,66,116,666,1.6,2.0,3.5,2021
Austin Rivers,SG,29,67,1480,146,350,0.417,79,231,0.342,67,119,0.563,32,44,0.727,19,95,114,90,51,6,54,121,403,0.1,1.1,1.2,2021
Duncan Robinson,SG,27,79,2043,290,726,0.399,232,624,0.372,58,102,0.569,51,61,0.836,24,179,203,129,42,14,60,201,863,1.9,2.0,3.9,2021
Justin Robinson,PG,24,25,304,28,93,0.301,18,61,0.295,10,32,0.313,4,8,0.5,4,17,21,32,9,1,17,27,78,-0.5,0.2,-0.3,2021
Mitchell Robinson,C,23,72,1848,261,343,0.761,0,0,0.0,261,343,0.761,88,181,0.486,295,322,617,38,58,133,60,195,610,5.3,3.2,8.5,2021
Jeremiah Robinson-Earl,C,21,49,1087,134,324,0.414,58,165,0.352,76,159,0.478,40,54,0.741,75,199,274,49,29,15,39,75,366,0.4,1.0,1.5,2021
Isaiah Roby,PF,23,45,948,166,323,0.514,44,99,0.444,122,224,0.545,78,116,0.672,75,142,217,71,36,34,43,109,454,1.8,1.1,2.9,2021
Rajon Rondo,PG,35,39,698,68,176,0.386,31,88,0.352,37,88,0.42,19,26,0.731,15,93,108,170,30,6,68,56,186,-0.1,0.8,0.7,2021
Derrick Rose,PG,33,26,636,122,274,0.445,37,92,0.402,85,182,0.467,30,31,0.968,21,57,78,103,22,12,39,15,311,0.8,0.7,1.4,2021
Terrence Ross,SG,30,63,1448,220,554,0.397,77,264,0.292,143,290,0.493,112,130,0.862,20,141,161,116,28,12,75,68,629,-0.5,0.9,0.3,2021
Terry Rozier,SG,27,73,2458,518,1167,0.444,222,593,0.374,296,574,0.516,150,176,0.852,56,259,315,326,93,25,96,119,1408,4.3,1.6,5.9,2021
Ricky Rubio,PG,31,34,970,149,411,0.363,59,174,0.339,90,237,0.38,88,103,0.854,15,126,141,225,49,7,90,75,445,-0.1,1.4,1.3,2021
D'Angelo Russell,PG,25,65,2077,401,975,0.411,176,518,0.34,225,457,0.492,198,240,0.825,25,191,216,460,62,22,165,130,1176,2.9,1.5,4.4,2021
Matt Ryan,SF,24,1,5,1,5,0.2,1,5,0.2,0,0,0.0,0,0,0.0,0,0,0,0,1,0,0,0,3,0.0,0.0,0.0,2021
Domantas Sabonis,PF,25,62,2136,443,773,0.573,39,125,0.312,404,648,0.623,246,332,0.741,201,551,752,323,59,27,195,203,1171,5.3,1.8,7.1,2021
Olivier Sarr,C,22,22,421,58,101,0.574,13,29,0.448,45,72,0.625,24,29,0.828,34,59,93,19,6,15,22,52,153,0.7,0.3,1.0,2021
Tomáš Satoranský,SG,30,55,906,72,191,0.377,11,53,0.208,61,138,0.442,43,54,0.796,27,99,126,184,29,5,46,71,198,0.5,0.6,1.0,2021
Jordan Schakel,SG,23,4,30,1,11,0.091,1,6,0.167,0,5,0.0,2,2,1.0,2,6,8,0,1,0,1,0,5,-0.2,0.0,-0.1,2021
Admiral Schofield,SF,24,38,469,54,129,0.419,26,79,0.329,28,50,0.56,12,15,0.8,17,72,89,25,4,5,21,58,146,-0.1,0.3,0.3,2021
Dennis Schröder,PG,28,64,1837,312,724,0.431,86,250,0.344,226,474,0.477,157,184,0.853,34,180,214,296,53,8,143,154,867,1.0,1.9,2.9,2021
Tre Scott,SF,25,2,11,3,6,0.5,0,1,0.0,3,5,0.6,0,0,0.0,1,1,2,0,1,1,0,2,6,0.0,0.0,0.0,2021
Jay Scrubb,SG,21,18,121,18,46,0.391,6,21,0.286,12,25,0.48,7,10,0.7,2,14,16,8,4,3,7,9,49,-0.1,0.1,0.0,2021
Wayne Selden,SG,27,3,19,1,4,0.25,1,2,0.5,0,2,0.0,2,4,0.5,0,1,1,1,0,0,0,1,5,0.0,0.0,0.0,2021
Alperen Sengun,C,19,72,1489,249,525,0.474,29,117,0.248,220,408,0.539,165,232,0.711,138,255,393,185,59,68,145,214,692,0.8,1.3,2.1,2021
Collin Sexton,SG,23,11,316,68,151,0.45,11,45,0.244,57,106,0.538,29,39,0.744,13,23,36,23,10,0,31,25,176,-0.4,0.3,-0.1,2021
Landry Shamet,SG,24,69,1437,191,485,0.394,123,334,0.368,68,151,0.45,68,81,0.84,16,110,126,108,28,9,41,92,573,1.1,1.5,2.6,2021
Day'Ron Sharpe,PF,20,32,391,86,149,0.577,2,7,0.286,84,142,0.592,24,41,0.585,81,79,160,17,10,15,30,60,198,0.8,0.5,1.2,2021
Pascal Siakam,PF,27,68,2578,596,1207,0.494,75,218,0.344,521,989,0.527,284,379,0.749,128,452,580,360,85,42,181,225,1551,4.9,3.2,8.1,2021
Chris Silva,PF,25,10,91,8,15,0.533,0,0,0.0,8,15,0.533,10,12,0.833,13,23,36,7,0,1,8,20,26,0.1,0.1,0.3,2021
Marko Simonovic,C,22,9,35,4,15,0.267,1,5,0.2,3,10,0.3,8,11,0.727,5,5,10,0,1,1,2,6,17,0.0,0.0,0.0,2021
Anfernee Simons,SG,22,57,1681,353,797,0.443,179,442,0.405,174,355,0.49,103,116,0.888,26,125,151,221,30,6,115,110,988,2.0,-0.1,1.9,2021
Zavier Simpson,PG,24,4,174,19,52,0.365,1,8,0.125,18,44,0.409,5,5,1.0,2,19,21,30,5,4,10,15,44,-0.2,0.1,-0.1,2021
Jericho Sims,PF,23,41,555,39,54,0.722,0,0,0.0,39,54,0.722,12,29,0.414,61,108,169,21,11,22,20,66,90,0.7,0.8,1.5,2021
Deividas Sirvydis,SG,21,3,27,1,10,0.1,1,7,0.143,0,3,0.0,0,0,0.0,0,6,6,1,3,1,0,4,3,-0.1,0.1,-0.1,2021
Javonte Smart,PG,22,17,200,19,60,0.317,8,27,0.296,11,33,0.333,5,6,0.833,5,19,24,16,6,3,11,12,51,-0.3,0.2,-0.2,2021
Marcus Smart,PG,27,71,2296,300,718,0.418,119,360,0.331,181,358,0.506,142,179,0.793,42,228,270,417,119,18,159,160,861,1.9,3.7,5.6,2021
Dennis Smith Jr.,PG,24,37,638,79,189,0.418,6,27,0.222,73,162,0.451,42,64,0.656,20,68,88,132,45,12,51,52,206,-0.1,0.5,0.4,2021
Ish Smith,PG,33,65,1126,185,430,0.43,25,67,0.373,160,363,0.441,15,24,0.625,25,115,140,244,47,23,78,78,410,-0.3,0.9,0.5,2021
Jalen Smith,PF,21,51,924,176,350,0.503,40,122,0.328,136,228,0.596,78,102,0.765,101,206,307,24,15,41,42,96,470,1.7,1.1,2.8,2021
Xavier Sneed,SF,24,9,39,2,10,0.2,1,8,0.125,1,2,0.5,0,0,0.0,2,4,6,1,0,0,0,2,5,-0.1,0.0,0.0,2021
Tony Snell,SG,30,53,822,69,171,0.404,45,128,0.352,24,43,0.558,4,4,1.0,16,87,103,28,16,9,19,70,187,0.2,0.2,0.4,2021
Jaden Springer,SG,19,2,6,1,1,1.0,0,0,0.0,1,1,1.0,0,0,0.0,1,1,2,0,0,2,1,0,2,0.0,0.0,0.0,2021
Cassius Stanley,SG,22,9,155,19,46,0.413,4,17,0.235,15,29,0.517,10,10,1.0,5,14,19,4,5,2,6,17,52,0.0,0.1,0.1,2021
Nik Stauskas,SG,28,8,39,5,14,0.357,4,10,0.4,1,4,0.25,4,6,0.667,1,2,3,2,0,0,1,1,18,0.0,0.0,0.1,2021
Lance Stephenson,PG,31,46,814,147,323,0.455,27,90,0.3,120,233,0.515,63,80,0.788,12,115,127,165,24,4,72,96,384,0.4,0.4,0.8,2021
Lamar Stevens,PF,24,63,1015,156,319,0.489,18,65,0.277,138,254,0.543,53,75,0.707,47,117,164,44,31,18,41,106,383,0.4,1.2,1.6,2021
Isaiah Stewart,C,20,71,1816,250,490,0.51,15,46,0.326,235,444,0.529,74,103,0.718,226,391,617,82,22,78,85,211,589,1.6,1.8,3.4,2021
Max Strus,SF,25,68,1587,249,564,0.441,181,442,0.41,68,122,0.557,42,53,0.792,24,178,202,92,28,16,57,116,721,2.0,1.7,3.6,2021
Jalen Suggs,PG,20,48,1307,198,548,0.361,42,196,0.214,156,352,0.443,126,163,0.773,26,145,171,209,59,19,143,142,564,-3.0,1.3,-1.6,2021
Craig Sword,SG,28,3,19,3,4,0.75,0,1,0.0,3,3,1.0,0,0,0.0,0,0,0,1,4,0,1,7,6,0.0,0.0,0.1,2021
Keifer Sykes,PG,28,32,566,69,190,0.363,27,90,0.3,42,100,0.42,15,17,0.882,8,37,45,62,12,4,33,51,180,-0.5,0.1,-0.5,2021
Jae'Sean Tate,PF,26,78,2056,363,729,0.498,63,202,0.312,300,527,0.569,130,184,0.707,135,285,420,222,72,41,139,286,919,1.9,1.1,3.0,2021
Jayson Tatum,SF,23,76,2731,708,1564,0.453,230,651,0.353,478,913,0.524,400,469,0.853,85,524,609,334,75,49,217,174,2046,5.0,4.6,9.6,2021
Terry Taylor,PF,22,33,714,135,220,0.614,12,38,0.316,123,182,0.676,36,51,0.706,95,77,172,41,14,8,23,61,318,2.2,0.2,2.4,2021
Garrett Temple,SG,35,59,1098,111,295,0.376,59,185,0.319,52,110,0.473,28,41,0.683,29,114,143,74,43,23,42,81,309,-0.1,1.0,0.8,2021
Emanuel Terry,PF,25,3,18,0,5,0.0,0,0,0.0,0,5,0.0,0,0,0.0,8,7,15,2,1,0,5,4,0,-0.1,0.0,-0.1,2021
Tyrell Terry,PG,21,2,3,1,1,1.0,0,0,0.0,1,1,1.0,0,0,0.0,0,0,0,0,0,0,0,1,2,0.0,0.0,0.0,2021
Jon Teske,C,24,3,8,0,1,0.0,0,0,0.0,0,1,0.0,0,2,0.0,0,2,2,1,1,0,0,1,0,0.0,0.0,0.0,2021
Daniel Theis,C,29,47,977,151,291,0.519,33,107,0.308,118,184,0.641,49,72,0.681,59,169,228,41,20,31,46,111,384,0.9,1.0,1.9,2021
Brodric Thomas,SG,25,12,60,8,18,0.444,2,9,0.222,6,9,0.667,3,5,0.6,2,8,10,11,1,1,6,7,21,0.0,0.1,0.1,2021
Cam Thomas,SG,20,67,1176,218,503,0.433,47,174,0.27,171,329,0.52,87,105,0.829,16,145,161,78,33,8,55,66,570,0.0,0.8,0.8,2021
Isaiah Thomas,PG,32,22,333,67,167,0.401,28,83,0.337,39,84,0.464,22,26,0.846,4,25,29,34,7,5,15,34,184,0.0,0.1,0.2,2021
Matt Thomas,SG,27,40,459,55,134,0.41,35,91,0.385,20,43,0.465,16,20,0.8,3,47,50,20,8,3,8,18,161,0.3,0.2,0.6,2021
Klay Thompson,SG,31,32,941,246,573,0.429,114,296,0.385,132,277,0.477,46,51,0.902,15,110,125,88,16,17,43,54,652,0.6,1.2,1.8,2021
Tristan Thompson,C,30,57,896,141,267,0.528,1,3,0.333,140,264,0.53,61,116,0.526,120,168,288,34,23,21,45,98,344,0.9,0.8,1.6,2021
JT Thor,PF,19,33,262,24,55,0.436,7,27,0.259,17,28,0.607,12,20,0.6,11,32,43,19,8,11,10,26,67,0.1,0.2,0.3,2021
Matisse Thybulle,SG,24,66,1685,150,300,0.5,45,144,0.313,105,156,0.673,34,43,0.791,42,109,151,75,115,71,39,158,379,1.2,2.5,3.7,2021
Killian Tillie,C,23,36,461,43,127,0.339,27,86,0.314,16,41,0.39,5,8,0.625,21,39,60,22,23,15,13,58,118,-0.1,0.6,0.6,2021
Xavier Tillman Sr.,PF,23,53,701,98,216,0.454,10,49,0.204,88,167,0.527,46,71,0.648,66,95,161,62,49,15,34,63,252,0.6,1.2,1.8,2021
Isaiah Todd,PF,20,12,74,7,26,0.269,4,16,0.25,3,10,0.3,2,6,0.333,3,9,12,4,4,2,4,4,20,-0.2,0.1,-0.2,2021
Obi Toppin,PF,23,72,1230,251,473,0.531,52,169,0.308,199,304,0.655,94,124,0.758,69,199,268,77,25,33,56,102,648,2.5,1.5,3.9,2021
Juan Toscano-Anderson,SF,28,73,994,115,235,0.489,28,87,0.322,87,148,0.588,40,70,0.571,28,148,176,127,48,17,68,115,298,0.3,1.8,2.0,2021
Karl-Anthony Towns,C,26,74,2476,642,1214,0.529,150,366,0.41,492,848,0.58,384,467,0.822,194,533,727,269,72,83,226,267,1818,7.1,3.2,10.3,2021
Gary Trent Jr.,SG,23,70,2448,450,1086,0.414,209,545,0.383,241,541,0.445,174,204,0.853,26,165,191,141,122,19,73,144,1283,3.1,2.5,5.6,2021
P.J. Tucker,PF,36,71,1981,207,428,0.484,80,193,0.415,127,235,0.54,45,61,0.738,100,287,387,149,58,15,66,161,539,2.4,2.6,5.0,2021
Rayjon Tucker,SG,24,5,71,6,9,0.667,4,5,0.8,2,4,0.5,5,7,0.714,3,5,8,10,4,0,1,5,21,0.3,0.1,0.4,2021
Myles Turner,C,25,42,1235,200,393,0.509,61,183,0.333,139,210,0.662,79,105,0.752,65,232,297,44,28,118,54,119,540,1.7,1.4,3.1,2021
Jonas Valančiūnas,C,29,74,2240,510,938,0.544,57,158,0.361,453,780,0.581,237,289,0.82,226,617,843,190,41,60,179,247,1314,4.6,2.7,7.3,2021
Denzel Valentine,SG,28,24,222,25,66,0.379,19,47,0.404,6,19,0.316,0,0,0.0,9,33,42,11,8,0,12,20,69,-0.1,0.3,0.2,2021
Jarred Vanderbilt,PF,22,74,1880,212,361,0.587,2,14,0.143,210,347,0.605,86,131,0.656,215,409,624,94,99,46,73,181,512,3.1,2.9,6.0,2021
Fred VanVleet,PG,27,65,2462,442,1097,0.403,242,642,0.377,200,455,0.44,194,222,0.874,44,245,289,434,111,35,170,162,1320,3.9,2.8,6.7,2021
Devin Vassell,SF,21,71,1937,326,764,0.427,137,380,0.361,189,384,0.492,83,99,0.838,44,262,306,136,76,41,58,143,872,1.3,2.0,3.3,2021
Gabe Vincent,PG,25,68,1589,214,513,0.417,119,323,0.368,95,190,0.5,44,54,0.815,22,104,126,210,62,12,98,158,591,0.7,1.9,2.5,2021
Nikola Vučević,C,31,73,2418,546,1154,0.473,104,331,0.314,442,823,0.537,92,121,0.76,142,662,804,236,70,71,136,181,1288,1.4,3.2,4.5,2021
Dean Wade,PF,25,51,980,99,217,0.456,51,142,0.359,48,75,0.64,20,30,0.667,31,119,150,52,29,7,16,88,269,1.1,1.1,2.3,2021
Franz Wagner,SF,20,79,2429,456,975,0.468,96,271,0.354,360,704,0.511,189,219,0.863,84,272,356,231,68,34,119,164,1197,2.1,1.9,4.0,2021
Moritz Wagner,C,24,63,960,197,396,0.497,66,201,0.328,131,195,0.672,104,129,0.806,42,190,232,87,20,13,56,123,564,1.8,1.0,2.8,2021
Ish Wainright,PF,27,45,359,41,104,0.394,19,59,0.322,22,45,0.489,7,12,0.583,27,27,54,15,20,6,13,49,108,0.0,0.6,0.6,2021
Kemba Walker,PG,31,37,948,149,370,0.403,73,199,0.367,76,171,0.444,60,71,0.845,14,97,111,131,26,7,48,37,431,1.0,0.9,1.8,2021
Lonnie Walker IV,SG,23,70,1612,311,764,0.407,111,353,0.314,200,411,0.487,116,148,0.784,18,163,181,152,44,19,71,98,849,0.1,1.1,1.2,2021
M.J. Walker,SG,23,2,8,0,4,0.0,0,2,0.0,0,2,0.0,0,0,0.0,0,1,1,1,2,0,0,1,0,-0.1,0.0,0.0,2021
Tyrone Wallace,SG,27,6,75,7,20,0.35,2,8,0.25,5,12,0.417,1,5,0.2,0,8,8,1,3,1,2,7,17,-0.2,0.1,-0.1,2021
Derrick Walton,PG,26,3,108,6,26,0.231,3,13,0.231,3,13,0.231,4,4,1.0,2,8,10,21,7,4,11,8,19,-0.3,0.1,-0.2,2021
Brad Wanamaker,PG,32,23,320,28,77,0.364,4,17,0.235,24,60,0.4,23,25,0.92,6,33,39,55,7,6,23,45,83,-0.1,0.1,0.0,2021
Duane Washington Jr.,PG,21,48,968,173,427,0.405,81,215,0.377,92,212,0.434,46,61,0.754,4,79,83,85,26,3,57,66,473,-0.2,0.2,0.0,2021
P.J. Washington,C,23,65,1768,250,532,0.47,110,301,0.365,140,231,0.606,58,81,0.716,82,255,337,147,57,61,82,152,668,1.8,1.6,3.4,2021
Yuta Watanabe,SF,27,38,445,56,138,0.406,27,79,0.342,29,59,0.492,24,40,0.6,18,74,92,21,11,16,19,38,163,0.1,0.6,0.7,2021
Lindy Waters III,SG,24,25,465,71,175,0.406,53,146,0.363,18,29,0.621,4,5,0.8,6,67,73,24,19,8,11,31,199,0.3,0.5,0.8,2021
Tremont Waters,PG,24,3,50,4,14,0.286,2,9,0.222,2,5,0.4,0,0,0.0,0,4,4,7,5,0,4,4,10,-0.1,0.1,0.0,2021
Trendon Watford,SF,21,48,869,142,267,0.532,9,38,0.237,133,229,0.581,71,94,0.755,57,142,199,81,25,28,44,116,364,1.4,0.5,1.9,2021
Paul Watson,SF,27,9,156,12,35,0.343,6,26,0.231,6,9,0.667,1,2,0.5,3,24,27,8,3,3,4,10,31,-0.1,0.1,0.0,2021
Quinndary Weatherspoon,SG,25,11,73,12,21,0.571,1,5,0.2,11,16,0.688,5,5,1.0,2,12,14,5,1,1,3,15,30,0.1,0.1,0.2,2021
Russell Westbrook,PG,33,78,2678,548,1233,0.444,79,265,0.298,469,968,0.485,266,399,0.667,110,470,580,550,75,20,295,235,1441,-0.6,2.3,1.7,2021
Coby White,PG,21,61,1675,279,644,0.433,136,353,0.385,143,291,0.491,78,91,0.857,17,165,182,176,29,11,70,137,772,1.6,0.8,2.4,2021
Derrick White,SG,27,75,2199,337,800,0.421,115,369,0.312,222,431,0.515,203,235,0.864,38,223,261,366,64,58,119,172,992,2.8,2.3,5.1,2021
Hassan Whiteside,C,32,65,1162,215,330,0.652,0,0,0.0,215,330,0.652,104,167,0.623,166,328,494,26,22,103,53,179,534,3.4,2.3,5.8,2021
Joe Wieskamp,SG,22,29,205,20,56,0.357,14,43,0.326,6,13,0.462,7,13,0.538,4,10,14,9,4,3,2,14,61,0.1,0.1,0.1,2021
Aaron Wiggins,SG,23,50,1209,156,337,0.463,42,138,0.304,114,199,0.573,62,85,0.729,51,127,178,68,30,10,54,93,416,0.5,0.8,1.2,2021
Andrew Wiggins,SF,26,73,2330,475,1019,0.466,157,399,0.393,318,620,0.513,149,235,0.634,85,240,325,161,76,51,111,158,1256,1.8,3.4,5.1,2021
Lindell Wigginton,PG,23,19,199,26,61,0.426,9,26,0.346,17,35,0.486,19,35,0.543,3,22,25,23,5,1,12,17,80,0.0,0.1,0.2,2021
Brandon Williams,PG,22,24,640,105,282,0.372,31,106,0.292,74,176,0.42,68,97,0.701,19,55,74,94,24,10,58,52,309,-0.7,0.2,-0.5,2021
Grant Williams,PF,23,77,1875,205,432,0.475,106,258,0.411,99,174,0.569,86,95,0.905,64,210,274,78,38,57,62,186,602,2.4,2.6,5.1,2021
Kenrich Williams,SF,27,49,1072,146,317,0.461,41,121,0.339,105,196,0.536,30,55,0.545,75,145,220,108,44,10,46,81,363,0.8,1.0,1.8,2021
Lou Williams,PG,35,56,799,125,320,0.391,37,102,0.363,88,218,0.404,67,78,0.859,16,71,87,105,28,3,43,48,354,0.2,0.4,0.6,2021
Patrick Williams,PF,20,17,422,54,102,0.529,15,29,0.517,39,73,0.534,30,41,0.732,17,52,69,15,9,9,16,28,153,0.6,0.3,0.9,2021
Robert Williams,C,24,61,1804,271,368,0.736,0,1,0.0,271,367,0.738,65,90,0.722,238,350,588,121,56,134,63,137,607,6.0,3.9,9.9,2021
Ziaire Williams,SF,20,62,1346,191,424,0.45,76,242,0.314,115,182,0.632,43,55,0.782,26,103,129,65,35,12,41,113,501,1.1,1.1,2.2,2021
D.J. Wilson,PF,25,4,54,11,15,0.733,0,2,0.0,11,13,0.846,8,10,0.8,1,15,16,5,5,1,2,6,30,0.2,0.1,0.4,2021
Dylan Windler,SF,25,50,459,37,98,0.378,21,70,0.3,16,28,0.571,15,18,0.833,21,68,89,34,14,3,16,47,110,0.2,0.6,0.8,2021
Justise Winslow,PF,25,48,775,110,257,0.428,15,66,0.227,95,191,0.497,39,66,0.591,50,152,202,84,35,25,49,67,274,-0.3,1.1,0.8,2021
Cassius Winston,PG,23,7,39,4,11,0.364,2,6,0.333,2,5,0.4,4,4,1.0,0,1,1,7,0,0,3,9,14,0.0,0.0,0.0,2021
Christian Wood,C,26,68,2094,440,878,0.501,131,336,0.39,309,542,0.57,207,332,0.623,110,576,686,155,54,65,126,171,1218,2.9,2.0,4.9,2021
Robert Woodard II,SF,22,12,42,2,16,0.125,1,4,0.25,1,12,0.083,2,2,1.0,5,6,11,3,1,1,1,3,7,-0.2,0.0,-0.1,2021
Delon Wright,SG,29,77,1452,122,269,0.454,44,116,0.379,78,153,0.51,54,63,0.857,50,170,220,188,93,19,45,56,342,2.2,1.5,3.6,2021
McKinley Wright IV,PG,23,5,19,2,3,0.667,1,2,0.5,1,1,1.0,0,0,0.0,0,0,0,3,0,0,1,1,5,0.0,0.0,0.0,2021
Moses Wright,PF,23,4,15,1,4,0.25,0,1,0.0,1,3,0.333,3,3,1.0,1,2,3,2,0,1,0,0,5,0.0,0.0,0.1,2021
Gabe York,SG,28,2,21,2,7,0.286,1,6,0.167,1,1,1.0,3,5,0.6,0,2,2,4,2,1,1,4,8,0.0,0.0,0.0,2021
Thaddeus Young,PF,33,52,845,141,272,0.518,17,48,0.354,124,224,0.554,23,49,0.469,80,128,208,104,54,18,52,81,322,0.9,1.3,2.2,2021
Trae Young,PG,23,76,2652,711,1544,0.46,233,610,0.382,478,934,0.512,500,553,0.904,50,234,284,737,72,7,303,128,2155,9.0,1.0,10.0,2021
Omer Yurtseven,C,23,56,706,130,247,0.526,1,11,0.091,129,236,0.547,38,61,0.623,85,209,294,49,17,20,41,84,299,0.8,1.4,2.1,2021
Cody Zeller,C,29,27,355,51,90,0.567,0,4,0.0,51,86,0.593,38,49,0.776,50,75,125,22,8,6,19,56,140,0.9,0.2,1.1,2021
Ivica Zubac,C,24,76,1852,310,495,0.626,0,0,0.0,310,495,0.626,165,227,0.727,217,427,644,120,36,77,114,203,785,4.3,2.9,7.2,2021
Precious Achiuwa,C,23,55,1140,196,404,0.485,29,108,0.269,167,296,0.564,87,124,0.702,100,228,328,50,31,30,59,102,508,0.8,1.4,2.2,2022
Steven Adams,C,29,42,1133,157,263,0.597,0,1,0.0,157,262,0.599,47,129,0.364,214,271,485,97,36,46,79,98,361,1.3,2.1,3.4,2022
Bam Adebayo,C,25,75,2598,602,1114,0.54,1,12,0.083,601,1102,0.545,324,402,0.806,184,504,688,240,88,61,187,208,1529,3.6,3.8,7.4,2022
Ochai Agbaji,SG,22,59,1209,165,386,0.427,81,228,0.355,84,158,0.532,56,69,0.812,43,78,121,67,16,15,41,99,467,0.9,0.4,1.3,2022
Santi Aldama,PF,22,77,1682,247,525,0.47,94,266,0.353,153,259,0.591,108,144,0.75,85,286,371,97,45,48,60,143,696,2.1,2.4,4.6,2022
Nickeil Alexander-Walker,SG,24,59,884,131,295,0.444,61,159,0.384,70,136,0.515,40,60,0.667,15,86,101,108,32,21,55,88,363,0.3,0.8,1.1,2022
Grayson Allen,SG,27,72,1972,245,557,0.44,146,366,0.399,99,191,0.518,114,126,0.905,61,176,237,163,62,14,72,117,750,2.8,2.2,5.1,2022
Jarrett Allen,C,24,68,2220,403,626,0.644,1,10,0.1,402,616,0.653,162,221,0.733,221,445,666,113,54,84,93,153,969,5.5,4.0,9.5,2022
Jose Alvarado,PG,24,61,1310,201,489,0.411,83,247,0.336,118,242,0.488,65,80,0.813,28,113,141,186,67,10,81,125,550,0.1,1.7,1.8,2022
Kyle Anderson,PF,29,69,1957,252,495,0.509,43,105,0.41,209,390,0.536,100,136,0.735,66,302,368,335,78,63,103,146,647,2.5,2.6,5.1,2022
Giannis Antetokounmpo,PF,28,63,2024,707,1278,0.553,47,171,0.275,660,1107,0.596,498,772,0.645,137,605,742,359,52,51,246,197,1959,4.9,3.7,8.6,2022
Thanasis Antetokounmpo,PF,30,37,206,20,46,0.435,0,8,0.0,20,38,0.526,11,22,0.5,15,29,44,15,3,3,12,22,51,-0.1,0.2,0.1,2022
Cole Anthony,PG,22,60,1552,277,610,0.454,75,206,0.364,202,404,0.5,152,170,0.894,47,241,288,235,37,31,91,158,781,2.1,1.7,3.7,2022
OG Anunoby,SF,25,67,2386,421,885,0.476,142,367,0.387,279,518,0.539,140,167,0.838,95,237,332,131,128,50,132,200,1124,1.8,2.9,4.7,2022
Ryan Arcidiacono,PG,28,20,172,9,37,0.243,8,23,0.348,1,14,0.071,0,0,0.0,0,15,15,23,5,0,7,17,26,-0.2,0.1,-0.2,2022
Deni Avdija,SF,22,76,2020,253,579,0.437,69,232,0.297,184,347,0.53,122,165,0.739,74,413,487,211,65,29,123,209,697,0.0,2.3,2.3,2022
Deandre Ayton,C,24,67,2035,522,887,0.589,7,24,0.292,515,863,0.597,152,200,0.76,172,495,667,115,37,53,120,190,1203,3.3,3.0,6.2,2022
Udoka Azubuike,C,23,36,359,59,72,0.819,0,0,0.0,59,72,0.819,7,20,0.35,31,88,119,11,6,15,18,34,125,0.6,0.4,1.0,2022
Marvin Bagley III,C,23,42,990,202,382,0.529,19,66,0.288,183,316,0.579,81,108,0.75,94,175,269,36,19,30,46,81,504,1.3,0.7,2.0,2022
Patrick Baldwin Jr.,SF,20,31,226,43,109,0.394,32,84,0.381,11,25,0.44,4,6,0.667,1,39,40,11,6,4,11,14,122,-0.1,0.3,0.1,2022
LaMelo Ball,PG,21,36,1268,296,721,0.411,144,383,0.376,152,338,0.45,102,122,0.836,42,189,231,304,46,11,129,118,838,0.6,1.2,1.8,2022
Mo Bamba,C,24,49,769,117,241,0.485,48,124,0.387,69,117,0.59,41,62,0.661,58,167,225,46,13,43,30,105,323,1.1,1.1,2.2,2022
Paolo Banchero,PF,20,72,2430,479,1122,0.427,85,285,0.298,394,837,0.471,394,534,0.738,84,413,497,269,60,39,200,160,1437,-0.3,2.6,2.4,2022
Desmond Bane,SG,24,58,1841,450,939,0.479,166,407,0.408,284,532,0.534,181,205,0.883,43,248,291,254,56,22,126,150,1247,3.5,2.3,5.8,2022
Dalano Banton,PG,23,31,279,55,130,0.423,15,51,0.294,40,79,0.506,17,24,0.708,11,34,45,36,13,13,18,34,142,0.0,0.4,0.4,2022
Dominick Barlow,PF,19,28,408,46,86,0.535,0,4,0.0,46,82,0.561,18,25,0.72,46,56,102,24,10,19,15,56,110,0.5,0.2,0.7,2022
Harrison Barnes,PF,30,82,2662,374,791,0.473,132,353,0.374,242,438,0.553,350,413,0.847,87,279,366,128,57,10,86,103,1230,5.1,1.4,6.5,2022
Scottie Barnes,SF,21,77,2678,463,1016,0.456,63,224,0.281,400,792,0.505,190,246,0.772,179,333,512,371,83,61,154,170,1179,2.3,2.7,5.0,2022
RJ Barrett,SG,22,73,2475,510,1176,0.434,121,390,0.31,389,786,0.495,290,392,0.74,60,308,368,201,31,15,164,179,1431,0.5,1.8,2.2,2022
Will Barton,SG,32,56,993,138,364,0.379,66,180,0.367,72,184,0.391,37,47,0.787,15,122,137,112,28,13,48,56,379,-0.4,0.8,0.4,2022
Charles Bassey,C,22,35,508,87,135,0.644,3,8,0.375,84,127,0.661,22,37,0.595,75,118,193,47,16,33,41,74,199,0.7,0.6,1.3,2022
Keita Bates-Diop,PF,27,67,1452,236,465,0.508,56,142,0.394,180,323,0.557,119,150,0.793,65,183,248,103,46,20,56,63,647,2.1,0.6,2.7,2022
Nicolas Batum,PF,34,78,1709,160,381,0.42,124,317,0.391,36,64,0.563,34,48,0.708,62,237,299,121,54,44,50,149,478,1.7,1.9,3.6,2022
Darius Bazley,C,22,43,616,83,183,0.454,20,53,0.377,63,130,0.485,38,70,0.543,34,104,138,38,22,34,27,44,224,0.1,0.9,1.0,2022
Bradley Beal,SG,29,50,1673,444,878,0.506,80,219,0.365,364,659,0.552,192,228,0.842,41,155,196,271,45,33,145,107,1160,2.2,1.2,3.4,2022
Malik Beasley,SG,26,81,2093,370,937,0.395,235,658,0.357,135,279,0.484,50,65,0.769,35,248,283,124,65,9,90,107,1025,-0.2,1.6,1.4,2022
MarJon Beauchamp,SF,22,52,701,96,243,0.395,47,142,0.331,49,101,0.485,27,37,0.73,38,77,115,35,21,7,45,71,266,-0.4,0.8,0.4,2022
Dāvis Bertāns,PF,30,45,492,69,160,0.431,55,141,0.39,14,19,0.737,13,15,0.867,10,43,53,21,11,8,10,53,206,0.6,0.3,0.9,2022
Patrick Beverley,SG,34,67,1816,144,360,0.4,80,239,0.335,64,121,0.529,47,65,0.723,44,203,247,194,63,41,60,187,415,0.8,2.1,3.0,2022
Saddiq Bey,SF,23,77,2129,353,836,0.422,151,418,0.361,202,418,0.483,205,238,0.861,98,264,362,118,70,13,71,123,1062,2.6,1.2,3.9,2022
Khem Birch,C,30,20,162,19,32,0.594,1,2,0.5,18,30,0.6,4,5,0.8,8,17,25,7,5,5,8,24,43,0.1,0.2,0.2,2022
Goga Bitadze,C,23,38,457,69,125,0.552,6,26,0.231,63,99,0.636,23,42,0.548,61,76,137,39,16,26,22,64,167,0.8,0.6,1.3,2022
Bismack Biyombo,C,30,61,874,119,206,0.578,0,0,0.0,119,206,0.578,25,70,0.357,89,171,260,56,18,88,51,114,263,0.2,1.6,1.9,2022
Buddy Boeheim,SF,23,10,90,5,27,0.185,4,25,0.16,1,2,0.5,2,2,1.0,2,4,6,4,2,0,0,6,16,-0.2,0.0,-0.2,2022
Bogdan Bogdanović,SG,30,54,1508,273,611,0.447,146,360,0.406,127,251,0.506,64,77,0.831,23,142,165,150,43,18,65,86,756,1.8,1.0,2.8,2022
Bojan Bogdanović,PF,33,59,1893,430,882,0.488,145,353,0.411,285,529,0.539,268,303,0.884,36,187,223,152,34,8,135,113,1273,3.1,0.4,3.5,2022
Bol Bol,PF,23,70,1505,261,478,0.546,30,113,0.265,231,365,0.633,82,108,0.759,69,336,405,69,30,85,112,92,634,0.0,2.2,2.3,2022
Leandro Bolmaro,SF,22,14,68,3,20,0.15,0,4,0.0,3,16,0.188,0,0,0.0,4,3,7,7,3,1,7,10,6,-0.4,0.0,-0.3,2022
Devin Booker,SG,26,53,1835,527,1067,0.494,111,316,0.351,416,751,0.554,306,358,0.855,46,194,240,293,51,18,145,159,1471,4.2,1.9,6.0,2022
Brandon Boston Jr.,SF,21,22,248,51,122,0.418,12,29,0.414,39,93,0.419,29,38,0.763,7,23,30,20,9,0,12,21,143,0.0,0.2,0.2,2022
Chris Boucher,PF,30,76,1523,261,529,0.493,62,189,0.328,199,340,0.585,128,168,0.762,157,264,421,29,47,64,41,143,712,3.0,2.0,5.0,2022
James Bouknight,SG,22,34,515,69,193,0.358,33,109,0.303,36,84,0.429,20,30,0.667,8,64,72,41,14,5,32,49,191,-0.8,0.4,-0.4,2022
Jamaree Bouyea,PG,23,5,71,6,14,0.429,2,6,0.333,4,8,0.5,1,2,0.5,1,5,6,4,4,2,4,6,15,-0.1,0.1,0.0,2022
Tony Bradley,C,25,12,33,6,12,0.5,3,5,0.6,3,7,0.429,4,4,1.0,1,10,11,1,1,1,1,2,19,0.1,0.1,0.2,2022
Malaki Branham,SG,19,66,1550,269,611,0.44,77,255,0.302,192,356,0.539,58,70,0.829,28,153,181,127,33,7,76,115,673,-0.4,0.2,-0.1,2022
Jarrell Brantley,PF,26,4,39,8,14,0.571,4,9,0.444,4,5,0.8,2,2,1.0,1,5,6,3,0,2,2,3,22,0.1,0.0,0.1,2022
Christian Braun,SG,21,76,1181,143,289,0.495,34,96,0.354,109,193,0.565,40,64,0.625,48,133,181,59,41,17,35,101,360,0.7,1.2,1.9,2022
Mikal Bridges,SF,26,83,2963,593,1267,0.468,169,442,0.382,424,825,0.514,316,353,0.895,79,285,364,273,91,61,127,159,1671,4.4,3.1,7.5,2022
Oshae Brissett,PF,24,65,1083,123,319,0.386,48,155,0.31,75,164,0.457,104,145,0.717,62,156,218,44,33,13,34,79,398,0.4,0.7,1.1,2022
Malcolm Brogdon,PG,30,67,1744,354,732,0.484,132,297,0.444,222,435,0.51,160,184,0.87,42,238,280,248,45,18,98,109,1000,3.6,2.2,5.8,2022
Dillon Brooks,SF,27,73,2214,392,991,0.396,143,439,0.326,249,552,0.451,120,154,0.779,45,199,244,189,65,16,104,240,1047,-0.8,2.4,1.6,2022
Bruce Brown,SF,26,80,2280,358,741,0.483,91,254,0.358,267,487,0.548,116,153,0.758,63,265,328,268,87,51,123,190,923,1.7,2.6,4.3,2022
Greg Brown III,PF,21,16,93,11,28,0.393,1,7,0.143,10,21,0.476,5,12,0.417,2,17,19,3,4,5,6,13,28,-0.3,0.1,-0.1,2022
Jaylen Brown,SF,26,67,2405,679,1383,0.491,163,487,0.335,516,896,0.576,263,344,0.765,78,381,459,232,75,26,197,172,1784,1.6,3.4,5.0,2022
Kendall Brown,SG,19,6,40,4,7,0.571,0,1,0.0,4,6,0.667,1,2,0.5,2,4,6,3,4,0,2,9,9,0.0,0.1,0.1,2022
Moses Brown,C,23,36,294,61,96,0.635,0,0,0.0,61,96,0.635,33,72,0.458,57,82,139,4,4,14,15,39,155,0.7,0.4,1.1,2022
Sterling Brown,SF,27,4,24,0,4,0.0,0,2,0.0,0,2,0.0,0,0,0.0,3,5,8,2,3,0,0,4,0,0.0,0.1,0.0,2022
Troy Brown Jr.,SF,23,76,1860,200,465,0.43,107,281,0.381,93,184,0.505,34,39,0.872,62,246,308,95,59,16,49,120,541,1.0,2.0,2.9,2022
Jalen Brunson,PG,26,68,2379,587,1195,0.491,134,322,0.416,453,873,0.519,325,392,0.829,40,201,241,421,61,15,142,152,1633,6.9,1.8,8.7,2022
Thomas Bryant,C,25,59,1081,230,369,0.623,26,59,0.441,204,310,0.658,93,126,0.738,86,253,339,31,16,30,38,102,579,2.7,1.4,4.1,2022
Reggie Bullock,SF,31,78,2364,192,470,0.409,151,397,0.38,41,73,0.562,26,37,0.703,32,251,283,108,54,13,36,166,561,1.3,1.4,2.8,2022
Alec Burks,SG,31,51,1122,200,459,0.436,99,239,0.414,101,220,0.459,153,188,0.814,19,139,158,114,38,8,58,98,652,1.9,0.6,2.5,2022
Deonte Burton,PF,29,2,6,0,2,0.0,0,1,0.0,0,1,0.0,0,0,0.0,0,0,0,0,0,0,0,0,0,0.0,0.0,0.0,2022
Jared Butler,PG,22,6,77,15,32,0.469,7,14,0.5,8,18,0.444,0,0,0.0,1,3,4,8,5,0,5,5,37,0.0,0.1,0.1,2022
Jimmy Butler,PF,33,64,2138,479,888,0.539,36,103,0.35,443,785,0.564,472,555,0.85,141,234,375,340,117,21,101,80,1466,9.4,2.9,12.3,2022
John Butler,C,20,19,221,17,53,0.321,8,35,0.229,9,18,0.5,3,4,0.75,3,14,17,11,7,9,1,22,45,-0.1,0.1,0.0,2022
Jamal Cain,PF,23,18,240,37,66,0.561,7,20,0.35,30,46,0.652,17,22,0.773,15,37,52,12,11,1,6,21,98,0.5,0.3,0.8,2022
Kentavious Caldwell-Pope,SG,29,76,2381,292,632,0.462,135,319,0.423,157,313,0.502,103,125,0.824,35,173,208,183,112,35,86,145,822,2.0,2.5,4.5,2022
Facundo Campazzo,PG,31,8,52,3,13,0.231,3,11,0.273,0,2,0.0,1,2,0.5,0,2,2,9,6,0,3,3,10,-0.1,0.1,0.0,2022
Vlatko Čančar,PF,25,60,889,108,227,0.476,43,115,0.374,65,112,0.58,38,41,0.927,24,104,128,80,22,14,37,84,297,0.9,0.8,1.7,2022
Clint Capela,C,28,65,1730,350,536,0.653,0,1,0.0,350,535,0.654,79,131,0.603,258,459,717,58,45,79,54,139,779,4.9,2.4,7.2,2022
Vernon Carey Jr.,C,21,11,28,2,8,0.25,0,0,0.0,2,8,0.25,2,2,1.0,3,8,11,3,2,2,2,5,6,-0.1,0.1,0.0,2022
Jevon Carter,PG,27,81,1810,239,565,0.423,142,337,0.421,97,228,0.425,31,38,0.816,35,167,202,197,66,29,78,158,651,1.2,2.3,3.5,2022
Wendell Carter Jr.,C,23,57,1690,322,613,0.525,80,225,0.356,242,388,0.624,144,195,0.738,120,377,497,132,30,33,106,159,868,2.6,2.0,4.6,2022
Michael Carter-Williams,PG,31,4,44,6,14,0.429,1,3,0.333,5,11,0.455,4,7,0.571,1,4,5,7,1,1,4,5,17,0.0,0.0,0.0,2022
Alex Caruso,PG,28,67,1575,130,286,0.455,55,151,0.364,75,135,0.556,59,73,0.808,42,154,196,193,98,46,77,159,374,1.0,2.6,3.6,2022
Julian Champagnie,SF,21,17,320,59,130,0.454,33,82,0.402,26,48,0.542,14,17,0.824,10,50,60,10,6,5,11,26,165,0.3,0.1,0.4,2022
Justin Champagnie,SF,21,5,34,5,15,0.333,1,5,0.2,4,10,0.4,0,0,0.0,3,5,8,4,1,0,0,2,11,0.0,0.0,0.0,2022
Kennedy Chandler,PG,20,36,281,35,83,0.422,2,15,0.133,33,68,0.485,6,13,0.462,9,29,38,58,12,5,18,15,78,-0.1,0.4,0.3,2022
Max Christie,SG,19,41,512,44,106,0.415,26,62,0.419,18,44,0.409,14,16,0.875,7,68,75,21,9,7,13,33,128,0.1,0.5,0.6,2022
Josh Christopher,SG,21,64,786,153,329,0.465,21,89,0.236,132,240,0.55,45,60,0.75,20,51,71,73,33,15,60,59,372,-0.3,0.3,0.0,2022
Brandon Clarke,PF,26,56,1090,229,349,0.656,1,6,0.167,228,343,0.665,99,137,0.723,92,218,310,72,34,37,55,131,558,2.7,1.8,4.5,2022
Jordan Clarkson,SG,30,61,1988,458,1031,0.444,155,459,0.338,303,572,0.53,200,245,0.816,72,174,246,270,33,13,186,120,1271,0.9,0.8,1.7,2022
Nic Claxton,C,23,76,2271,414,587,0.705,0,2,0.0,414,585,0.708,133,246,0.541,184,518,702,144,65,189,96,212,961,5.2,4.0,9.2,2022
Amir Coffey,SF,25,50,625,56,145,0.386,11,40,0.275,45,105,0.429,49,63,0.778,17,36,53,53,7,5,21,50,172,0.1,0.3,0.4,2022
John Collins,PF,25,71,2130,359,707,0.508,70,240,0.292,289,467,0.619,143,178,0.803,77,385,462,85,42,73,79,220,931,2.1,2.1,4.2,2022
Zach Collins,C,25,63,1441,284,548,0.518,55,147,0.374,229,401,0.571,108,142,0.761,116,286,402,180,37,49,129,199,731,1.2,1.0,2.2,2022
Chance Comanche,C,26,1,21,3,5,0.6,0,0,0.0,3,5,0.6,1,4,0.25,2,1,3,0,0,1,0,0,7,0.0,0.0,0.0,2022
Mike Conley,PG,35,67,2029,261,610,0.428,135,351,0.385,126,259,0.486,141,169,0.834,33,149,182,450,73,14,103,139,798,4.1,1.4,5.5,2022
Pat Connaughton,SF,30,61,1443,165,421,0.392,109,322,0.339,56,99,0.566,27,41,0.659,50,233,283,77,37,11,33,69,466,0.7,1.8,2.5,2022
Xavier Cooks,PF,27,10,126,17,28,0.607,0,1,0.0,17,27,0.63,4,10,0.4,16,22,38,6,6,4,8,13,38,0.1,0.2,0.2,2022
Robert Covington,PF,32,48,779,102,229,0.445,54,136,0.397,48,93,0.516,30,40,0.75,31,135,166,57,38,33,32,86,288,0.7,1.2,1.9,2022
Torrey Craig,PF,32,79,1948,228,500,0.456,100,253,0.395,128,247,0.518,32,45,0.711,145,281,426,117,50,62,73,179,588,1.5,2.5,4.0,2022
Jae Crowder,PF,32,18,340,45,94,0.479,24,55,0.436,21,39,0.538,10,12,0.833,17,52,69,27,12,6,7,27,124,0.7,0.5,1.2,2022
Jarrett Culver,SF,23,10,137,17,43,0.395,1,12,0.083,16,31,0.516,9,13,0.692,10,28,38,6,6,2,7,14,44,-0.1,0.2,0.0,2022
Cade Cunningham,PG,21,12,400,93,224,0.415,17,61,0.279,76,163,0.466,36,43,0.837,12,62,74,72,10,7,39,34,239,-0.4,0.2,-0.1,2022
Seth Curry,SG,32,61,1211,208,449,0.463,94,232,0.405,114,217,0.525,51,55,0.927,13,87,100,99,36,7,51,96,561,0.9,0.9,1.8,2022
Stephen Curry,PG,34,56,1941,559,1133,0.493,273,639,0.427,286,494,0.579,257,281,0.915,39,302,341,352,52,20,179,117,1648,5.8,2.0,7.8,2022
Dyson Daniels,PG,19,59,1042,87,208,0.418,27,86,0.314,60,122,0.492,26,40,0.65,36,152,188,134,43,11,57,99,227,-0.1,1.4,1.3,2022
Anthony Davis,C,29,56,1904,542,962,0.563,19,74,0.257,523,888,0.589,348,444,0.784,195,507,702,148,59,114,122,146,1451,5.5,3.4,9.0,2022
Johnny Davis,SG,20,28,423,66,171,0.386,17,70,0.243,49,101,0.485,14,27,0.519,10,55,65,28,10,8,17,48,163,-0.6,0.3,-0.3,2022
Terence Davis,SG,25,64,841,154,364,0.423,89,243,0.366,65,121,0.537,34,43,0.791,20,119,139,67,43,12,53,104,431,0.0,0.9,0.9,2022
JD Davison,SG,20,12,66,8,19,0.421,2,7,0.286,6,12,0.5,1,2,0.5,2,7,9,11,2,2,4,5,19,0.0,0.1,0.1,2022
Darius Days,SF,23,4,25,5,12,0.417,3,10,0.3,2,2,1.0,2,2,1.0,1,5,6,1,0,1,0,2,15,0.1,0.0,0.1,2022
Dewayne Dedmon,C,33,38,426,77,151,0.51,12,39,0.308,65,112,0.58,33,49,0.673,34,100,134,26,9,19,25,75,199,0.3,0.7,1.0,2022
Matthew Dellavedova,PG,32,32,213,17,50,0.34,9,27,0.333,8,23,0.348,4,7,0.571,1,12,13,41,7,0,10,20,47,0.0,0.1,0.1,2022
DeMar DeRozan,SF,33,74,2682,657,1303,0.504,46,142,0.324,611,1161,0.526,456,523,0.872,34,309,343,377,83,36,153,186,1816,5.4,3.2,8.5,2022
Moussa Diabaté,C,21,22,195,24,47,0.511,1,2,0.5,23,45,0.511,10,16,0.625,31,19,50,4,7,8,9,15,59,0.2,0.2,0.4,2022
Mamadi Diakite,C,26,22,176,24,50,0.48,7,21,0.333,17,29,0.586,2,2,1.0,8,22,30,8,4,9,12,26,57,-0.1,0.3,0.2,2022
Hamidou Diallo,SF,24,56,996,215,375,0.573,5,21,0.238,210,354,0.593,87,148,0.588,57,137,194,55,53,16,71,124,522,0.4,0.9,1.3,2022
Gorgui Dieng,C,33,31,358,45,117,0.385,21,75,0.28,24,42,0.571,10,13,0.769,27,80,107,53,4,14,32,57,121,-0.2,0.2,0.0,2022
Ousmane Dieng,PF,19,39,569,76,181,0.42,26,98,0.265,50,83,0.602,15,23,0.652,19,86,105,46,14,7,26,42,193,-0.1,0.6,0.4,2022
Spencer Dinwiddie,SG,29,79,2725,460,1050,0.438,181,490,0.369,279,560,0.498,268,330,0.812,28,242,270,515,67,24,145,187,1369,4.5,1.8,6.3,2022
Donte DiVincenzo,SG,26,72,1894,235,540,0.435,150,378,0.397,85,162,0.525,58,71,0.817,80,245,325,252,97,10,112,133,678,1.9,2.3,4.2,2022
Luka Dončić,PG,23,66,2391,719,1449,0.496,185,541,0.342,534,908,0.588,515,694,0.742,54,515,569,529,90,33,236,166,2138,7.3,2.9,10.2,2022
Tyler Dorsey,SF,26,3,8,4,5,0.8,1,2,0.5,3,3,1.0,0,0,0.0,1,1,2,0,0,0,0,0,9,0.1,0.0,0.1,2022
Luguentz Dort,SF,23,74,2272,339,873,0.388,135,409,0.33,204,464,0.44,200,259,0.772,128,216,344,154,75,23,92,243,1013,0.9,2.1,2.9,2022
Ayo Dosunmu,SG,23,80,2098,281,570,0.493,59,189,0.312,222,381,0.583,66,82,0.805,45,175,220,206,62,26,99,182,687,0.7,2.2,2.9,2022
Devon Dotson,PG,23,6,53,1,10,0.1,1,4,0.25,0,6,0.0,0,0,0.0,6,4,10,8,5,0,3,9,3,-0.1,0.1,0.0,2022
Jeff Dowtin,PG,25,25,259,25,57,0.439,5,16,0.313,20,41,0.488,6,9,0.667,6,17,23,31,9,3,5,13,61,0.2,0.2,0.4,2022
PJ Dozier,SF,26,16,79,10,33,0.303,2,16,0.125,8,17,0.471,0,0,0.0,1,13,14,10,6,1,5,7,22,-0.3,0.1,-0.2,2022
Goran Dragić,PG,36,58,870,141,335,0.421,52,145,0.359,89,190,0.468,31,45,0.689,16,65,81,151,13,4,63,65,365,-0.3,0.7,0.4,2022
Andre Drummond,C,29,67,849,166,274,0.606,0,3,0.0,166,271,0.613,67,125,0.536,138,306,444,33,45,27,75,117,399,0.8,2.0,2.8,2022
Chris Duarte,SF,25,46,897,123,333,0.369,55,174,0.316,68,159,0.428,61,72,0.847,19,96,115,64,25,9,41,65,362,-0.5,0.4,0.0,2022
David Duke Jr.,SG,23,23,228,36,78,0.462,1,12,0.083,35,66,0.53,12,17,0.706,11,18,29,21,10,1,18,31,85,-0.3,0.2,-0.1,2022
Kris Dunn,PG,28,22,568,116,216,0.537,17,36,0.472,99,180,0.55,41,53,0.774,9,91,100,124,25,10,35,58,290,1.3,0.6,1.9,2022
Kevin Durant,PF,34,47,1672,483,862,0.56,93,230,0.404,390,632,0.617,307,334,0.919,17,296,313,235,34,67,156,99,1366,4.7,2.1,6.8,2022
Jalen Duren,C,19,67,1670,258,398,0.648,0,2,0.0,258,396,0.652,96,157,0.611,229,366,595,75,44,59,92,182,612,2.9,1.6,4.5,2022
Tari Eason,PF,21,82,1767,296,660,0.448,59,172,0.343,237,488,0.486,109,145,0.752,195,301,496,88,96,47,101,189,760,0.9,1.7,2.6,2022
Anthony Edwards,SG,21,79,2842,707,1541,0.459,213,578,0.369,494,963,0.513,319,422,0.756,47,411,458,350,125,58,259,186,1946,0.2,3.6,3.8,2022
Kessler Edwards,SF,22,36,385,36,93,0.387,17,55,0.309,19,38,0.5,11,15,0.733,23,38,61,23,14,6,13,40,100,0.1,0.3,0.4,2022
Keon Ellis,SG,23,16,71,7,16,0.438,6,12,0.5,1,4,0.25,4,7,0.571,4,4,8,6,5,1,1,10,24,0.2,0.1,0.2,2022
Joel Embiid,C,28,66,2284,728,1328,0.548,66,200,0.33,662,1128,0.587,661,771,0.857,113,557,670,274,66,112,226,205,2183,8.4,3.9,12.3,2022
Drew Eubanks,C,25,78,1584,214,334,0.641,7,18,0.389,207,316,0.655,83,125,0.664,132,286,418,103,40,102,67,169,518,2.9,1.6,4.4,2022
Bruno Fernando,C,24,39,405,59,112,0.527,0,4,0.0,59,108,0.546,35,50,0.7,54,83,137,31,6,34,25,74,153,0.5,0.4,0.9,2022
Dorian Finney-Smith,PF,29,66,2009,196,501,0.391,114,338,0.337,82,163,0.503,45,59,0.763,114,202,316,100,55,36,62,144,551,0.6,1.6,2.1,2022
Malachi Flynn,PG,24,53,691,87,242,0.36,47,133,0.353,40,109,0.367,25,33,0.758,15,61,76,70,21,4,25,65,246,0.0,0.5,0.5,2022
Simone Fontecchio,SF,27,52,766,115,312,0.369,63,191,0.33,52,121,0.43,35,44,0.795,31,55,86,42,15,8,39,62,328,-0.4,0.3,-0.1,2022
Bryn Forbes,SG,29,25,268,30,83,0.361,14,46,0.304,16,37,0.432,15,15,1.0,4,11,15,17,7,2,12,22,89,-0.2,0.2,0.0,2022
Trent Forrest,SG,24,23,277,25,60,0.417,0,2,0.0,25,58,0.431,2,3,0.667,5,32,37,38,7,2,15,17,52,-0.2,0.2,-0.1,2022
Michael Foster Jr.,PF,20,1,1,0,0,0.0,0,0,0.0,0,0,0.0,0,0,0.0,0,0,0,0,0,0,0,0,0,0.0,0.0,0.0,2022
Evan Fournier,SG,30,27,459,56,166,0.337,35,114,0.307,21,52,0.404,18,21,0.857,4,45,49,36,16,3,22,46,165,-0.3,0.4,0.1,2022
De'Aaron Fox,PG,25,73,2435,682,1331,0.512,119,367,0.324,563,964,0.584,343,440,0.78,40,266,306,447,83,23,181,172,1826,5.5,1.8,7.4,2022
Markelle Fultz,PG,24,60,1778,349,679,0.514,27,87,0.31,322,592,0.544,112,143,0.783,69,165,234,341,87,26,139,131,837,1.7,2.0,3.7,2022
Wenyen Gabriel,C,25,68,1024,155,260,0.596,10,36,0.278,145,224,0.647,52,84,0.619,116,170,286,36,26,35,46,144,372,1.5,1.3,2.8,2022
Daniel Gafford,C,24,78,1604,289,395,0.732,0,0,0.0,289,395,0.732,127,187,0.679,163,270,433,84,33,99,85,187,705,4.2,1.9,6.1,2022
Darius Garland,PG,23,69,2447,522,1129,0.462,169,412,0.41,353,717,0.492,277,321,0.863,28,157,185,538,85,9,199,148,1490,4.5,3.0,7.6,2022
Usman Garuba,C,20,75,970,86,177,0.486,24,59,0.407,62,118,0.525,29,47,0.617,120,187,307,64,44,29,47,135,225,0.9,0.9,1.8,2022
Luka Garza,C,24,28,243,63,116,0.543,14,39,0.359,49,77,0.636,41,52,0.788,33,30,63,18,3,2,14,43,181,0.9,0.2,1.1,2022
Rudy Gay,PF,36,56,816,109,287,0.38,33,130,0.254,76,157,0.484,42,49,0.857,33,130,163,57,19,18,37,68,293,-0.4,0.7,0.3,2022
Paul George,SF,32,56,1939,459,1004,0.457,158,426,0.371,301,578,0.521,256,294,0.871,45,297,342,288,83,20,176,159,1332,2.3,2.3,4.6,2022
Taj Gibson,C,37,49,480,65,125,0.52,8,24,0.333,57,101,0.564,30,42,0.714,32,61,93,34,15,12,26,84,168,0.4,0.5,0.8,2022
Josh Giddey,PF,20,76,2367,539,1118,0.482,76,234,0.325,463,884,0.524,106,145,0.731,148,451,599,469,57,31,211,143,1260,1.3,2.7,4.0,2022
Shai Gilgeous-Alexander,PG,24,68,2416,704,1381,0.51,58,168,0.345,646,1213,0.533,669,739,0.905,59,270,329,371,112,65,192,192,2135,8.4,3.0,11.4,2022
Anthony Gill,PF,30,59,624,71,132,0.538,4,29,0.138,67,103,0.65,49,67,0.731,37,62,99,34,7,12,15,70,195,1.0,0.4,1.3,2022
Jacob Gilyard,PG,24,1,41,1,3,0.333,1,3,0.333,0,0,0.0,0,0,0.0,0,4,4,7,3,0,2,3,3,0.0,0.1,0.1,2022
Rudy Gobert,C,30,70,2148,360,546,0.659,0,3,0.0,360,543,0.663,219,340,0.644,231,583,814,87,56,95,122,210,939,4.3,3.5,7.8,2022
Jordan Goodwin,PG,24,62,1106,158,353,0.448,38,118,0.322,120,235,0.511,53,69,0.768,57,148,205,168,58,26,57,95,407,0.9,1.3,2.2,2022
Aaron Gordon,PF,27,68,2055,429,761,0.564,60,173,0.347,369,588,0.628,191,314,0.608,164,282,446,203,54,51,98,129,1109,4.6,2.2,6.8,2022
Eric Gordon,SG,34,69,1965,291,653,0.446,132,356,0.371,159,297,0.535,142,173,0.821,16,118,134,183,43,25,104,78,856,1.8,0.5,2.3,2022
Devonte' Graham,PG,27,73,1338,161,431,0.374,119,338,0.352,42,93,0.452,98,131,0.748,19,103,122,196,45,16,53,79,539,1.5,1.0,2.5,2022
Jerami Grant,PF,28,63,2246,434,913,0.475,144,359,0.401,290,554,0.523,278,342,0.813,53,230,283,150,51,53,116,152,1290,3.1,1.0,4.1,2022
RaiQuan Gray,PF,23,1,35,6,12,0.5,2,5,0.4,4,7,0.571,2,2,1.0,3,6,9,7,0,1,4,5,16,0.0,0.0,0.1,2022
A.J. Green,SG,23,35,345,53,125,0.424,44,105,0.419,9,20,0.45,4,4,1.0,6,39,45,22,6,0,9,31,154,0.5,0.3,0.8,2022
Danny Green,SG,35,11,138,22,49,0.449,16,37,0.432,6,12,0.5,1,1,1.0,3,11,14,6,6,3,10,16,61,0.0,0.2,0.2,2022
Draymond Green,PF,32,73,2297,250,474,0.527,40,131,0.305,210,343,0.612,77,108,0.713,66,459,525,500,74,60,204,229,617,1.6,3.1,4.7,2022
Jalen Green,SG,20,76,2602,566,1359,0.416,187,554,0.338,379,805,0.471,364,463,0.786,43,241,284,281,59,18,200,131,1683,1.4,0.5,1.8,2022
JaMychal Green,PF,32,57,797,136,252,0.54,42,111,0.378,94,141,0.667,52,67,0.776,72,133,205,51,25,23,52,105,366,1.2,1.0,2.2,2022
Javonte Green,SF,29,32,480,61,108,0.565,13,35,0.371,48,73,0.658,30,45,0.667,27,61,88,23,24,21,20,52,165,0.6,0.8,1.4,2022
Jeff Green,PF,36,56,1091,160,328,0.488,30,104,0.288,130,224,0.58,87,117,0.744,38,106,144,69,18,17,46,99,437,0.8,0.8,1.7,2022
Josh Green,SG,22,60,1539,205,382,0.537,68,169,0.402,137,213,0.643,68,94,0.723,55,127,182,103,42,5,72,156,546,1.7,0.9,2.6,2022
AJ Griffin,SF,19,72,1401,248,533,0.465,101,259,0.39,147,274,0.536,42,47,0.894,37,116,153,73,42,12,42,87,639,1.3,0.9,2.2,2022
Blake Griffin,C,33,41,569,63,130,0.485,23,66,0.348,40,64,0.625,21,32,0.656,47,108,155,61,14,9,22,75,170,1.0,0.8,1.8,2022
Quentin Grimes,SG,22,71,2121,282,602,0.468,157,407,0.386,125,195,0.641,78,98,0.796,49,180,229,150,47,26,69,177,799,3.2,1.6,4.8,2022
Rui Hachimura,PF,24,63,1466,284,584,0.486,51,160,0.319,233,424,0.55,88,119,0.739,53,230,283,58,19,26,53,72,707,0.6,1.3,1.8,2022
Tyrese Haliburton,PG,22,56,1883,412,841,0.49,161,402,0.4,251,439,0.572,175,201,0.871,33,172,205,585,91,25,141,69,1160,6.4,1.2,7.6,2022
Jordan Hall,SF,21,9,83,9,28,0.321,3,15,0.2,6,13,0.462,7,9,0.778,3,9,12,11,1,0,7,6,28,-0.1,0.0,-0.1,2022
R.J. Hampton,SG,21,47,750,102,237,0.43,41,116,0.353,61,121,0.504,57,76,0.75,18,69,87,54,27,9,42,51,302,0.1,0.5,0.7,2022
Tim Hardaway Jr.,SF,30,71,2152,340,847,0.401,212,550,0.385,128,297,0.431,127,165,0.77,21,230,251,129,49,12,60,120,1019,1.0,1.3,2.3,2022
James Harden,PG,33,58,2135,371,842,0.441,161,418,0.385,210,424,0.495,313,361,0.867,40,314,354,618,71,31,195,112,1216,5.8,2.6,8.4,2022
Jaden Hardy,SG,20,48,708,146,333,0.438,63,156,0.404,83,177,0.469,65,79,0.823,11,78,89,65,17,7,46,64,420,0.2,0.5,0.7,2022
Ron Harper Jr.,PF,22,9,48,8,16,0.5,3,9,0.333,5,7,0.714,1,1,1.0,3,4,7,4,0,1,0,3,20,0.1,0.0,0.2,2022
Montrezl Harrell,C,29,57,681,125,209,0.598,0,6,0.0,125,203,0.616,70,101,0.693,67,92,159,33,17,25,35,75,320,1.3,0.8,2.2,2022
Gary Harris,SG,28,48,1184,138,307,0.45,94,218,0.431,44,89,0.494,27,30,0.9,21,77,98,59,45,12,28,93,397,1.3,1.1,2.3,2022
Joe Harris,SF,31,74,1527,201,440,0.457,142,333,0.426,59,107,0.551,18,28,0.643,23,141,164,101,34,13,41,140,562,1.5,1.1,2.6,2022
Kevon Harris,SG,25,34,457,47,107,0.439,16,43,0.372,31,64,0.484,31,41,0.756,28,42,70,16,17,5,21,53,141,0.2,0.4,0.6,2022
Tobias Harris,SF,30,74,2436,423,845,0.501,126,324,0.389,297,521,0.57,113,129,0.876,67,357,424,186,68,40,89,149,1085,3.1,2.8,5.9,2022
Shaquille Harrison,SG,29,5,120,15,36,0.417,3,10,0.3,12,26,0.462,11,15,0.733,1,21,22,30,11,2,6,12,44,0.2,0.2,0.3,2022
Josh Hart,SF,27,76,2454,275,520,0.529,61,164,0.372,214,356,0.601,132,176,0.75,142,451,593,290,88,21,117,195,743,3.8,2.2,6.0,2022
Isaiah Hartenstein,C,24,82,1626,175,327,0.535,8,37,0.216,167,290,0.576,48,71,0.676,209,327,536,102,53,64,66,213,406,2.2,2.4,4.6,2022
Udonis Haslem,C,42,7,71,10,29,0.345,3,9,0.333,7,20,0.35,4,5,0.8,4,7,11,0,1,2,1,11,27,-0.1,0.1,0.0,2022
Sam Hauser,SF,25,80,1290,180,396,0.455,140,335,0.418,40,61,0.656,12,17,0.706,35,169,204,71,29,21,30,99,512,1.8,1.6,3.4,2022
Jaxson Hayes,C,22,47,610,86,156,0.551,3,29,0.103,83,127,0.654,58,83,0.699,39,93,132,34,20,19,31,67,233,0.6,0.9,1.5,2022
Killian Hayes,PG,21,76,2154,307,815,0.377,80,286,0.28,227,529,0.429,92,112,0.821,28,193,221,470,104,28,173,219,786,-1.9,1.4,-0.5,2022
Gordon Hayward,SF,32,50,1577,276,581,0.475,52,160,0.325,224,421,0.532,129,159,0.811,33,182,215,206,42,12,99,70,733,0.8,1.1,2.0,2022
Juancho Hernangómez,PF,27,42,614,48,114,0.421,17,67,0.254,31,47,0.66,9,16,0.563,27,96,123,25,16,6,15,43,122,0.1,0.6,0.7,2022
Willy Hernangómez,C,28,38,458,89,169,0.527,3,11,0.273,86,158,0.544,81,104,0.779,58,122,180,33,17,13,39,64,262,0.8,0.8,1.6,2022
Tyler Herro,SG,23,67,2337,487,1109,0.439,203,537,0.378,284,572,0.497,170,182,0.934,27,333,360,280,51,16,158,101,1347,1.1,2.4,3.5,2022
Buddy Hield,SF,30,80,2482,475,1038,0.458,288,677,0.425,187,361,0.518,106,129,0.822,67,333,400,225,92,26,139,156,1344,2.7,1.6,4.4,2022
Haywood Highsmith,PF,26,54,969,93,216,0.431,37,109,0.339,56,107,0.523,13,28,0.464,57,131,188,43,36,17,45,82,236,-0.3,1.3,0.9,2022
George Hill,PG,36,46,834,78,166,0.47,34,95,0.358,44,71,0.62,42,55,0.764,15,70,85,110,26,6,34,55,232,1.1,0.8,1.9,2022
Malcolm Hill,SF,27,5,9,2,4,0.5,1,3,0.333,1,1,1.0,0,0,0.0,0,3,3,0,0,0,0,1,5,0.0,0.0,0.0,2022
Aaron Holiday,PG,26,63,845,92,220,0.418,36,88,0.409,56,132,0.424,27,32,0.844,25,49,74,89,37,12,36,79,247,0.3,0.6,0.9,2022
Jrue Holiday,PG,32,67,2183,490,1023,0.479,158,411,0.384,332,612,0.542,152,177,0.859,79,262,341,495,79,25,197,116,1290,3.9,2.8,6.7,2022
Justin Holiday,SF,33,46,706,77,204,0.377,46,143,0.322,31,61,0.508,5,8,0.625,5,50,55,41,19,19,22,68,205,-0.4,0.5,0.1,2022
Richaun Holmes,C,29,42,348,55,89,0.618,5,8,0.625,50,81,0.617,15,19,0.789,29,51,80,9,3,11,14,50,130,0.6,0.3,0.8,2022
Al Horford,C,36,63,1922,228,479,0.476,145,325,0.446,83,154,0.539,15,21,0.714,73,317,390,189,30,61,37,121,616,3.6,2.7,6.3,2022
Talen Horton-Tucker,SG,22,65,1313,257,613,0.419,58,203,0.286,199,410,0.485,126,168,0.75,41,169,210,246,41,29,126,108,698,-0.3,1.1,0.8,2022
Danuel House Jr.,SF,29,56,807,93,197,0.472,37,110,0.336,56,87,0.644,45,60,0.75,9,85,94,44,14,9,26,69,268,0.6,0.7,1.3,2022
Caleb Houstan,SF,20,51,812,66,182,0.363,46,136,0.338,20,46,0.435,15,18,0.833,34,65,99,30,12,7,18,63,193,0.1,0.5,0.7,2022
Trevor Hudgins,PG,23,5,28,2,9,0.222,2,8,0.25,0,1,0.0,3,3,1.0,0,0,0,3,0,0,1,1,9,0.0,0.0,0.0,2022
Kevin Huerter,SG,24,75,2203,420,866,0.485,205,510,0.402,215,356,0.604,95,131,0.725,42,209,251,221,80,24,97,181,1140,3.3,1.7,4.9,2022
Jay Huff,C,24,7,95,15,25,0.6,6,12,0.5,9,13,0.692,15,16,0.938,6,15,21,10,3,4,5,15,51,0.4,0.1,0.5,2022
De'Andre Hunter,SF,25,67,2126,379,822,0.461,100,286,0.35,279,536,0.521,171,207,0.826,46,238,284,94,35,17,82,199,1029,1.4,1.2,2.5,2022
Bones Hyland,PG,22,56,1085,228,571,0.399,117,315,0.371,111,256,0.434,86,102,0.843,20,115,135,172,39,15,82,96,659,0.3,1.1,1.4,2022
Serge Ibaka,C,33,16,185,26,54,0.481,6,18,0.333,20,36,0.556,8,13,0.615,15,29,44,4,2,7,11,23,66,0.0,0.2,0.2,2022
Andre Iguodala,PF,39,8,113,7,15,0.467,1,9,0.111,6,6,1.0,2,3,0.667,3,14,17,19,4,3,9,11,17,0.0,0.1,0.1,2022
Joe Ingles,SF,35,46,1044,108,248,0.435,83,203,0.409,25,45,0.556,18,21,0.857,13,115,128,150,33,6,55,74,317,1.1,1.2,2.3,2022
Brandon Ingram,SF,25,45,1538,404,835,0.484,64,164,0.39,340,671,0.507,240,272,0.882,23,223,246,262,32,19,148,116,1112,1.8,1.7,3.5,2022
Kyrie Irving,PG,30,60,2241,594,1203,0.494,188,496,0.379,406,707,0.574,247,273,0.905,59,245,304,331,66,45,128,165,1623,5.4,2.0,7.4,2022
Jonathan Isaac,PF,25,11,124,22,53,0.415,6,15,0.4,16,38,0.421,5,9,0.556,15,29,44,6,14,4,4,5,55,0.0,0.3,0.3,2022
Jaden Ivey,SG,20,74,2304,409,983,0.416,120,350,0.343,289,633,0.457,266,356,0.747,73,215,288,387,61,17,237,242,1204,-0.9,0.8,0.0,2022
Frank Jackson,PG,24,1,5,0,3,0.0,0,1,0.0,0,2,0.0,0,0,0.0,1,1,2,1,0,0,0,0,0,0.0,0.0,0.0,2022
Isaiah Jackson,C,21,63,1042,179,318,0.563,2,14,0.143,177,304,0.582,95,146,0.651,113,169,282,51,31,93,51,154,455,1.5,1.2,2.7,2022
Jaren Jackson Jr.,C,23,63,1787,416,822,0.506,100,282,0.355,316,540,0.585,241,306,0.788,108,318,426,60,65,189,107,227,1173,2.8,3.8,6.6,2022
Justin Jackson,SF,27,23,107,7,27,0.259,5,20,0.25,2,7,0.286,1,2,0.5,2,15,17,9,4,4,2,7,20,-0.1,0.2,0.1,2022
Quenton Jackson,PG,24,9,135,19,42,0.452,1,12,0.083,18,30,0.6,17,22,0.773,2,6,8,15,4,1,4,10,56,0.1,0.1,0.2,2022
Reggie Jackson,PG,32,68,1657,263,640,0.411,96,288,0.333,167,352,0.474,71,78,0.91,25,119,144,233,47,6,115,114,693,-0.6,1.2,0.6,2022
LeBron James,PF,38,55,1954,609,1219,0.5,121,377,0.321,488,842,0.58,251,327,0.768,65,392,457,375,50,32,178,88,1590,3.2,2.4,5.6,2022
Ty Jerome,SG,25,45,816,118,242,0.488,35,90,0.389,83,152,0.546,38,41,0.927,7,71,78,135,23,5,30,64,309,1.4,0.7,2.1,2022
Isaiah Joe,SG,23,73,1395,224,508,0.441,161,394,0.409,63,114,0.553,82,100,0.82,27,148,175,88,48,8,39,105,691,2.5,1.3,3.8,2022
Alize Johnson,PF,26,4,30,3,6,0.5,0,2,0.0,3,4,0.75,1,2,0.5,2,8,10,1,1,0,4,3,7,-0.1,0.0,-0.1,2022
Cameron Johnson,PF,26,42,1199,223,474,0.47,103,255,0.404,120,219,0.548,101,120,0.842,34,151,185,78,50,14,37,83,650,2.1,1.4,3.5,2022
Jalen Johnson,SF,21,70,1042,158,322,0.491,30,104,0.288,128,218,0.587,49,78,0.628,51,231,282,83,38,34,41,113,395,0.8,1.3,2.1,2022
James Johnson,PF,35,18,162,22,49,0.449,3,15,0.2,19,34,0.559,4,8,0.5,4,26,30,15,7,6,8,32,51,-0.1,0.2,0.1,2022
Keldon Johnson,SF,23,63,2063,503,1113,0.452,134,407,0.329,369,706,0.523,245,327,0.749,56,262,318,183,46,11,134,125,1385,0.7,0.5,1.3,2022
Keon Johnson,SG,20,40,416,67,178,0.376,28,81,0.346,39,97,0.402,27,41,0.659,11,33,44,59,19,6,43,43,189,-0.7,0.2,-0.5,2022
Stanley Johnson,SF,26,30,469,65,122,0.533,18,40,0.45,47,82,0.573,26,39,0.667,22,73,95,67,16,6,33,48,174,0.5,0.3,0.7,2022
Nikola Jokić,C,27,69,2323,646,1022,0.632,57,149,0.383,589,873,0.675,341,415,0.822,167,650,817,678,87,47,247,174,1690,11.2,3.8,14.9,2022
Carlik Jones,PG,25,7,56,6,15,0.4,3,6,0.5,3,9,0.333,5,8,0.625,1,4,5,6,2,0,2,2,20,0.0,0.1,0.1,2022
Damian Jones,C,27,41,477,55,86,0.64,10,17,0.588,45,69,0.652,22,29,0.759,42,80,122,15,8,21,23,55,142,0.7,0.5,1.2,2022
Derrick Jones Jr.,PF,25,64,893,115,230,0.5,27,80,0.338,88,150,0.587,62,84,0.738,60,93,153,34,29,37,25,86,319,1.2,1.2,2.4,2022
Herbert Jones,PF,24,66,1951,235,501,0.469,56,167,0.335,179,334,0.536,123,161,0.764,97,172,269,162,103,42,88,208,649,1.5,2.7,4.2,2022
Kai Jones,C,22,46,550,67,120,0.558,4,19,0.211,63,101,0.624,19,26,0.731,37,86,123,15,17,30,31,65,157,0.0,0.7,0.7,2022
Tre Jones,PG,23,68,1984,341,743,0.459,45,158,0.285,296,585,0.506,148,172,0.86,56,189,245,448,89,9,110,98,875,2.6,0.8,3.4,2022
Tyus Jones,PG,26,80,1940,311,710,0.438,121,326,0.371,190,384,0.495,80,100,0.8,28,172,200,417,83,6,74,32,823,3.4,2.3,5.7,2022
DeAndre Jordan,C,34,39,586,88,115,0.765,1,1,1.0,87,114,0.763,22,48,0.458,52,150,202,34,12,23,48,71,199,0.5,0.9,1.4,2022
Cory Joseph,PG,31,62,1227,150,351,0.427,70,180,0.389,80,171,0.468,57,72,0.792,21,85,106,217,34,9,56,88,427,1.5,0.3,1.8,2022
Nikola Jović,PF,19,15,204,28,69,0.406,8,35,0.229,20,34,0.588,18,19,0.947,9,22,31,10,7,2,10,19,82,0.0,0.2,0.2,2022
Johnny Juzang,SG,21,18,232,35,104,0.337,15,63,0.238,20,41,0.488,2,4,0.5,8,31,39,8,4,3,3,13,87,-0.3,0.1,-0.2,2022
Mfiondu Kabengele,PF,25,4,36,2,7,0.286,0,3,0.0,2,4,0.5,2,2,1.0,5,5,10,0,2,0,1,3,6,0.0,0.1,0.1,2022
Frank Kaminsky,C,29,36,235,31,63,0.492,13,33,0.394,18,30,0.6,14,16,0.875,7,45,52,32,6,4,9,22,89,0.5,0.2,0.7,2022
Trevor Keels,SG,19,3,8,1,4,0.25,1,4,0.25,0,0,0.0,0,0,0.0,0,2,2,0,0,0,0,0,3,0.0,0.0,0.0,2022
Luke Kennard,SG,26,59,1315,188,382,0.492,133,269,0.494,55,113,0.487,37,39,0.949,15,143,158,91,32,5,46,82,546,2.2,1.2,3.4,2022
Walker Kessler,C,21,74,1703,298,414,0.72,1,3,0.333,297,411,0.723,82,159,0.516,231,389,620,69,26,173,58,169,679,4.6,2.5,7.1,2022
Braxton Key,SF,25,3,9,1,1,1.0,0,0,0.0,1,1,1.0,2,2,1.0,0,1,1,0,0,0,0,0,4,0.0,0.0,0.0,2022
Louis King,PF,23,1,29,8,13,0.615,4,8,0.5,4,5,0.8,0,1,0.0,2,2,4,2,1,0,2,4,20,0.1,0.0,0.1,2022
Corey Kispert,SF,23,74,2093,291,585,0.497,163,384,0.424,128,201,0.637,75,88,0.852,33,174,207,87,32,9,55,97,820,2.9,0.9,3.8,2022
Maxi Kleber,PF,31,37,930,77,169,0.456,39,112,0.348,38,57,0.667,27,38,0.711,30,105,135,52,12,30,27,85,220,0.7,0.6,1.3,2022
Nathan Knight,C,25,38,291,46,81,0.568,8,22,0.364,38,59,0.644,39,57,0.684,22,34,56,13,10,6,21,41,139,0.4,0.3,0.7,2022
Kevin Knox,SF,23,63,952,152,332,0.458,65,186,0.349,87,146,0.596,46,60,0.767,34,143,177,33,24,12,50,95,415,0.2,0.5,0.7,2022
Christian Koloko,C,22,58,802,72,150,0.48,1,12,0.083,71,138,0.514,37,59,0.627,84,87,171,31,21,57,20,128,182,0.7,1.0,1.7,2022
John Konchar,SF,26,72,1494,138,320,0.431,60,177,0.339,78,143,0.545,28,36,0.778,64,246,310,100,77,25,37,112,364,1.0,2.5,3.5,2022
Furkan Korkmaz,SG,25,37,353,48,111,0.432,18,46,0.391,30,65,0.462,26,36,0.722,6,36,42,22,10,3,24,18,140,-0.2,0.3,0.1,2022
Luke Kornet,C,27,69,804,113,170,0.665,3,13,0.231,110,157,0.701,32,39,0.821,86,111,197,53,11,46,25,81,261,2.1,1.2,3.3,2022
Vit Krejci,PG,22,29,165,15,37,0.405,5,21,0.238,10,16,0.625,1,2,0.5,6,20,26,17,5,1,5,17,36,0.0,0.1,0.1,2022
Jonathan Kuminga,PF,20,67,1394,261,497,0.525,54,146,0.37,207,351,0.59,90,138,0.652,70,161,231,125,41,31,95,157,666,1.0,1.4,2.4,2022
Kyle Kuzma,PF,27,64,2239,512,1142,0.448,160,481,0.333,352,661,0.533,173,237,0.73,55,408,463,239,36,29,190,145,1357,-1.0,1.9,0.9,2022
Anthony Lamb,SF,25,62,1195,148,314,0.471,73,199,0.367,75,115,0.652,46,60,0.767,56,159,215,96,28,20,54,134,415,1.2,1.2,2.4,2022
Jock Landale,C,27,69,979,178,337,0.528,21,84,0.25,157,253,0.621,79,105,0.752,119,161,280,68,16,30,59,126,456,1.5,1.2,2.7,2022
Romeo Langford,SG,23,43,844,121,259,0.467,16,61,0.262,105,198,0.53,39,56,0.696,57,57,114,50,24,13,30,67,297,0.3,0.2,0.5,2022
Jake LaRavia,PF,21,35,414,37,95,0.389,24,71,0.338,13,24,0.542,7,9,0.778,19,44,63,21,12,4,18,49,105,0.0,0.5,0.5,2022
Zach LaVine,SG,27,77,2768,673,1388,0.485,204,544,0.375,469,844,0.556,363,428,0.848,42,303,345,327,69,18,194,159,1913,4.2,2.9,7.1,2022
A.J. Lawson,SG,22,15,108,22,44,0.5,10,25,0.4,12,19,0.632,2,8,0.25,6,15,21,2,2,0,3,11,56,0.1,0.1,0.1,2022
Damion Lee,SG,30,74,1506,200,452,0.442,110,247,0.445,90,205,0.439,94,104,0.904,39,186,225,99,30,7,78,118,604,1.1,1.4,2.6,2022
Saben Lee,PG,23,25,373,49,121,0.405,11,30,0.367,38,91,0.418,42,57,0.737,13,32,45,67,19,1,24,32,151,0.2,0.4,0.7,2022
Alex Len,C,29,26,161,16,30,0.533,0,2,0.0,16,28,0.571,11,16,0.688,24,36,60,12,4,11,16,28,43,0.1,0.2,0.3,2022
Kawhi Leonard,SF,31,52,1748,446,871,0.512,104,250,0.416,342,621,0.551,243,279,0.871,57,281,338,204,72,28,88,84,1239,4.9,2.2,7.1,2022
Meyers Leonard,C,30,9,114,14,29,0.483,7,18,0.389,7,11,0.636,8,9,0.889,12,22,34,1,2,0,6,16,43,0.2,0.1,0.3,2022
Caris LeVert,SG,28,74,2237,320,742,0.431,127,324,0.392,193,418,0.462,130,180,0.722,53,229,282,287,72,24,116,170,897,1.4,3.1,4.4,2022
Kira Lewis Jr.,PG,21,25,235,40,88,0.455,15,34,0.441,25,54,0.463,19,22,0.864,5,28,33,23,10,2,10,24,114,0.3,0.3,0.6,2022
Damian Lillard,PG,32,58,2107,556,1202,0.463,244,658,0.371,312,544,0.574,510,558,0.914,44,233,277,425,50,18,191,109,1866,8.2,0.8,9.0,2022
Nassir Little,SF,22,54,976,134,303,0.442,58,158,0.367,76,145,0.524,33,46,0.717,27,114,141,50,20,20,36,66,359,0.2,0.4,0.7,2022
Isaiah Livers,PF,24,52,1199,120,288,0.417,74,203,0.365,46,85,0.541,32,39,0.821,28,115,143,41,28,28,30,103,346,0.5,0.5,1.0,2022
Kenneth Lofton Jr.,PF,20,24,176,49,93,0.527,6,17,0.353,43,76,0.566,16,27,0.593,19,32,51,20,5,2,12,28,120,0.3,0.2,0.5,2022
Kevon Looney,C,26,82,1958,242,384,0.63,0,1,0.0,242,383,0.632,94,155,0.606,274,486,760,207,52,50,45,225,578,5.9,2.8,8.7,2022
Brook Lopez,C,34,78,2373,477,899,0.531,136,364,0.374,341,535,0.637,149,190,0.784,157,363,520,99,37,193,107,203,1239,4.1,3.9,8.0,2022
Robin Lopez,C,34,37,299,48,75,0.64,2,4,0.5,46,71,0.648,14,18,0.778,23,28,51,19,2,8,25,43,112,0.2,0.3,0.6,2022
Kevin Love,PF,34,62,1240,165,424,0.389,99,296,0.334,66,128,0.516,80,91,0.879,59,340,399,116,16,12,70,97,509,0.6,2.0,2.6,2022
Kyle Lowry,PG,36,55,1718,196,485,0.404,107,310,0.345,89,175,0.509,116,135,0.859,43,182,225,281,57,21,103,143,615,1.5,1.9,3.4,2022
Trey Lyles,PF,27,74,1247,187,408,0.458,87,240,0.363,100,168,0.595,101,124,0.815,68,232,300,66,27,31,64,97,562,1.4,1.2,2.6,2022
Théo Maledon,PG,21,44,854,102,254,0.402,28,95,0.295,74,159,0.465,63,74,0.851,14,109,123,152,37,12,59,61,295,0.0,0.9,0.8,2022
Sandro Mamukelashvili,C,23,43,660,97,230,0.422,30,99,0.303,67,131,0.511,39,57,0.684,70,115,185,62,14,12,35,52,263,0.4,0.5,0.9,2022
Terance Mann,SG,26,81,1872,272,524,0.519,77,198,0.389,195,326,0.598,92,118,0.78,77,199,276,184,42,22,80,149,713,2.8,1.5,4.3,2022
Tre Mann,PG,21,67,1183,197,501,0.393,81,257,0.315,116,244,0.475,42,55,0.764,27,128,155,120,40,11,62,99,517,-0.6,1.1,0.5,2022
Boban Marjanović,C,34,31,171,41,60,0.683,0,1,0.0,41,59,0.695,20,27,0.741,20,40,60,9,5,2,14,10,102,0.4,0.1,0.6,2022
Lauri Markkanen,PF,25,66,2273,571,1145,0.499,200,511,0.391,371,634,0.585,349,399,0.875,130,440,570,123,42,38,127,137,1691,6.3,1.9,8.2,2022
Naji Marshall,SF,25,77,1792,247,571,0.433,66,218,0.303,181,353,0.513,138,175,0.789,48,231,279,189,54,14,97,113,698,0.5,2.0,2.5,2022
Caleb Martin,SF,27,71,2077,254,548,0.464,84,236,0.356,170,312,0.545,91,113,0.805,88,256,344,117,71,31,78,145,683,1.2,2.5,3.7,2022
Cody Martin,SF,27,7,134,14,36,0.389,3,14,0.214,11,22,0.5,4,7,0.571,8,16,24,11,4,1,2,13,35,0.0,0.1,0.1,2022
KJ Martin,SF,22,82,2292,410,720,0.569,68,216,0.315,342,504,0.679,151,222,0.68,126,326,452,123,41,30,91,147,1039,4.2,0.7,4.9,2022
Tyrese Martin,SG,23,16,66,9,23,0.391,1,7,0.143,8,16,0.5,2,2,1.0,5,7,12,2,1,0,2,2,21,0.0,0.0,0.0,2022
Garrison Mathews,SG,26,54,686,73,201,0.363,63,180,0.35,10,21,0.476,48,53,0.906,11,62,73,26,24,5,19,62,257,0.7,0.3,1.0,2022
Bennedict Mathurin,SG,20,78,2222,413,951,0.434,100,310,0.323,313,641,0.488,376,454,0.828,87,231,318,116,48,13,152,162,1302,1.0,0.8,1.8,2022
Wesley Matthews,SF,36,52,820,58,160,0.363,39,124,0.315,19,36,0.528,24,28,0.857,34,79,113,34,20,13,18,71,179,0.3,0.9,1.2,2022
Tyrese Maxey,SG,22,60,2016,439,913,0.481,160,369,0.434,279,544,0.513,180,213,0.845,23,153,176,212,49,8,80,132,1218,3.7,1.6,5.4,2022
Skylar Mays,PG,25,6,189,34,68,0.5,12,26,0.462,22,42,0.524,12,13,0.923,2,17,19,50,6,1,10,11,92,0.6,0.1,0.7,2022
Miles McBride,PG,22,64,760,77,215,0.358,40,134,0.299,37,81,0.457,28,42,0.667,13,37,50,72,37,8,25,60,222,0.0,0.7,0.7,2022
Mac McClung,SG,24,2,41,9,20,0.45,4,11,0.364,5,9,0.556,3,5,0.6,3,7,10,9,0,0,3,3,25,0.1,0.0,0.1,2022
CJ McCollum,PG,31,75,2649,587,1344,0.437,211,543,0.389,376,801,0.469,183,238,0.769,55,273,328,429,70,38,183,153,1568,1.5,2.8,4.3,2022
T.J. McConnell,PG,30,75,1526,283,521,0.543,26,59,0.441,257,462,0.556,58,68,0.853,45,189,234,397,81,10,143,105,650,1.9,1.2,3.1,2022
Jaden McDaniels,SF,22,79,2416,370,716,0.517,107,269,0.398,263,447,0.588,106,144,0.736,92,215,307,148,74,76,112,272,953,2.0,2.4,4.4,2022
Jalen McDaniels,SF,25,80,1913,281,617,0.455,77,232,0.332,204,385,0.53,116,138,0.841,63,283,346,130,83,34,93,209,755,0.5,2.2,2.7,2022
Doug McDermott,SF,31,64,1314,239,523,0.457,123,298,0.413,116,225,0.516,53,70,0.757,24,115,139,91,13,6,58,118,654,1.0,0.0,1.0,2022
JaVale McGee,C,35,42,355,80,125,0.64,2,5,0.4,78,120,0.65,24,41,0.585,30,77,107,11,4,26,36,54,186,0.1,0.5,0.6,2022
Bryce McGowens,SG,20,46,787,80,202,0.396,26,80,0.325,54,122,0.443,60,80,0.75,20,73,93,54,15,6,43,48,246,-0.4,0.4,0.1,2022
Rodney McGruder,SG,31,32,524,62,152,0.408,41,97,0.423,21,55,0.382,18,22,0.818,20,54,74,28,16,1,11,39,183,0.5,0.2,0.7,2022
Jordan McLaughlin,PG,26,43,678,61,145,0.421,24,78,0.308,37,67,0.552,15,18,0.833,15,47,62,148,32,4,33,28,161,0.7,0.6,1.3,2022
De'Anthony Melton,SG,24,77,2150,277,651,0.425,157,403,0.39,120,248,0.484,69,87,0.793,69,243,312,197,126,41,102,191,780,1.1,3.1,4.2,2022
Sam Merrill,SG,26,5,59,9,22,0.409,5,18,0.278,4,4,1.0,2,2,1.0,0,9,9,5,4,0,0,3,25,0.1,0.1,0.2,2022
Chimezie Metu,PF,25,66,689,129,219,0.589,9,38,0.237,120,181,0.663,54,73,0.74,47,151,198,40,22,21,32,81,321,1.2,0.8,2.1,2022
Khris Middleton,SF,31,33,801,177,406,0.436,51,162,0.315,126,244,0.516,92,102,0.902,28,112,140,163,23,5,71,68,497,1.0,1.0,1.9,2022
Patty Mills,PG,34,40,567,86,209,0.411,49,134,0.366,37,75,0.493,25,30,0.833,8,36,44,56,15,3,30,32,246,0.0,0.4,0.4,2022
Shake Milton,SG,26,76,1567,241,503,0.479,56,148,0.378,185,355,0.521,99,116,0.853,39,152,191,240,25,13,94,123,637,1.6,1.2,2.9,2022
Justin Minaya,SF,23,4,89,7,23,0.304,3,12,0.25,4,11,0.364,0,1,0.0,3,12,15,4,2,5,4,9,17,-0.2,0.1,-0.1,2022
Josh Minott,SF,20,15,96,18,36,0.5,2,6,0.333,16,30,0.533,8,8,1.0,5,20,25,5,4,6,3,10,46,0.1,0.2,0.3,2022
Davion Mitchell,PG,24,80,1447,181,399,0.454,63,197,0.32,118,202,0.584,25,31,0.806,16,89,105,185,44,15,62,112,450,0.7,0.8,1.5,2022
Donovan Mitchell,SG,26,68,2432,679,1402,0.484,245,635,0.386,434,767,0.566,319,368,0.867,63,226,289,301,99,27,180,168,1922,5.4,3.5,8.9,2022
Evan Mobley,PF,21,79,2715,525,947,0.554,22,102,0.216,503,845,0.595,205,304,0.674,187,524,711,224,60,119,146,218,1277,3.7,4.8,8.5,2022
Isaiah Mobley,PF,23,12,84,12,28,0.429,3,8,0.375,9,20,0.45,4,4,1.0,4,16,20,3,4,3,1,8,31,0.1,0.2,0.2,2022
Chima Moneke,SF,27,2,8,1,2,0.5,0,0,0.0,1,2,0.5,0,2,0.0,2,0,2,1,0,0,2,2,2,0.0,0.0,0.0,2022
Malik Monk,SG,24,77,1719,357,796,0.448,143,398,0.359,214,398,0.538,184,207,0.889,32,171,203,298,49,20,146,125,1041,2.1,1.2,3.2,2022
Moses Moody,SG,20,63,817,108,227,0.476,49,135,0.363,59,92,0.641,37,53,0.698,28,77,105,51,18,7,34,54,302,0.7,0.6,1.3,2022
Xavier Moon,SG,28,4,20,3,9,0.333,1,3,0.333,2,6,0.333,0,0,0.0,0,3,3,5,0,0,1,2,7,0.0,0.0,0.0,2022
Wendell Moore Jr.,SG,21,29,153,18,43,0.419,2,17,0.118,16,26,0.615,4,5,0.8,4,14,18,18,8,5,8,13,42,-0.1,0.2,0.1,2022
Ja Morant,PG,23,61,1948,566,1214,0.466,92,300,0.307,474,914,0.519,372,497,0.748,61,296,357,493,66,16,206,100,1596,3.4,2.6,6.0,2022
Marcus Morris,PF,33,65,1825,274,643,0.426,112,308,0.364,162,335,0.484,68,87,0.782,29,229,258,114,42,21,56,136,728,0.4,1.6,2.0,2022
Markieff Morris,PF,33,35,355,47,115,0.409,28,71,0.394,19,44,0.432,10,10,1.0,13,58,71,31,9,5,18,48,132,0.1,0.4,0.4,2022
Monte Morris,PG,27,62,1695,247,515,0.48,78,204,0.382,169,311,0.543,64,77,0.831,26,184,210,326,43,13,60,75,636,3.1,1.1,4.2,2022
Trey Murphy III,SF,22,79,2448,387,800,0.484,202,497,0.406,185,303,0.611,172,190,0.905,59,222,281,112,89,43,61,155,1148,4.8,2.8,7.6,2022
Dejounte Murray,SG,26,74,2693,612,1319,0.464,133,387,0.344,479,932,0.514,158,190,0.832,53,336,389,448,112,19,160,106,1515,2.4,2.3,4.7,2022
Jamal Murray,PG,25,65,2133,473,1041,0.454,172,432,0.398,301,609,0.494,180,216,0.833,48,209,257,400,66,16,145,103,1298,3.3,1.9,5.1,2022
Keegan Murray,SF,22,80,2382,354,782,0.453,206,501,0.411,148,281,0.527,62,81,0.765,89,282,371,98,61,42,60,162,976,2.6,1.7,4.3,2022
Mike Muscala,C,31,63,945,131,292,0.449,81,207,0.391,50,85,0.588,40,52,0.769,37,166,203,50,15,24,23,98,383,1.4,1.1,2.5,2022
Svi Mykhailiuk,SF,25,32,468,77,173,0.445,42,99,0.424,35,74,0.473,26,39,0.667,15,38,53,53,15,4,24,23,222,0.5,0.3,0.8,2022
Larry Nance Jr.,C,30,65,1381,186,305,0.61,14,42,0.333,172,263,0.654,55,79,0.696,106,248,354,119,56,37,42,133,441,2.8,2.1,4.9,2022
Andrew Nembhard,SG,23,75,2073,284,644,0.441,92,263,0.35,192,381,0.504,49,62,0.79,35,164,199,341,70,13,126,179,709,0.4,0.8,1.2,2022
Aaron Nesmith,SF,23,73,1816,252,590,0.427,115,314,0.366,137,276,0.496,119,142,0.838,62,215,277,98,55,34,75,235,738,0.9,1.1,2.0,2022
Raul Neto,PG,30,48,505,57,110,0.518,12,42,0.286,45,68,0.662,31,34,0.912,10,36,46,79,17,4,24,49,157,0.8,0.6,1.5,2022
Georges Niang,PF,29,78,1512,222,502,0.442,154,384,0.401,68,118,0.576,39,45,0.867,19,166,185,77,30,14,54,145,637,1.1,1.4,2.5,2022
Daishen Nix,PG,20,57,914,81,237,0.342,40,140,0.286,41,97,0.423,24,36,0.667,18,80,98,132,31,7,86,59,226,-1.5,0.3,-1.2,2022
Zeke Nnaji,PF,22,53,728,110,196,0.561,17,65,0.262,93,131,0.71,40,62,0.645,65,73,138,18,17,23,31,105,277,0.9,0.7,1.6,2022
Nerlens Noel,C,28,17,195,13,36,0.361,1,2,0.5,12,34,0.353,8,12,0.667,10,36,46,10,16,10,13,32,35,-0.3,0.3,0.0,2022
Jaylen Nowell,SG,23,65,1252,280,625,0.448,67,232,0.289,213,393,0.542,77,99,0.778,36,134,170,132,42,5,65,101,704,0.0,1.2,1.2,2022
Frank Ntilikina,SG,24,47,607,48,132,0.364,17,67,0.254,31,65,0.477,22,33,0.667,7,55,62,58,16,7,29,65,135,-0.5,0.4,-0.1,2022
Kendrick Nunn,SG,27,70,964,191,450,0.424,79,223,0.354,112,227,0.493,35,41,0.854,15,94,109,90,28,7,66,66,496,-0.6,0.8,0.2,2022
Jusuf Nurkić,C,28,52,1391,262,505,0.519,43,119,0.361,219,386,0.567,127,192,0.661,114,357,471,149,43,44,119,185,694,1.2,1.5,2.7,2022
Jordan Nwora,SF,24,62,1188,194,445,0.436,86,211,0.408,108,234,0.462,68,86,0.791,51,178,229,88,24,14,66,74,542,0.5,1.0,1.5,2022
Royce O'Neale,SF,29,76,2409,229,593,0.386,163,419,0.389,66,174,0.379,50,69,0.725,55,329,384,283,65,49,114,239,671,0.4,2.5,2.9,2022
Chuma Okeke,SF,24,27,518,43,122,0.352,26,86,0.302,17,36,0.472,16,21,0.762,26,70,96,37,19,11,17,40,128,0.0,0.6,0.7,2022
Josh Okogie,SG,24,72,1350,162,414,0.391,66,197,0.335,96,217,0.442,139,192,0.724,109,142,251,105,56,34,63,114,529,1.1,1.7,2.8,2022
Onyeka Okongwu,C,22,80,1849,317,497,0.638,4,13,0.308,313,484,0.647,153,196,0.781,217,359,576,81,56,107,81,251,791,4.7,2.4,7.1,2022
Isaac Okoro,SF,22,76,1652,175,354,0.494,62,171,0.363,113,183,0.617,78,103,0.757,52,135,187,87,56,30,42,158,490,1.9,2.3,4.2,2022
KZ Okpala,PF,23,35,248,16,38,0.421,7,21,0.333,9,17,0.529,7,8,0.875,7,27,34,13,7,7,7,39,46,0.1,0.2,0.3,2022
Victor Oladipo,SG,30,42,1106,160,403,0.397,70,212,0.33,90,191,0.471,59,79,0.747,16,112,128,146,57,12,87,99,449,-0.9,1.5,0.6,2022
Kelly Olynyk,C,31,68,1942,278,557,0.499,93,236,0.394,185,321,0.576,198,232,0.853,82,338,420,252,60,37,168,232,847,2.4,1.9,4.3,2022
Eugene Omoruyi,SF,25,40,645,101,228,0.443,25,89,0.281,76,139,0.547,51,75,0.68,43,68,111,28,28,3,34,91,278,0.1,0.5,0.6,2022
Cedi Osman,SF,27,77,1548,239,530,0.451,116,312,0.372,123,218,0.564,75,108,0.694,25,151,176,115,35,11,52,122,669,1.4,1.9,3.3,2022
Kelly Oubre Jr.,SF,27,48,1548,353,819,0.431,108,339,0.319,245,480,0.51,158,208,0.76,65,184,249,54,68,18,64,141,972,0.1,1.5,1.7,2022
Chris Paul,PG,37,59,1889,294,668,0.44,98,261,0.375,196,407,0.482,133,160,0.831,27,224,251,524,91,22,114,126,819,3.7,2.5,6.2,2022
Cameron Payne,PG,28,48,968,188,453,0.415,68,185,0.368,120,268,0.448,49,64,0.766,12,94,106,214,33,8,81,88,493,0.0,1.0,1.1,2022
Gary Payton II,SG,30,22,367,41,69,0.594,13,26,0.5,28,43,0.651,6,7,0.857,24,45,69,30,22,5,16,43,101,0.6,0.4,1.0,2022
Theo Pinson,SG,27,40,323,31,87,0.356,22,62,0.355,9,25,0.36,11,13,0.846,10,53,63,46,6,1,12,34,95,0.2,0.2,0.5,2022
Scotty Pippen Jr.,PG,22,6,32,4,12,0.333,1,3,0.333,3,9,0.333,5,9,0.556,2,2,4,2,2,1,2,3,14,-0.1,0.0,0.0,2022
Mason Plumlee,C,32,79,2054,329,484,0.68,0,0,0.0,329,484,0.68,199,313,0.636,229,471,700,245,46,47,117,217,857,5.5,2.4,7.9,2022
Jakob Poeltl,C,27,72,1906,389,618,0.629,0,1,0.0,389,617,0.63,119,201,0.592,236,417,653,197,66,86,125,195,897,3.7,2.2,6.0,2022
Aleksej Pokusevski,PF,21,34,701,108,249,0.434,38,104,0.365,70,145,0.483,22,35,0.629,45,114,159,64,20,43,43,58,276,0.0,1.0,1.0,2022
Jordan Poole,PG,23,82,2458,550,1278,0.43,214,637,0.336,336,641,0.524,361,415,0.87,32,193,225,369,63,21,252,214,1675,1.4,1.9,3.2,2022
Kevin Porter Jr.,PG,22,59,2024,391,884,0.442,141,385,0.366,250,499,0.501,207,264,0.784,76,238,314,338,82,17,188,156,1130,1.9,1.0,2.9,2022
Michael Porter Jr.,SF,24,62,1798,398,817,0.487,188,454,0.414,210,363,0.579,96,120,0.8,64,277,341,65,37,29,68,119,1080,2.6,1.8,4.3,2022
Otto Porter Jr.,SF,29,8,146,15,30,0.5,6,17,0.353,9,13,0.692,8,8,1.0,6,13,19,8,11,0,4,7,44,0.2,0.2,0.4,2022
Bobby Portis,PF,27,70,1818,398,803,0.496,95,257,0.37,303,546,0.555,96,125,0.768,154,518,672,105,29,16,81,115,987,2.5,2.8,5.3,2022
Kristaps Porziņģis,C,27,65,2120,507,1018,0.498,137,356,0.385,370,662,0.559,354,416,0.851,114,432,546,174,58,100,137,196,1505,5.0,2.7,7.7,2022
Micah Potter,PF,24,7,52,10,15,0.667,4,7,0.571,6,8,0.75,0,0,0.0,3,13,16,4,1,0,2,5,24,0.2,0.0,0.2,2022
Dwight Powell,C,31,76,1458,197,269,0.732,0,5,0.0,197,264,0.746,112,168,0.667,149,165,314,69,48,26,65,209,506,3.8,1.3,5.1,2022
Norman Powell,SG,29,60,1567,340,710,0.479,114,287,0.397,226,423,0.534,225,277,0.812,24,151,175,109,50,18,101,125,1019,2.1,1.4,3.5,2022
Jason Preston,PG,23,14,124,18,41,0.439,5,18,0.278,13,23,0.565,0,2,0.0,2,20,22,27,2,0,10,7,41,0.0,0.1,0.1,2022
Joshua Primo,SG,20,4,93,9,26,0.346,3,12,0.25,6,14,0.429,7,9,0.778,2,11,13,18,1,2,11,8,28,-0.2,0.0,-0.1,2022
Taurean Prince,PF,28,54,1192,177,379,0.467,74,194,0.381,103,185,0.557,65,77,0.844,15,117,132,84,28,15,69,123,493,0.3,1.0,1.3,2022
Payton Pritchard,PG,25,48,643,101,245,0.412,56,154,0.364,45,91,0.495,12,16,0.75,25,63,88,64,14,1,40,37,270,-0.1,0.7,0.6,2022
Trevelin Queen,SG,25,7,70,7,29,0.241,2,15,0.133,5,14,0.357,5,5,1.0,8,9,17,6,2,5,7,4,21,-0.3,0.1,-0.2,2022
Neemias Queta,C,23,5,29,6,9,0.667,0,0,0.0,6,9,0.667,0,2,0.0,5,6,11,1,0,2,1,7,12,0.1,0.0,0.1,2022
Immanuel Quickley,SG,23,81,2344,419,936,0.448,168,454,0.37,251,482,0.521,203,248,0.819,58,279,337,279,80,14,100,166,1209,4.4,2.3,6.7,2022
Lester Quinones,SG,22,4,18,2,5,0.4,2,4,0.5,0,1,0.0,4,6,0.667,1,2,3,2,1,0,5,0,10,-0.1,0.0,0.0,2022
Julius Randle,PF,28,77,2737,658,1432,0.459,218,636,0.343,440,796,0.553,402,531,0.757,141,626,767,316,49,21,216,233,1936,5.0,3.1,8.1,2022
Austin Reaves,SG,24,64,1843,259,490,0.529,86,216,0.398,173,274,0.631,229,265,0.864,33,160,193,215,33,19,99,108,833,4.1,1.4,5.4,2022
Cam Reddish,SF,23,40,990,139,312,0.446,45,144,0.313,94,168,0.56,64,75,0.853,18,70,88,57,39,14,47,72,387,0.3,0.7,0.9,2022
Davon Reed,SG,27,43,342,28,84,0.333,17,46,0.37,11,38,0.289,16,24,0.667,10,49,59,23,15,4,20,39,89,-0.4,0.4,0.1,2022
Paul Reed,C,23,69,755,124,209,0.593,1,6,0.167,123,203,0.606,38,51,0.745,112,150,262,27,46,51,45,123,287,1.2,1.6,2.8,2022
Naz Reid,C,23,68,1251,310,577,0.537,75,217,0.346,235,360,0.653,86,127,0.677,73,260,333,77,42,53,92,176,781,1.1,1.9,3.0,2022
Jared Rhoden,SG,23,14,198,17,44,0.386,5,20,0.25,12,24,0.5,6,6,1.0,11,26,37,4,4,1,3,23,45,0.0,0.1,0.1,2022
Nick Richards,C,25,65,1217,197,313,0.629,1,1,1.0,196,312,0.628,137,183,0.749,147,269,416,38,11,71,59,154,532,2.7,1.5,4.2,2022
Josh Richardson,SG,29,65,1530,239,554,0.431,107,293,0.365,132,261,0.506,69,81,0.852,41,134,175,174,69,20,86,117,654,0.6,1.1,1.8,2022
Austin Rivers,SG,30,52,1016,91,209,0.435,43,123,0.35,48,86,0.558,30,39,0.769,5,78,83,75,28,4,23,80,255,0.5,0.8,1.3,2022
Duncan Robinson,SF,28,42,691,88,237,0.371,63,192,0.328,25,45,0.556,29,32,0.906,8,61,69,46,14,0,28,77,268,-0.1,0.6,0.5,2022
Mitchell Robinson,C,24,59,1591,188,280,0.671,0,0,0.0,188,280,0.671,59,122,0.484,267,288,555,53,56,109,41,160,435,4.0,2.6,6.5,2022
Orlando Robinson,C,22,31,425,47,89,0.528,0,6,0.0,47,83,0.566,22,31,0.71,48,78,126,25,12,12,16,53,116,0.5,0.6,1.1,2022
Jeremiah Robinson-Earl,PF,22,43,814,110,248,0.444,37,111,0.333,73,137,0.533,35,42,0.833,71,109,180,43,24,11,19,71,292,1.1,0.8,1.9,2022
Isaiah Roby,PF,24,42,474,67,155,0.432,18,60,0.3,49,95,0.516,20,41,0.488,21,86,107,38,18,7,31,53,172,-0.4,0.3,-0.1,2022
David Roddy,PF,21,70,1258,180,420,0.429,65,212,0.307,115,208,0.553,41,65,0.631,50,143,193,59,29,19,57,107,466,-0.3,1.4,1.1,2022
Ryan Rollins,PG,20,12,62,7,20,0.35,3,9,0.333,4,11,0.364,6,6,1.0,3,9,12,6,1,1,16,10,23,-0.3,0.1,-0.3,2022
Derrick Rose,PG,34,27,338,61,159,0.384,19,63,0.302,42,96,0.438,11,12,0.917,8,32,40,46,7,5,22,18,152,-0.3,0.3,0.0,2022
Terrence Ross,SG,31,63,1330,200,465,0.43,95,258,0.368,105,207,0.507,27,34,0.794,22,132,154,95,35,10,43,97,522,0.5,1.2,1.6,2022
Terry Rozier,SG,28,63,2221,493,1188,0.415,165,505,0.327,328,683,0.48,178,220,0.809,51,208,259,319,74,16,134,119,1329,0.1,1.6,1.7,2022
Ricky Rubio,PG,32,33,566,61,178,0.343,21,82,0.256,40,96,0.417,28,35,0.8,9,61,70,115,26,6,31,51,171,-0.2,0.9,0.7,2022
D'Angelo Russell,PG,26,71,2304,445,948,0.469,194,490,0.396,251,458,0.548,179,216,0.829,35,180,215,437,70,29,186,140,1263,3.1,1.9,5.1,2022
Matt Ryan,SF,25,34,310,40,108,0.37,32,84,0.381,8,24,0.333,10,12,0.833,4,22,26,16,5,1,7,27,122,0.1,0.2,0.3,2022
Domantas Sabonis,C,26,79,2736,577,938,0.615,31,83,0.373,546,855,0.639,325,438,0.742,251,722,973,573,65,39,230,279,1510,9.6,3.0,12.6,2022
Luka Šamanić,PF,23,7,161,26,57,0.456,8,31,0.258,18,26,0.692,9,13,0.692,0,30,30,15,6,2,10,17,69,0.0,0.2,0.2,2022
Dario Šarić,PF,28,57,806,127,277,0.458,45,115,0.391,82,162,0.506,63,76,0.829,53,154,207,74,20,7,55,99,362,0.7,1.0,1.7,2022
Olivier Sarr,C,23,9,114,15,30,0.5,1,8,0.125,14,22,0.636,5,7,0.714,12,19,31,4,1,5,4,17,36,0.1,0.1,0.2,2022
Jordan Schakel,SF,24,2,6,1,2,0.5,1,1,1.0,0,1,0.0,0,0,0.0,0,0,0,1,1,0,0,1,3,0.0,0.0,0.0,2022
Admiral Schofield,PF,25,37,451,55,122,0.451,24,74,0.324,31,48,0.646,21,23,0.913,23,39,62,31,8,5,16,61,155,0.5,0.3,0.8,2022
Dennis Schröder,PG,29,66,1986,270,650,0.415,74,225,0.329,196,425,0.461,216,252,0.857,21,144,165,298,50,10,112,145,830,1.3,1.5,2.8,2022
Jay Scrubb,SG,22,2,30,5,7,0.714,2,2,1.0,3,5,0.6,1,2,0.5,0,6,6,1,2,0,3,2,13,0.0,0.0,0.1,2022
Dereon Seabron,SG,22,5,12,2,5,0.4,0,0,0.0,2,5,0.4,0,0,0.0,1,0,1,0,0,0,0,1,4,0.0,0.0,0.0,2022
Alperen Sengun,C,20,75,2171,442,799,0.553,19,57,0.333,423,742,0.57,206,288,0.715,242,436,678,291,70,70,193,258,1109,3.4,1.8,5.2,2022
Collin Sexton,PG,24,48,1145,237,468,0.506,48,122,0.393,189,346,0.546,163,199,0.819,37,68,105,138,27,6,85,112,685,2.0,0.5,2.5,2022
Landry Shamet,SG,25,40,807,113,300,0.377,75,199,0.377,38,101,0.376,45,51,0.882,11,56,67,93,26,5,36,61,346,0.5,0.7,1.2,2022
Day'Ron Sharpe,C,21,48,552,93,171,0.544,6,11,0.545,87,160,0.544,35,55,0.636,99,101,200,37,15,32,42,89,227,0.8,0.8,1.6,2022
Shaedon Sharpe,SG,19,80,1779,306,648,0.472,102,283,0.36,204,365,0.559,75,105,0.714,63,173,236,94,38,24,83,136,789,0.6,0.6,1.2,2022
Pascal Siakam,PF,28,71,2652,630,1313,0.48,93,287,0.324,537,1026,0.523,367,474,0.774,131,425,556,415,65,36,169,228,1720,5.2,2.6,7.8,2022
Chris Silva,PF,26,1,3,1,1,1.0,0,0,0.0,1,1,1.0,0,0,0.0,0,0,0,0,0,0,1,2,2,0.0,0.0,0.0,2022
Ben Simmons,PG,26,42,1105,133,235,0.566,0,2,0.0,133,233,0.571,25,57,0.439,40,223,263,256,54,24,97,139,291,0.5,1.7,2.2,2022
Kobi Simmons,SG,25,5,28,1,6,0.167,1,5,0.2,0,1,0.0,2,2,1.0,1,3,4,5,0,2,1,0,5,0.0,0.0,0.0,2022
Marko Simonovic,C,23,7,20,2,7,0.286,1,4,0.25,1,3,0.333,1,2,0.5,1,1,2,0,0,0,0,5,6,0.0,0.0,0.0,2022
Anfernee Simons,SG,23,62,2171,467,1045,0.447,212,562,0.377,255,483,0.528,160,179,0.894,18,143,161,253,42,14,128,142,1306,2.1,0.3,2.5,2022
Jericho Sims,C,24,52,812,83,107,0.776,0,1,0.0,83,106,0.783,12,16,0.75,99,143,242,25,15,28,27,96,178,1.6,0.9,2.6,2022
Marcus Smart,PG,28,61,1957,250,602,0.415,115,342,0.336,135,260,0.519,88,118,0.746,46,145,191,382,93,23,143,172,703,1.0,2.7,3.7,2022
Dennis Smith Jr.,PG,25,54,1390,186,452,0.412,24,111,0.216,162,341,0.475,78,106,0.736,27,140,167,261,75,25,82,122,474,-0.4,1.5,1.1,2022
Dru Smith,SG,25,15,158,18,45,0.4,5,19,0.263,13,26,0.5,3,3,1.0,2,22,24,22,10,4,3,23,44,0.1,0.3,0.3,2022
Ish Smith,PG,34,43,398,52,131,0.397,2,12,0.167,50,119,0.42,2,4,0.5,5,49,54,100,8,7,44,33,108,-0.8,0.4,-0.5,2022
Jabari Smith Jr.,PF,19,79,2451,364,892,0.408,120,391,0.307,244,501,0.487,162,206,0.786,122,447,569,101,43,74,104,227,1010,0.5,1.4,1.9,2022
Jalen Smith,C,22,68,1279,242,508,0.476,54,191,0.283,188,317,0.593,104,137,0.759,129,265,394,66,21,60,72,153,642,1.1,1.1,2.3,2022
Xavier Sneed,SF,25,4,48,5,10,0.5,3,6,0.5,2,4,0.5,4,4,1.0,0,5,5,5,0,1,3,7,17,0.1,0.0,0.1,2022
Jeremy Sochan,PF,19,56,1458,250,552,0.453,33,134,0.246,217,418,0.519,81,116,0.698,95,200,295,142,43,23,97,138,614,-0.5,0.7,0.2,2022
Jaden Springer,SG,20,16,89,17,35,0.486,2,5,0.4,15,30,0.5,6,8,0.75,6,8,14,8,7,3,3,15,42,0.1,0.2,0.3,2022
Lamar Stevens,SF,25,62,1120,129,288,0.448,30,95,0.316,99,193,0.513,40,57,0.702,48,159,207,33,27,19,27,79,328,0.3,1.6,1.9,2022
Isaiah Stewart,C,21,50,1414,195,441,0.442,67,205,0.327,128,236,0.542,110,149,0.738,115,288,403,70,20,34,68,133,567,1.1,0.9,2.0,2022
Max Strus,SF,26,80,2272,324,790,0.41,197,563,0.35,127,227,0.559,78,89,0.876,49,209,258,171,42,12,70,166,923,1.5,1.9,3.4,2022
Jalen Suggs,SG,21,53,1246,186,444,0.419,66,202,0.327,120,242,0.496,86,119,0.723,55,106,161,155,67,27,94,120,524,-0.2,1.5,1.4,2022
Edmond Sumner,SG,27,53,736,124,269,0.461,31,87,0.356,93,182,0.511,99,108,0.917,13,66,79,68,31,10,50,83,378,0.6,0.7,1.3,2022
Cole Swider,SF,23,7,41,3,9,0.333,3,8,0.375,0,1,0.0,0,0,0.0,1,6,7,4,0,0,0,3,9,0.0,0.0,0.1,2022
Jae'Sean Tate,SF,27,31,677,110,229,0.48,13,46,0.283,97,183,0.53,50,69,0.725,41,77,118,84,21,7,47,106,283,0.4,0.3,0.7,2022
Jayson Tatum,SF,24,74,2732,727,1559,0.466,240,686,0.35,487,873,0.558,531,622,0.854,78,571,649,342,78,51,213,160,2225,6.2,4.3,10.5,2022
Terry Taylor,PF,23,31,264,39,75,0.52,5,19,0.263,34,56,0.607,6,11,0.545,27,20,47,10,3,6,9,26,89,0.2,0.1,0.3,2022
Garrett Temple,SG,36,25,162,18,45,0.4,11,26,0.423,7,19,0.368,3,4,0.75,5,12,17,13,9,2,4,15,50,0.1,0.2,0.3,2022
Dalen Terry,SG,20,38,214,32,72,0.444,7,27,0.259,25,45,0.556,14,21,0.667,12,25,37,22,11,5,8,24,85,0.1,0.3,0.5,2022
Daniel Theis,C,30,7,109,21,44,0.477,2,11,0.182,19,33,0.576,5,12,0.417,7,15,22,9,2,6,3,7,49,0.0,0.1,0.1,2022
Cam Thomas,SG,21,57,948,201,456,0.441,51,133,0.383,150,323,0.464,151,174,0.868,8,87,95,78,20,7,63,55,604,0.3,0.7,1.0,2022
Klay Thompson,SF,32,69,2279,546,1252,0.436,301,731,0.412,245,521,0.47,116,132,0.879,39,247,286,163,49,29,123,130,1509,1.2,1.9,3.1,2022
JT Thor,PF,20,69,969,95,238,0.399,39,123,0.317,56,115,0.487,33,47,0.702,36,116,152,36,22,23,44,66,262,-0.6,0.8,0.2,2022
Matisse Thybulle,SF,25,71,1200,110,253,0.435,54,148,0.365,56,105,0.533,19,28,0.679,40,100,140,53,83,32,24,113,293,0.6,1.5,2.1,2022
Xavier Tillman Sr.,C,24,61,1180,188,306,0.614,4,15,0.267,184,291,0.632,49,89,0.551,121,186,307,96,58,29,44,97,429,2.3,1.9,4.2,2022
Isaiah Todd,PF,21,6,61,3,19,0.158,1,10,0.1,2,9,0.222,2,2,1.0,2,10,12,4,1,0,2,4,9,-0.2,0.0,-0.2,2022
Obi Toppin,PF,24,67,1050,187,419,0.446,85,247,0.344,102,172,0.593,38,47,0.809,29,158,187,66,23,12,38,68,497,1.1,1.0,2.1,2022
Juan Toscano-Anderson,SF,29,52,700,64,143,0.448,8,43,0.186,56,100,0.56,19,24,0.792,28,96,124,65,16,10,34,80,155,-0.1,0.6,0.5,2022
Karl-Anthony Towns,PF,27,29,957,212,428,0.495,60,164,0.366,152,264,0.576,118,135,0.874,48,188,236,140,20,17,86,111,602,1.5,1.1,2.7,2022
Gary Trent Jr.,SG,24,66,2118,405,935,0.433,166,450,0.369,239,485,0.493,172,205,0.839,30,143,173,106,104,14,55,102,1148,2.5,2.0,4.5,2022
P.J. Tucker,PF,37,75,1920,96,225,0.427,55,140,0.393,41,85,0.482,19,23,0.826,95,200,295,60,39,15,44,180,266,0.9,1.7,2.5,2022
Myles Turner,C,26,62,1825,402,733,0.548,93,249,0.373,309,484,0.638,216,276,0.783,88,378,466,89,36,140,103,215,1113,3.4,2.0,5.4,2022
Stanley Umude,SG,23,1,2,0,1,0.0,0,1,0.0,0,0,0.0,2,2,1.0,0,0,0,0,1,1,0,0,2,0.0,0.0,0.0,2022
Jonas Valančiūnas,C,30,79,1968,446,816,0.547,38,109,0.349,408,707,0.577,185,224,0.826,225,579,804,140,20,52,159,245,1115,2.8,3.0,5.8,2022
Jarred Vanderbilt,PF,23,78,1879,247,451,0.548,29,90,0.322,218,361,0.604,96,139,0.691,170,412,582,184,83,21,97,190,619,2.7,2.5,5.2,2022
Fred VanVleet,PG,28,69,2535,437,1112,0.393,207,606,0.342,230,506,0.455,254,283,0.898,30,250,280,495,123,38,140,193,1335,3.7,2.8,6.5,2022
Devin Vassell,SG,22,38,1178,261,595,0.439,103,266,0.387,158,329,0.48,78,100,0.78,8,140,148,136,43,17,57,57,703,0.7,0.5,1.2,2022
Gabe Vincent,PG,26,68,1759,228,567,0.402,117,350,0.334,111,217,0.512,68,78,0.872,27,118,145,167,62,5,92,154,641,-0.3,1.7,1.4,2022
Noah Vonleh,C,27,23,171,11,24,0.458,1,4,0.25,10,20,0.5,2,2,1.0,18,30,48,7,2,8,11,35,25,0.0,0.3,0.2,2022
Nikola Vučević,C,32,82,2746,597,1148,0.52,121,347,0.349,476,801,0.594,132,158,0.835,159,744,903,265,60,57,139,179,1447,3.9,4.4,8.3,2022
Dean Wade,PF,26,44,891,73,177,0.412,45,127,0.354,28,50,0.56,15,23,0.652,20,130,150,37,28,21,17,89,206,0.4,1.4,1.8,2022
Franz Wagner,SF,21,80,2609,542,1118,0.485,130,360,0.361,412,758,0.544,271,322,0.842,70,259,329,283,77,17,167,183,1485,3.1,2.3,5.4,2022
Moritz Wagner,C,25,57,1109,198,396,0.5,51,163,0.313,147,233,0.631,153,182,0.841,69,190,259,84,37,13,68,136,600,2.1,1.3,3.4,2022
Ish Wainright,SF,28,60,915,84,227,0.37,57,173,0.329,27,54,0.5,26,31,0.839,45,94,139,53,38,22,22,117,251,0.5,1.2,1.7,2022
Jabari Walker,SF,20,56,619,83,198,0.419,16,56,0.286,67,142,0.472,34,45,0.756,48,83,131,34,10,13,29,69,216,-0.1,0.3,0.2,2022
Kemba Walker,PG,32,9,144,24,57,0.421,7,28,0.25,17,29,0.586,17,21,0.81,3,13,16,19,2,2,4,11,72,0.2,0.1,0.3,2022
Lonnie Walker IV,SG,24,56,1297,236,527,0.448,91,249,0.365,145,278,0.522,91,106,0.858,14,95,109,64,30,17,46,71,654,0.8,1.0,1.8,2022
John Wall,PG,32,34,755,138,338,0.408,33,109,0.303,105,229,0.459,77,113,0.681,14,78,92,178,27,12,80,59,386,-0.4,0.7,0.3,2022
T.J. Warren,PF,29,42,687,132,270,0.489,22,67,0.328,110,203,0.542,28,35,0.8,26,95,121,40,22,12,20,65,314,0.4,0.8,1.2,2022
Duane Washington Jr.,SG,22,31,394,94,256,0.367,40,111,0.36,54,145,0.372,16,24,0.667,2,34,36,63,6,4,34,23,244,-0.8,0.3,-0.5,2022
P.J. Washington,PF,24,73,2380,434,978,0.444,149,428,0.348,285,550,0.518,127,174,0.73,73,285,358,175,66,79,110,193,1144,0.4,2.2,2.6,2022
TyTy Washington Jr.,PG,21,31,433,58,160,0.363,19,80,0.238,39,80,0.488,10,18,0.556,2,43,45,47,15,2,14,29,145,-0.3,0.1,-0.1,2022
Yuta Watanabe,SF,28,58,928,114,232,0.491,60,135,0.444,54,97,0.557,34,47,0.723,30,111,141,48,25,17,22,80,322,1.3,0.9,2.1,2022
Lindy Waters III,SG,25,41,531,70,178,0.393,58,162,0.358,12,16,0.75,16,20,0.8,16,59,75,28,14,11,10,42,214,0.6,0.5,1.1,2022
Trendon Watford,PF,22,62,1182,181,323,0.56,25,64,0.391,156,259,0.602,72,100,0.72,42,196,238,130,32,12,71,118,459,1.3,0.7,2.1,2022
Peyton Watson,SG,20,23,186,29,59,0.492,6,14,0.429,23,45,0.511,11,20,0.55,8,29,37,11,2,11,8,14,75,0.1,0.2,0.3,2022
Blake Wesley,SG,19,37,669,69,215,0.321,20,52,0.385,49,163,0.301,26,44,0.591,11,70,81,99,25,5,65,67,184,-1.9,0.3,-1.6,2022
Russell Westbrook,PG,34,73,2126,432,991,0.436,89,286,0.311,343,705,0.487,206,314,0.656,89,334,423,551,76,33,255,162,1159,-0.6,2.6,1.9,2022
Coby White,SG,22,74,1730,263,594,0.443,128,344,0.372,135,250,0.54,61,70,0.871,16,196,212,204,54,6,74,122,715,1.2,1.9,3.1,2022
Derrick White,SG,28,82,2319,350,758,0.462,149,391,0.381,201,367,0.548,168,192,0.875,52,241,293,321,54,76,95,177,1017,4.4,3.1,7.4,2022
Jack White,SF,25,17,66,8,19,0.421,3,9,0.333,5,10,0.5,2,3,0.667,6,11,17,4,3,2,2,9,21,0.1,0.1,0.1,2022
Joe Wieskamp,SF,23,9,50,3,14,0.214,3,12,0.25,0,2,0.0,0,0,0.0,0,4,4,3,0,0,1,3,9,-0.1,0.0,-0.1,2022
Aaron Wiggins,SG,24,70,1297,186,363,0.512,48,122,0.393,138,241,0.573,59,71,0.831,68,142,210,80,39,15,55,110,479,1.4,1.2,2.6,2022
Andrew Wiggins,SF,27,37,1190,250,529,0.473,89,225,0.396,161,304,0.53,44,72,0.611,61,125,186,85,45,28,48,107,633,1.0,1.3,2.3,2022
Lindell Wigginton,PG,24,7,87,18,37,0.486,6,18,0.333,12,19,0.632,8,9,0.889,0,7,7,14,0,2,12,7,50,0.0,0.1,0.1,2022
Alondes Williams,SG,23,1,5,0,0,0.0,0,0,0.0,0,0,0.0,0,0,0.0,0,1,1,0,0,0,2,1,0,-0.1,0.0,-0.1,2022
Donovan Williams,SG,21,2,4,2,5,0.4,0,2,0.0,2,3,0.667,0,0,0.0,0,2,2,0,0,0,0,0,4,0.0,0.0,0.0,2022
Grant Williams,PF,24,79,2045,216,476,0.454,115,291,0.395,101,185,0.546,94,122,0.77,87,276,363,131,41,31,82,192,641,1.9,2.6,4.4,2022
Jalen Williams,SG,21,75,2276,414,794,0.521,73,205,0.356,341,589,0.579,155,191,0.812,84,253,337,248,103,35,123,191,1056,3.0,2.6,5.6,2022
Jaylin Williams,C,20,49,914,102,234,0.436,46,113,0.407,56,121,0.463,38,54,0.704,44,197,241,76,28,12,37,111,288,0.7,1.2,1.9,2022
Jeenathan Williams,SG,23,5,127,24,39,0.615,3,8,0.375,21,31,0.677,2,3,0.667,10,5,15,10,3,2,4,13,53,0.3,0.0,0.3,2022
Kenrich Williams,PF,28,53,1206,179,346,0.517,50,134,0.373,129,212,0.608,17,39,0.436,97,164,261,105,45,14,32,112,425,2.0,1.3,3.3,2022
Mark Williams,C,21,43,828,160,251,0.637,0,0,0.0,160,251,0.637,67,97,0.691,93,211,304,18,28,45,40,94,387,1.5,1.3,2.8,2022
Patrick Williams,PF,21,82,2323,314,677,0.464,115,277,0.415,199,400,0.498,90,105,0.857,78,249,327,100,72,70,101,147,833,0.5,3.0,3.5,2022
Robert Williams,C,25,35,824,127,170,0.747,0,1,0.0,127,169,0.751,25,41,0.61,104,188,292,50,22,48,34,68,279,2.3,1.6,3.8,2022
Vince Williams Jr.,SG,22,15,105,12,40,0.3,4,28,0.143,8,12,0.667,2,2,1.0,4,11,15,4,6,2,5,12,30,-0.3,0.2,-0.1,2022
Ziaire Williams,SF,21,37,561,84,196,0.429,25,97,0.258,59,99,0.596,17,22,0.773,16,63,79,35,14,6,37,58,210,-0.5,0.6,0.1,2022
Zion Williamson,PF,22,29,956,285,469,0.608,7,19,0.368,278,450,0.618,177,248,0.714,58,144,202,133,32,16,99,65,754,2.3,1.2,3.6,2022
Dylan Windler,SF,26,3,10,2,3,0.667,1,2,0.5,1,1,1.0,0,0,0.0,0,0,0,1,1,0,1,0,5,0.0,0.0,0.0,2022
Justise Winslow,PF,26,29,776,81,198,0.409,14,45,0.311,67,153,0.438,20,28,0.714,49,96,145,98,30,11,43,89,196,-0.1,0.5,0.4,2022
James Wiseman,C,21,45,867,189,339,0.558,4,20,0.2,185,319,0.58,68,97,0.701,73,194,267,30,7,27,51,108,450,0.7,0.7,1.4,2022
Christian Wood,C,27,67,1738,396,769,0.515,105,279,0.376,291,490,0.594,217,281,0.772,87,404,491,121,30,72,121,169,1114,2.7,2.1,4.8,2022
Delon Wright,PG,30,50,1221,138,291,0.474,41,119,0.345,97,172,0.564,52,60,0.867,58,122,180,194,92,17,44,59,369,2.1,1.6,3.7,2022
McKinley Wright IV,PG,24,27,335,46,98,0.469,9,28,0.321,37,70,0.529,13,19,0.684,9,38,47,58,8,5,19,24,114,0.2,0.2,0.5,2022
Gabe York,SG,29,3,56,8,21,0.381,6,18,0.333,2,3,0.667,2,2,1.0,0,6,6,5,2,0,0,5,24,0.1,0.0,0.1,2022
Thaddeus Young,PF,34,54,795,108,198,0.545,6,34,0.176,102,164,0.622,18,26,0.692,71,95,166,75,54,5,42,88,240,0.7,1.1,1.8,2022
Trae Young,PG,24,73,2541,597,1390,0.429,154,460,0.335,443,930,0.476,566,639,0.886,56,161,217,741,80,9,300,104,1914,5.3,1.4,6.7,2022
Omer Yurtseven,C,24,9,83,16,27,0.593,3,7,0.429,13,20,0.65,5,6,0.833,8,15,23,2,2,2,4,16,40,0.2,0.1,0.3,2022
Cody Zeller,C,30,15,217,37,59,0.627,0,2,0.0,37,57,0.649,24,35,0.686,25,39,64,10,3,4,14,33,98,0.4,0.3,0.7,2022
Ivica Zubac,C,25,76,2170,326,514,0.634,0,2,0.0,326,512,0.637,166,238,0.697,236,520,756,77,29,98,117,219,818,3.8,2.9,6.7,2022
Precious Achiuwa,PF,24,74,1624,235,469,0.501,26,97,0.268,209,372,0.562,69,112,0.616,191,296,487,97,46,68,83,143,565,1.2,2.2,3.4,2023
Bam Adebayo,C,26,71,2416,530,1017,0.521,15,42,0.357,515,975,0.528,292,387,0.755,159,578,737,278,81,66,162,159,1367,2.9,4.3,7.2,2023
Ochai Agbaji,SG,23,78,1641,178,433,0.411,62,211,0.294,116,222,0.523,37,56,0.661,74,142,216,83,47,44,64,117,455,-0.5,0.6,0.1,2023
Santi Aldama,PF,23,61,1618,247,568,0.435,106,304,0.349,141,264,0.534,54,87,0.621,72,280,352,138,43,54,69,89,654,0.4,2.0,2.4,2023
Nickeil Alexander-Walker,SG,25,82,1921,236,538,0.439,131,335,0.391,105,203,0.517,52,65,0.8,35,132,167,204,64,42,76,143,655,1.5,2.8,4.3,2023
Grayson Allen,SG,28,75,2513,340,682,0.499,205,445,0.461,135,237,0.57,129,147,0.878,48,247,295,227,69,45,95,157,1014,4.7,2.2,6.9,2023
Jarrett Allen,C,25,77,2442,519,819,0.634,0,6,0.0,519,813,0.638,233,314,0.742,243,568,811,210,53,81,121,147,1271,6.8,3.9,10.7,2023
Timmy Allen,SF,24,5,125,6,23,0.261,0,7,0.0,6,16,0.375,1,2,0.5,4,13,17,5,4,0,2,18,13,-0.2,0.1,-0.1,2023
Jose Alvarado,PG,25,56,1028,142,345,0.412,78,207,0.377,64,138,0.464,35,52,0.673,25,103,128,117,59,15,40,89,397,0.6,1.5,2.1,2023
Kyle Anderson,PF,30,79,1782,199,433,0.46,11,48,0.229,188,385,0.488,97,137,0.708,60,213,273,331,71,47,91,128,506,1.4,3.1,4.5,2023
Giannis Antetokounmpo,PF,29,73,2567,837,1369,0.611,34,124,0.274,803,1245,0.645,514,782,0.657,196,645,841,476,87,79,250,210,2222,9.5,3.7,13.2,2023
Thanasis Antetokounmpo,PF,31,34,155,16,30,0.533,0,1,0.0,16,29,0.552,0,2,0.0,7,6,13,17,7,4,14,24,32,-0.2,0.1,0.0,2023
Cole Anthony,PG,23,81,1817,332,763,0.435,93,275,0.338,239,488,0.49,180,218,0.826,64,247,311,236,64,37,126,175,937,0.9,2.7,3.6,2023
OG Anunoby,SF,26,50,1702,282,577,0.489,102,267,0.382,180,310,0.581,67,89,0.753,47,161,208,107,68,36,81,119,733,1.1,1.5,2.6,2023
Ryan Arcidiacono,PG,29,20,45,0,6,0.0,0,6,0.0,0,0,0.0,0,0,0.0,0,8,8,4,2,0,2,5,0,-0.1,0.1,-0.1,2023
Deni Avdija,SF,23,75,2257,406,803,0.506,88,235,0.374,318,568,0.56,202,273,0.74,84,456,540,286,60,36,160,185,1102,1.7,1.5,3.2,2023
Deandre Ayton,C,25,55,1784,427,749,0.57,1,10,0.1,426,739,0.576,65,79,0.823,176,433,609,90,56,42,99,109,920,1.8,2.1,3.9,2023
Udoka Azubuike,C,24,16,113,16,23,0.696,0,0,0.0,16,23,0.696,3,13,0.231,11,21,32,3,1,6,4,17,35,0.1,0.1,0.2,2023
Ibou Badji,C,21,22,226,14,22,0.636,0,0,0.0,14,22,0.636,6,12,0.5,20,31,51,13,3,20,15,46,34,0.0,0.2,0.2,2023
Marvin Bagley III,C,24,50,1053,239,408,0.586,9,23,0.391,230,385,0.597,96,126,0.762,130,182,312,55,20,33,59,81,583,2.0,0.7,2.7,2023
Amari Bailey,PG,19,10,65,8,24,0.333,1,8,0.125,7,16,0.438,6,7,0.857,6,3,9,7,3,0,4,2,23,-0.1,0.0,-0.1,2023
Patrick Baldwin Jr.,SF,21,38,493,59,155,0.381,31,97,0.32,28,58,0.483,19,28,0.679,17,106,123,29,18,15,19,56,168,-0.3,0.5,0.2,2023
LaMelo Ball,PG,22,22,711,183,423,0.433,70,197,0.355,113,226,0.5,90,104,0.865,29,84,113,176,40,4,83,79,526,0.6,0.5,1.1,2023
Mo Bamba,C,25,57,740,97,198,0.49,25,64,0.391,72,134,0.537,34,50,0.68,77,161,238,41,22,60,39,101,253,0.6,1.3,2.0,2023
Paolo Banchero,PF,21,80,2799,640,1407,0.455,119,351,0.339,521,1056,0.493,405,559,0.725,82,472,554,431,71,47,247,153,1804,1.3,4.0,5.3,2023
Desmond Bane,SG,25,42,1443,360,776,0.464,137,360,0.381,223,416,0.536,140,161,0.87,36,149,185,230,43,22,112,120,997,1.8,1.3,3.1,2023
Dalano Banton,PG,24,54,1047,202,500,0.404,59,199,0.296,143,301,0.475,94,120,0.783,41,137,178,127,33,20,77,64,557,-0.4,0.9,0.5,2023
Dominick Barlow,PF,20,33,420,56,113,0.496,3,9,0.333,53,104,0.51,29,42,0.69,45,68,113,36,12,14,9,47,144,0.7,0.4,1.1,2023
Harrison Barnes,PF,31,82,2381,347,732,0.474,149,385,0.387,198,347,0.571,157,196,0.801,67,182,249,99,54,12,58,98,1000,3.1,1.5,4.7,2023
Scottie Barnes,SG,22,60,2094,447,942,0.475,101,296,0.341,346,646,0.536,196,251,0.781,141,353,494,363,75,88,165,118,1191,2.3,2.0,4.3,2023
RJ Barrett,SG,23,58,1838,436,880,0.495,90,250,0.36,346,630,0.549,208,291,0.715,53,262,315,193,31,22,126,129,1170,1.6,1.2,2.9,2023
Charles Bassey,C,23,19,205,29,40,0.725,0,1,0.0,29,39,0.744,5,6,0.833,23,53,76,21,8,17,15,31,63,0.3,0.4,0.7,2023
Emoni Bates,SF,20,15,133,15,49,0.306,10,33,0.303,5,16,0.313,1,4,0.25,1,13,14,10,1,2,8,5,41,-0.4,0.1,-0.3,2023
Keita Bates-Diop,SF,28,53,665,72,166,0.434,21,69,0.304,51,97,0.526,32,42,0.762,31,79,110,38,25,22,15,35,197,0.5,0.8,1.3,2023
Nicolas Batum,PF,35,60,1529,116,256,0.453,73,185,0.395,43,71,0.606,15,21,0.714,70,178,248,128,48,38,40,109,320,1.7,1.6,3.3,2023
Darius Bazley,PF,23,9,152,18,30,0.6,2,8,0.25,16,22,0.727,10,12,0.833,8,20,28,7,6,7,8,3,48,0.2,0.1,0.3,2023
Bradley Beal,SG,30,53,1767,377,735,0.513,101,235,0.43,276,500,0.552,109,134,0.813,54,178,232,265,52,27,131,127,964,2.4,1.5,3.9,2023
Malik Beasley,SG,27,79,2337,320,722,0.443,224,542,0.413,96,180,0.533,25,35,0.714,41,249,290,108,59,9,54,158,889,1.9,1.6,3.5,2023
MarJon Beauchamp,SF,23,48,608,81,166,0.488,30,75,0.4,51,91,0.56,19,28,0.679,22,77,99,31,13,7,27,54,211,0.2,0.5,0.7,2023
Jules Bernard,SG,24,19,149,29,64,0.453,11,29,0.379,18,35,0.514,5,9,0.556,10,16,26,16,3,1,8,14,74,0.0,0.0,0.1,2023
Dāvis Bertāns,PF,31,43,674,92,234,0.393,76,200,0.38,16,34,0.471,30,33,0.909,9,52,61,35,26,12,18,56,290,0.5,0.4,0.9,2023
Patrick Beverley,PG,35,73,1462,158,379,0.417,61,181,0.337,97,198,0.49,74,90,0.822,49,190,239,212,43,31,65,128,451,1.2,1.5,2.7,2023
Saddiq Bey,SF,24,63,2062,290,697,0.416,113,358,0.316,177,339,0.522,170,203,0.837,167,244,411,92,51,11,54,88,863,2.8,0.7,3.5,2023
Goga Bitadze,C,24,62,957,126,209,0.603,2,14,0.143,124,195,0.636,57,87,0.655,109,177,286,79,32,72,44,107,311,1.8,1.9,3.7,2023
Onuralp Bitim,SG,24,23,268,32,84,0.381,12,44,0.273,20,40,0.5,4,5,0.8,6,26,32,13,3,2,10,24,80,-0.3,0.1,-0.1,2023
Bismack Biyombo,C,31,40,791,74,131,0.565,0,0,0.0,74,131,0.565,26,54,0.481,62,147,209,53,11,37,42,89,174,0.1,1.0,1.1,2023
Anthony Black,PG,20,69,1164,115,247,0.466,37,94,0.394,78,153,0.51,49,80,0.613,33,106,139,91,35,21,56,110,316,0.1,1.5,1.6,2023
Leaky Black,SF,24,26,284,25,52,0.481,9,20,0.45,16,32,0.5,10,15,0.667,9,39,48,24,8,11,6,19,69,0.3,0.2,0.5,2023
Buddy Boeheim,SF,24,10,84,9,29,0.31,8,25,0.32,1,4,0.25,8,10,0.8,3,7,10,3,0,1,0,5,34,0.1,0.0,0.1,2023
Bogdan Bogdanović,SG,31,79,2401,471,1100,0.428,240,641,0.374,231,459,0.503,151,164,0.921,53,219,272,247,96,26,112,179,1333,2.8,1.2,3.9,2023
Bojan Bogdanović,SF,34,57,1478,309,681,0.454,133,334,0.398,176,347,0.507,117,149,0.785,22,130,152,97,30,5,101,95,868,0.3,0.7,1.1,2023
Bol Bol,PF,24,43,469,93,151,0.616,22,52,0.423,71,99,0.717,15,19,0.789,32,105,137,17,10,25,19,42,223,1.0,0.7,1.6,2023
Marques Bolden,C,25,11,121,17,25,0.68,0,1,0.0,17,24,0.708,3,4,0.75,10,24,34,4,3,7,3,10,37,0.2,0.1,0.3,2023
Devin Booker,PG,27,68,2447,642,1305,0.492,152,418,0.364,490,887,0.552,405,457,0.886,56,252,308,472,61,28,178,206,1841,7.2,2.0,9.2,2023
Brandon Boston Jr.,SF,22,32,345,65,161,0.404,14,52,0.269,51,109,0.468,23,33,0.697,19,33,52,13,11,8,24,40,167,-0.6,0.3,-0.3,2023
Chris Boucher,PF,31,50,705,110,217,0.507,31,94,0.33,79,123,0.642,71,92,0.772,62,145,207,23,14,24,28,68,322,1.2,0.6,1.7,2023
James Bouknight,SG,23,14,81,18,41,0.439,13,30,0.433,5,11,0.455,1,2,0.5,1,8,9,6,1,1,2,3,50,0.1,0.0,0.1,2023
Jamaree Bouyea,PG,24,9,95,10,28,0.357,1,9,0.111,9,19,0.474,0,0,0.0,3,16,19,11,1,0,9,10,21,-0.3,0.1,-0.3,2023
Malaki Branham,PG,20,75,1594,271,628,0.432,93,268,0.347,178,360,0.494,55,63,0.873,28,120,148,156,27,8,91,94,690,-0.9,0.6,-0.3,2023
Christian Braun,SG,22,82,1655,222,483,0.46,63,164,0.384,159,319,0.498,93,134,0.694,79,227,306,132,42,35,55,137,600,1.5,2.0,3.4,2023
Mikal Bridges,SF,27,82,2854,564,1294,0.436,220,592,0.372,344,702,0.49,258,317,0.814,68,304,372,299,81,30,164,116,1606,2.1,2.1,4.2,2023
Miles Bridges,SF,25,69,2581,559,1210,0.462,157,450,0.349,402,760,0.529,174,211,0.825,71,434,505,231,65,33,138,118,1449,0.7,1.4,2.2,2023
Oshae Brissett,SF,25,55,630,68,153,0.444,15,55,0.273,53,98,0.541,50,83,0.602,61,99,160,44,19,8,20,54,201,0.8,0.9,1.7,2023
Izaiah Brockington,PG,24,1,3,2,5,0.4,0,1,0.0,2,4,0.5,0,0,0.0,1,1,2,0,0,0,0,0,4,0.0,0.0,0.0,2023
Malcolm Brogdon,PG,31,39,1121,218,496,0.44,82,199,0.412,136,297,0.458,95,116,0.819,28,120,148,214,27,8,60,58,613,2.0,0.6,2.6,2023
Armoni Brooks,PG,25,10,104,15,46,0.326,11,32,0.344,4,14,0.286,1,2,0.5,7,11,18,5,1,1,3,3,42,-0.1,0.1,0.0,2023
Dillon Brooks,SF,28,72,2227,329,768,0.428,133,370,0.359,196,398,0.492,124,147,0.844,53,193,246,119,64,10,88,241,915,0.6,2.1,2.7,2023
Bruce Brown,PG,27,67,1866,278,582,0.478,53,164,0.323,225,418,0.538,117,142,0.824,53,231,284,192,59,17,86,148,726,1.2,1.0,2.2,2023
Charlie Brown Jr.,SG,26,8,37,2,10,0.2,2,7,0.286,0,3,0.0,0,0,0.0,1,1,2,0,0,2,2,5,6,-0.1,0.0,-0.1,2023
Greg Brown III,PF,22,6,40,5,11,0.455,1,3,0.333,4,8,0.5,4,9,0.444,3,6,9,4,0,4,4,5,15,0.0,0.0,0.0,2023
Jaylen Brown,SF,27,70,2343,627,1256,0.499,145,410,0.354,482,846,0.57,211,300,0.703,84,303,387,249,83,37,166,185,1610,2.7,3.2,5.9,2023
Kendall Brown,SG,20,15,63,8,15,0.533,0,2,0.0,8,13,0.615,5,8,0.625,3,2,5,5,0,0,2,9,21,0.1,0.0,0.1,2023
Kobe Brown,PF,24,44,394,37,90,0.411,14,48,0.292,23,42,0.548,1,2,0.5,20,42,62,25,12,6,9,49,89,0.1,0.3,0.5,2023
Moses Brown,C,24,22,200,33,65,0.508,0,0,0.0,33,65,0.508,9,31,0.29,37,49,86,7,5,7,11,27,75,-0.1,0.2,0.2,2023
Troy Brown Jr.,SF,24,59,827,84,226,0.372,47,141,0.333,37,85,0.435,32,37,0.865,25,119,144,60,24,3,30,42,247,0.0,0.9,0.8,2023
Jalen Brunson,PG,27,77,2726,790,1648,0.479,211,526,0.401,579,1122,0.516,421,497,0.847,43,235,278,519,70,13,186,144,2212,8.8,2.4,11.2,2023
Thomas Bryant,C,26,38,441,86,149,0.577,4,22,0.182,82,127,0.646,41,47,0.872,40,101,141,23,10,16,21,46,217,0.9,0.8,1.6,2023
Kobe Bufkin,SG,20,17,196,34,92,0.37,9,40,0.225,25,52,0.481,4,8,0.5,6,27,33,27,7,5,10,20,81,-0.3,0.1,-0.1,2023
Reggie Bullock,SF,32,44,417,34,82,0.415,27,67,0.403,7,15,0.467,1,1,1.0,6,67,73,15,12,5,10,29,96,0.1,0.5,0.6,2023
Alec Burks,SG,32,66,1212,210,569,0.369,124,330,0.376,86,239,0.36,145,167,0.868,24,126,150,88,28,12,48,75,689,0.7,0.7,1.4,2023
Jared Butler,SG,23,40,566,98,201,0.488,24,78,0.308,74,123,0.602,31,36,0.861,9,49,58,126,29,8,50,58,251,0.3,0.3,0.6,2023
Jimmy Butler,PF,34,60,2042,396,793,0.499,60,145,0.414,336,648,0.519,394,459,0.858,105,213,318,298,79,17,102,68,1246,6.4,2.7,9.1,2023
Jamal Cain,PF,24,26,259,34,79,0.43,11,31,0.355,23,48,0.479,18,23,0.783,15,22,37,10,10,5,8,22,97,0.1,0.3,0.5,2023
Kentavious Caldwell-Pope,SG,30,76,2402,270,587,0.46,125,308,0.406,145,279,0.52,101,113,0.894,31,152,183,183,98,42,75,151,766,2.2,2.6,4.8,2023
Toumani Camara,PF,23,70,1739,197,438,0.45,58,172,0.337,139,266,0.523,75,99,0.758,139,204,343,87,66,33,84,174,527,0.6,1.4,2.0,2023
Clint Capela,C,29,73,1883,353,618,0.571,0,1,0.0,353,617,0.572,130,206,0.631,335,441,776,91,43,106,74,164,836,4.4,1.9,6.3,2023
Jevon Carter,PG,28,72,1004,138,365,0.378,77,234,0.329,61,131,0.466,4,7,0.571,11,49,60,94,37,16,36,71,357,-0.5,0.7,0.2,2023
Wendell Carter Jr.,C,24,55,1406,223,425,0.525,64,171,0.374,159,254,0.626,93,134,0.694,112,269,381,95,35,28,68,121,603,2.2,2.1,4.4,2023
D.J. Carton,SG,23,4,36,3,8,0.375,1,4,0.25,2,4,0.5,4,5,0.8,2,2,4,3,1,0,1,3,11,0.0,0.0,0.0,2023
Alex Caruso,SG,29,71,2040,253,541,0.468,136,333,0.408,117,208,0.563,73,96,0.76,62,211,273,247,120,70,102,181,715,2.3,2.6,4.9,2023
Colin Castleton,C,23,16,59,9,16,0.563,0,0,0.0,9,16,0.563,6,6,1.0,6,6,12,3,2,0,3,11,24,0.1,0.0,0.2,2023
Malcolm Cazalon,SG,22,1,3,0,0,0.0,0,0,0.0,0,0,0.0,0,0,0.0,0,0,0,0,0,0,0,0,0,0.0,0.0,0.0,2023
Julian Champagnie,SF,22,74,1468,164,402,0.408,101,277,0.365,63,125,0.504,75,92,0.815,42,164,206,103,48,42,57,77,504,0.6,1.3,1.8,2023
Justin Champagnie,SF,22,15,235,32,78,0.41,13,45,0.289,19,33,0.576,12,15,0.8,19,34,53,19,10,9,10,14,89,0.1,0.2,0.3,2023
Max Christie,SG,20,67,944,103,241,0.427,42,118,0.356,61,123,0.496,36,46,0.783,15,127,142,60,20,17,35,57,284,-0.1,0.8,0.7,2023
Sidy Cissoko,SF,19,12,141,16,33,0.485,1,12,0.083,15,21,0.714,12,15,0.8,8,14,22,10,7,3,3,18,45,0.2,0.1,0.3,2023
Brandon Clarke,PF,27,6,134,33,59,0.559,1,6,0.167,32,53,0.604,1,7,0.143,13,19,32,9,5,6,3,8,68,0.1,0.2,0.3,2023
Jordan Clarkson,SG,31,55,1682,337,816,0.413,91,309,0.294,246,507,0.485,177,201,0.881,49,139,188,277,35,6,146,81,942,0.1,0.1,0.2,2023
Nic Claxton,C,24,71,2116,366,582,0.629,1,5,0.2,365,577,0.633,108,196,0.551,193,513,706,147,46,146,93,175,841,3.5,3.2,6.7,2023
Noah Clowney,PF,19,23,370,50,93,0.538,12,33,0.364,38,60,0.633,21,30,0.7,26,55,81,18,8,16,15,25,133,0.5,0.4,0.9,2023
Amir Coffey,SF,26,70,1460,166,352,0.472,70,184,0.38,96,168,0.571,61,71,0.859,29,119,148,76,41,14,33,102,463,1.6,1.0,2.6,2023
John Collins,PF,26,68,1901,397,746,0.532,86,232,0.371,311,514,0.605,147,185,0.795,157,418,575,77,40,61,98,191,1027,3.1,1.3,4.4,2023
Zach Collins,C,26,69,1526,298,616,0.484,58,181,0.32,240,435,0.552,122,162,0.753,118,252,370,194,34,52,132,206,776,0.4,1.5,1.8,2023
Mike Conley,PG,36,76,2193,294,644,0.457,179,405,0.442,115,239,0.481,102,112,0.911,37,181,218,449,88,17,102,128,869,5.0,3.3,8.2,2023
Pat Connaughton,SF,31,76,1676,151,347,0.435,82,238,0.345,69,109,0.633,44,58,0.759,51,188,239,161,40,19,49,99,428,1.6,1.2,2.8,2023
Bilal Coulibaly,SF,19,63,1715,188,432,0.435,64,185,0.346,124,247,0.502,92,131,0.702,56,200,256,110,57,48,87,137,532,-0.5,0.9,0.4,2023
Ricky Council IV,SG,22,32,289,54,112,0.482,12,32,0.375,42,80,0.525,53,71,0.746,14,32,46,16,8,1,5,17,173,0.8,0.3,1.0,2023
Robert Covington,SF,33,29,488,43,98,0.439,19,56,0.339,24,42,0.571,22,26,0.846,31,66,97,24,39,18,11,56,127,0.6,0.9,1.5,2023
Torrey Craig,SF,33,53,1049,108,251,0.43,60,153,0.392,48,98,0.49,27,36,0.75,69,148,217,58,30,21,32,110,303,1.0,0.9,1.9,2023
Jae Crowder,PF,33,50,1156,114,270,0.422,58,166,0.349,56,104,0.538,26,36,0.722,31,130,161,66,38,9,23,74,312,0.6,1.0,1.6,2023
Jalen Crutcher,PG,24,1,3,0,1,0.0,0,0,0.0,0,1,0.0,0,0,0.0,0,0,0,0,0,0,0,0,0,0.0,0.0,0.0,2023
Cade Cunningham,PG,22,62,2074,524,1167,0.449,119,335,0.355,405,832,0.487,238,274,0.869,33,235,268,464,56,22,212,153,1405,0.7,1.0,1.8,2023
Seth Curry,SG,33,44,616,80,204,0.392,38,108,0.352,42,96,0.438,28,31,0.903,18,50,68,44,22,6,21,39,226,0.1,0.4,0.5,2023
Stephen Curry,PG,35,74,2421,650,1445,0.45,357,876,0.408,293,569,0.515,299,324,0.923,37,293,330,379,54,28,210,117,1956,5.2,2.0,7.2,2023
Dyson Daniels,PG,20,61,1358,139,311,0.447,42,135,0.311,97,176,0.551,34,53,0.642,62,174,236,164,85,25,59,101,354,0.7,2.2,2.9,2023
Anthony Davis,C,30,76,2700,713,1283,0.556,29,107,0.271,684,1176,0.582,421,516,0.816,239,722,961,266,91,178,159,177,1876,7.2,4.7,11.8,2023
Johnny Davis,SG,21,50,613,62,154,0.403,14,40,0.35,48,114,0.421,14,24,0.583,18,54,72,32,18,10,13,57,152,-0.3,0.2,-0.1,2023
JD Davison,SG,21,8,39,5,12,0.417,3,7,0.429,2,5,0.4,3,4,0.75,2,8,10,10,1,1,2,4,16,0.1,0.1,0.2,2023
Dexter Dennis,SG,24,4,30,10,19,0.526,1,8,0.125,9,11,0.818,1,3,0.333,1,8,9,4,0,1,3,1,22,0.0,0.0,0.0,2023
DeMar DeRozan,SF,34,79,2989,650,1355,0.48,75,225,0.333,575,1130,0.509,522,612,0.853,43,297,340,421,90,45,135,161,1897,7.0,2.2,9.2,2023
Moussa Diabaté,C,22,11,64,10,19,0.526,0,0,0.0,10,19,0.526,9,14,0.643,15,9,24,4,5,1,2,4,29,0.2,0.1,0.3,2023
Mamadi Diakite,PF,27,6,24,4,6,0.667,0,1,0.0,4,5,0.8,4,6,0.667,1,3,4,2,1,1,1,2,12,0.1,0.0,0.1,2023
Hamidou Diallo,SG,25,2,5,1,2,0.5,0,0,0.0,1,2,0.5,0,0,0.0,2,0,2,1,2,0,1,1,2,0.0,0.0,0.0,2023
Gradey Dick,SG,20,60,1268,189,445,0.425,88,241,0.365,101,204,0.495,44,51,0.863,27,105,132,68,34,2,50,87,510,-0.1,0.4,0.3,2023
Ousmane Dieng,PF,20,33,365,49,116,0.422,21,70,0.3,28,46,0.609,14,16,0.875,10,41,51,37,8,5,19,22,133,0.0,0.4,0.4,2023
Spencer Dinwiddie,PG,30,76,2152,251,640,0.392,124,368,0.337,127,272,0.467,169,210,0.805,30,175,205,356,51,22,91,138,795,2.3,1.3,3.6,2023
Donte DiVincenzo,SG,27,81,2360,445,1004,0.443,283,705,0.401,162,299,0.542,86,114,0.754,63,234,297,216,107,36,113,166,1259,3.6,3.0,6.6,2023
Luka Dončić,PG,24,70,2624,804,1652,0.487,284,744,0.382,520,908,0.573,478,608,0.786,59,588,647,686,99,38,282,149,2370,8.5,3.5,12.0,2023
Luguentz Dort,SF,24,79,2246,288,657,0.438,156,396,0.394,132,261,0.506,128,155,0.826,74,210,284,113,72,47,74,228,860,2.0,2.5,4.6,2023
Ayo Dosunmu,SG,24,76,2212,360,719,0.501,119,295,0.403,241,424,0.568,85,105,0.81,54,162,216,242,68,36,103,166,924,2.6,1.5,4.1,2023
Jeff Dowtin,PG,26,12,142,20,36,0.556,9,19,0.474,11,17,0.647,3,4,0.75,3,17,20,27,7,1,5,1,52,0.4,0.2,0.6,2023
Henri Drell,SF,23,4,30,4,10,0.4,2,6,0.333,2,4,0.5,1,2,0.5,1,3,4,4,2,1,2,6,11,0.0,0.0,0.0,2023
Andre Drummond,C,30,79,1351,267,480,0.556,0,3,0.0,267,477,0.56,129,218,0.592,265,443,708,37,73,48,81,140,663,2.3,2.6,4.9,2023
Chris Duarte,SF,26,59,719,80,210,0.381,44,127,0.346,36,83,0.434,26,33,0.788,26,80,106,44,28,8,26,80,230,0.0,0.7,0.7,2023
David Duke Jr.,SG,24,4,51,10,18,0.556,3,6,0.5,7,12,0.583,3,3,1.0,2,8,10,5,2,0,3,4,26,0.1,0.0,0.1,2023
Kris Dunn,PG,29,66,1249,147,313,0.47,41,111,0.369,106,202,0.525,22,32,0.688,50,139,189,254,68,28,79,135,357,1.1,0.9,2.0,2023
Kevin Durant,PF,35,75,2791,751,1436,0.523,168,407,0.413,583,1029,0.567,362,423,0.856,41,454,495,378,69,91,244,133,2032,5.1,3.2,8.3,2023
Jalen Duren,C,20,61,1777,349,564,0.619,0,4,0.0,349,560,0.623,143,181,0.79,192,517,709,147,33,47,129,192,841,3.0,1.8,4.8,2023
Tari Eason,PF,22,22,480,88,189,0.466,18,50,0.36,70,139,0.504,21,33,0.636,46,107,153,27,31,19,20,51,215,0.3,1.0,1.3,2023
Anthony Edwards,SG,22,79,2770,718,1558,0.461,190,532,0.357,528,1026,0.515,423,506,0.836,52,378,430,405,101,42,241,141,2049,2.9,4.7,7.5,2023
Kessler Edwards,SF,23,54,275,34,82,0.415,20,52,0.385,14,30,0.467,5,9,0.556,9,33,42,15,10,4,4,26,93,0.2,0.3,0.5,2023
Keon Ellis,SG,24,57,978,107,232,0.461,70,168,0.417,37,64,0.578,26,35,0.743,32,92,124,85,51,29,37,112,310,1.1,1.2,2.3,2023
Joel Embiid,C,29,39,1309,450,851,0.529,54,139,0.388,396,712,0.556,399,452,0.883,95,335,430,219,46,66,150,112,1353,5.2,2.3,7.5,2023
Drew Eubanks,C,26,75,1169,152,253,0.601,3,3,1.0,149,250,0.596,72,93,0.774,103,219,322,63,27,61,61,115,379,1.6,1.6,3.1,2023
Tosan Evbuomwan,SF,22,17,367,36,71,0.507,12,32,0.375,24,39,0.615,17,25,0.68,18,42,60,16,6,5,9,23,101,0.4,0.2,0.5,2023
Dante Exum,PG,28,55,1088,161,302,0.533,53,108,0.491,108,194,0.557,53,68,0.779,25,124,149,157,22,5,49,85,428,2.1,0.8,2.9,2023
Bruno Fernando,C,25,45,682,109,187,0.583,0,4,0.0,109,183,0.596,64,96,0.667,59,134,193,46,25,28,44,107,282,0.8,0.7,1.5,2023
Dorian Finney-Smith,PF,30,68,1934,215,511,0.421,117,336,0.348,98,175,0.56,33,46,0.717,109,208,317,107,56,38,59,150,580,1.0,1.6,2.6,2023
Adam Flagler,SG,24,2,14,1,7,0.143,1,6,0.167,0,1,0.0,0,0,0.0,0,0,0,4,0,0,0,0,3,0.0,0.0,0.0,2023
Malachi Flynn,PG,25,69,876,136,325,0.418,56,169,0.331,80,156,0.513,52,71,0.732,21,93,114,130,38,8,63,66,380,-0.1,0.6,0.5,2023
Simone Fontecchio,SF,28,66,1644,252,548,0.46,134,334,0.401,118,214,0.551,54,66,0.818,64,182,246,101,44,23,68,110,692,1.5,0.6,2.1,2023
Jordan Ford,PG,25,6,22,4,7,0.571,2,3,0.667,2,4,0.5,2,2,1.0,0,2,2,2,0,0,1,0,12,0.1,0.0,0.1,2023
Trent Forrest,SG,25,38,414,34,90,0.378,2,10,0.2,32,80,0.4,13,17,0.765,11,40,51,92,11,3,20,25,83,0.1,0.1,0.2,2023
Evan Fournier,SG,31,32,580,79,221,0.357,33,130,0.254,46,91,0.505,29,36,0.806,5,53,58,48,29,7,21,48,220,-0.5,0.4,-0.1,2023
De'Aaron Fox,PG,26,74,2659,720,1549,0.465,214,580,0.369,506,969,0.522,312,423,0.738,67,273,340,418,150,31,194,193,1966,3.3,3.2,6.5,2023
Javon Freeman-Liberty,PG,24,22,403,55,124,0.444,10,42,0.238,45,82,0.549,33,36,0.917,16,54,70,40,10,4,25,28,153,0.1,0.2,0.2,2023
Alex Fudge,SF,20,6,40,6,15,0.4,1,5,0.2,5,10,0.5,2,2,1.0,4,1,5,0,3,0,2,2,15,0.0,0.0,0.0,2023
Markelle Fultz,PG,25,43,910,154,326,0.472,4,18,0.222,150,308,0.487,23,33,0.697,56,82,138,120,42,15,50,65,335,0.0,1.3,1.3,2023
Andrew Funk,SG,24,5,13,0,4,0.0,0,3,0.0,0,1,0.0,0,0,0.0,0,0,0,0,1,1,0,0,0,-0.1,0.0,-0.1,2023
Wenyen Gabriel,PF,26,5,81,8,22,0.364,1,6,0.167,7,16,0.438,0,5,0.0,7,18,25,3,2,2,8,10,17,-0.3,0.1,-0.2,2023
Daniel Gafford,C,25,74,1815,348,480,0.725,0,0,0.0,348,480,0.725,118,175,0.674,195,367,562,115,65,153,74,227,814,5.2,2.5,7.8,2023
Danilo Gallinari,PF,35,49,630,83,190,0.437,30,93,0.323,53,97,0.546,84,98,0.857,20,88,108,55,14,6,23,50,280,1.0,0.3,1.3,2023
Darius Garland,PG,24,57,1901,375,841,0.446,132,356,0.371,243,485,0.501,146,175,0.834,30,122,152,373,74,7,176,95,1028,0.7,2.0,2.7,2023
Usman Garuba,PF,21,6,18,1,6,0.167,0,1,0.0,1,5,0.2,1,2,0.5,3,4,7,1,1,3,2,2,3,-0.1,0.0,0.0,2023
Luka Garza,C,25,25,122,36,75,0.48,9,32,0.281,27,43,0.628,18,25,0.72,19,12,31,4,4,1,6,24,99,0.2,0.2,0.4,2023
Kaiser Gates,SF,27,1,7,0,4,0.0,0,2,0.0,0,2,0.0,0,0,0.0,0,1,1,0,0,0,0,0,0,-0.1,0.0,-0.1,2023
Keyonte George,PG,20,75,2023,319,815,0.391,147,440,0.334,172,375,0.459,189,223,0.848,15,196,211,332,36,7,188,91,974,-0.4,0.1,-0.3,2023
Paul George,PF,33,74,2502,582,1236,0.471,243,588,0.413,339,648,0.523,264,291,0.907,37,351,388,262,113,37,153,202,1671,4.4,2.8,7.3,2023
Taj Gibson,PF,38,20,204,15,37,0.405,2,10,0.2,13,27,0.481,2,2,1.0,12,25,37,11,3,7,5,31,34,0.0,0.2,0.2,2023
Josh Giddey,SG,21,80,2011,402,847,0.475,82,243,0.337,320,604,0.53,100,124,0.806,111,403,514,386,51,44,168,111,986,1.4,2.9,4.3,2023
Harry Giles,C,25,23,100,23,50,0.46,3,14,0.214,20,36,0.556,7,13,0.538,12,18,30,6,2,3,6,15,56,0.0,0.1,0.1,2023
Shai Gilgeous-Alexander,PG,25,75,2553,796,1487,0.535,95,269,0.353,701,1218,0.576,567,649,0.874,65,350,415,465,150,67,162,184,2254,10.5,4.2,14.6,2023
Anthony Gill,PF,31,50,466,75,160,0.469,10,41,0.244,65,119,0.546,29,36,0.806,37,57,94,34,13,11,23,48,189,0.1,0.2,0.4,2023
Collin Gillespie,PG,24,24,225,32,69,0.464,15,38,0.395,17,31,0.548,8,12,0.667,1,20,21,27,13,0,14,24,87,0.1,0.3,0.4,2023
Jacob Gilyard,PG,25,41,699,60,150,0.4,51,126,0.405,9,24,0.375,2,2,1.0,9,37,46,137,33,5,30,39,173,0.8,0.6,1.4,2023
Rudy Gobert,C,31,76,2593,406,614,0.661,0,3,0.0,406,611,0.664,249,390,0.638,285,697,982,102,52,162,118,238,1061,5.8,5.8,11.6,2023
Jordan Goodwin,PG,25,57,1055,141,382,0.369,42,141,0.298,99,241,0.411,44,59,0.746,88,165,253,155,48,18,56,76,368,-0.2,1.4,1.2,2023
Aaron Gordon,PF,28,73,2297,398,716,0.556,40,138,0.29,358,578,0.619,177,269,0.658,174,297,471,259,56,45,105,142,1013,4.5,2.6,7.1,2023
Eric Gordon,SG,35,68,1893,274,618,0.443,150,397,0.378,124,221,0.561,51,64,0.797,16,106,122,139,66,30,73,79,749,1.0,1.5,2.5,2023
Devonte' Graham,PG,28,23,313,38,108,0.352,25,83,0.301,13,25,0.52,13,16,0.813,5,31,36,49,9,2,17,14,114,-0.1,0.2,0.1,2023
Jerami Grant,PF,29,54,1830,383,850,0.451,111,276,0.402,272,574,0.474,255,312,0.817,37,154,191,152,45,34,116,117,1132,1.7,1.0,2.7,2023
RaiQuan Gray,PF,24,3,39,10,17,0.588,3,7,0.429,7,10,0.7,0,0,0.0,2,5,7,6,1,1,1,0,23,0.1,0.0,0.2,2023
A.J. Green,SG,24,56,614,83,196,0.423,69,169,0.408,14,27,0.519,17,19,0.895,9,55,64,30,9,4,12,49,252,0.7,0.3,1.1,2023
Danny Green,SG,36,2,18,0,2,0.0,0,1,0.0,0,1,0.0,0,0,0.0,0,2,2,1,1,0,0,1,0,0.0,0.0,0.0,2023
Draymond Green,PF,33,55,1490,185,372,0.497,51,129,0.395,134,243,0.551,54,74,0.73,76,322,398,332,55,47,135,166,475,1.4,2.2,3.6,2023
Jalen Green,SG,21,82,2601,563,1332,0.423,201,605,0.332,362,727,0.498,283,352,0.804,41,382,423,291,66,28,191,115,1610,0.2,2.9,3.1,2023
Javonte Green,SF,30,9,230,45,75,0.6,10,27,0.37,35,48,0.729,10,13,0.769,20,47,67,5,10,8,7,19,110,0.5,0.3,0.9,2023
Jeff Green,PF,37,78,1307,167,366,0.456,53,160,0.331,114,206,0.553,122,149,0.819,46,132,178,70,16,31,46,100,509,1.4,1.2,2.6,2023
Josh Green,SG,23,57,1505,179,374,0.479,72,187,0.385,107,187,0.572,39,57,0.684,40,144,184,130,47,9,60,107,469,1.0,1.2,2.2,2023
AJ Griffin,SF,20,20,171,18,62,0.29,10,39,0.256,8,23,0.348,2,2,1.0,2,16,18,5,1,2,8,6,48,-0.4,0.0,-0.4,2023
Quentin Grimes,SG,23,51,1025,122,328,0.372,81,240,0.338,41,88,0.466,34,45,0.756,15,85,100,66,35,7,28,75,359,0.3,1.0,1.3,2023
Mouhamadou Gueye,PF,25,11,120,11,38,0.289,0,3,0.0,11,35,0.314,4,9,0.444,12,11,23,5,3,18,12,15,26,-0.5,0.2,-0.4,2023
Mouhamed Gueye,PF,21,6,73,8,23,0.348,3,9,0.333,5,14,0.357,5,6,0.833,10,12,22,4,5,4,1,13,24,0.1,0.1,0.2,2023
Rui Hachimura,PF,25,68,1826,363,676,0.537,98,232,0.422,265,444,0.597,99,134,0.739,58,236,294,81,41,25,46,101,923,2.7,1.5,4.1,2023
Ashton Hagans,PG,24,19,316,29,71,0.408,8,25,0.32,21,46,0.457,14,17,0.824,14,31,45,54,11,9,30,40,80,-0.2,0.3,0.0,2023
Tyrese Haliburton,PG,23,69,2224,500,1048,0.477,195,535,0.364,305,513,0.595,194,227,0.855,35,236,271,752,83,48,159,75,1389,7.6,1.5,9.0,2023
R.J. Hampton,PG,22,8,76,4,14,0.286,1,8,0.125,3,6,0.5,1,2,0.5,2,4,6,8,0,0,3,8,10,-0.1,0.0,-0.1,2023
Tim Hardaway Jr.,SF,31,79,2120,392,976,0.402,211,597,0.353,181,379,0.478,144,169,0.852,22,232,254,139,42,6,69,106,1139,0.8,1.4,2.2,2023
James Harden,PG,34,72,2470,352,822,0.428,186,488,0.381,166,334,0.497,302,344,0.878,34,335,369,614,77,57,185,127,1192,5.9,2.5,8.4,2023
Jaden Hardy,SG,21,73,989,195,479,0.407,81,224,0.362,114,255,0.447,59,76,0.776,20,111,131,109,22,4,62,80,530,-0.4,0.7,0.3,2023
Ron Harper Jr.,PF,23,1,4,0,0,0.0,0,0,0.0,0,0,0.0,0,0,0.0,0,0,0,1,0,0,0,2,0,0.0,0.0,0.0,2023
Gary Harris,SG,29,54,1297,131,297,0.441,76,205,0.371,55,92,0.598,34,45,0.756,24,67,91,87,49,14,31,91,372,1.1,1.5,2.7,2023
Joe Harris,SG,32,16,170,14,39,0.359,10,30,0.333,4,9,0.444,1,2,0.5,3,10,13,10,3,2,4,19,39,0.0,0.0,0.0,2023
Kevon Harris,SG,26,2,6,2,3,0.667,0,0,0.0,2,3,0.667,0,0,0.0,0,2,2,1,0,0,1,3,4,0.0,0.0,0.0,2023
Tobias Harris,PF,31,70,2368,463,951,0.487,91,258,0.353,372,693,0.537,187,213,0.878,80,373,453,217,70,46,93,115,1204,3.2,2.7,5.9,2023
Shaquille Harrison,SG,30,3,6,1,2,0.5,0,0,0.0,1,2,0.5,0,0,0.0,0,2,2,0,0,1,0,0,2,0.0,0.0,0.0,2023
Josh Hart,SF,28,81,2707,295,679,0.434,80,258,0.31,215,421,0.511,91,115,0.791,128,547,675,331,75,23,118,171,761,2.0,3.6,5.7,2023
Isaiah Hartenstein,C,25,75,1896,235,365,0.644,1,3,0.333,234,362,0.646,111,157,0.707,244,382,626,188,87,85,93,210,582,4.6,3.5,8.1,2023
Sam Hauser,SF,26,79,1741,249,558,0.446,197,465,0.424,52,93,0.559,17,19,0.895,45,231,276,82,40,25,32,99,712,2.7,2.1,4.9,2023
Jordan Hawkins,SG,21,67,1160,174,456,0.382,109,298,0.366,65,158,0.411,67,80,0.838,29,119,148,70,19,7,40,72,524,0.3,1.0,1.3,2023
Jaxson Hayes,C,23,70,877,126,175,0.72,0,8,0.0,126,167,0.754,51,82,0.622,69,142,211,33,34,29,43,123,303,1.4,1.1,2.5,2023
Killian Hayes,PG,22,42,1008,117,283,0.413,22,74,0.297,95,209,0.455,33,50,0.66,11,108,119,205,36,20,51,75,289,0.0,0.7,0.7,2023
Gordon Hayward,SF,33,51,1245,187,403,0.464,37,90,0.411,150,313,0.479,89,120,0.742,38,143,181,158,40,13,66,67,500,0.6,0.9,1.5,2023
Scoot Henderson,PG,19,62,1765,307,797,0.385,87,268,0.325,220,529,0.416,167,204,0.819,53,141,194,336,48,13,212,195,868,-2.5,0.9,-1.7,2023
Taylor Hendricks,PF,20,40,856,108,240,0.45,53,140,0.379,55,100,0.55,23,29,0.793,46,139,185,32,28,30,27,77,292,0.7,0.6,1.2,2023
Tyler Herro,SG,24,42,1407,324,735,0.441,132,333,0.396,192,402,0.478,95,111,0.856,19,203,222,188,30,3,93,63,875,0.4,1.6,2.0,2023
Buddy Hield,SF,31,84,2160,371,850,0.436,219,568,0.386,152,282,0.539,52,59,0.881,61,208,269,236,70,42,103,169,1013,1.9,1.6,3.5,2023
Haywood Highsmith,PF,27,66,1366,153,329,0.465,76,192,0.396,77,137,0.562,23,36,0.639,65,145,210,70,53,30,34,117,405,1.1,1.9,3.1,2023
Nate Hinton,SG,24,15,75,11,26,0.423,7,14,0.5,4,12,0.333,4,5,0.8,7,15,22,10,3,2,3,11,33,0.2,0.1,0.3,2023
D'Moi Hodge,SG,25,7,41,5,15,0.333,3,12,0.25,2,3,0.667,1,2,0.5,0,0,0,5,1,1,1,4,14,0.0,0.0,0.0,2023
Aaron Holiday,PG,27,78,1269,186,417,0.446,84,217,0.387,102,200,0.51,58,63,0.921,23,100,123,140,42,6,53,125,514,1.3,1.2,2.5,2023
Jrue Holiday,PG,33,69,2263,331,689,0.48,138,322,0.429,193,367,0.526,60,72,0.833,84,289,373,333,61,53,124,108,860,3.3,3.0,6.3,2023
Justin Holiday,SG,34,58,862,88,194,0.454,55,136,0.404,33,58,0.569,3,4,0.75,9,62,71,67,36,9,14,69,234,0.9,0.9,1.8,2023
Richaun Holmes,C,30,40,555,82,147,0.558,1,3,0.333,81,144,0.563,34,47,0.723,71,111,182,25,11,19,24,74,199,0.8,0.5,1.3,2023
Chet Holmgren,C,21,82,2413,505,953,0.53,129,349,0.37,376,604,0.623,218,275,0.793,129,519,648,200,53,190,131,197,1357,4.6,4.4,8.9,2023
Jalen Hood-Schifino,SG,20,21,109,10,45,0.222,2,15,0.133,8,30,0.267,12,20,0.6,2,11,13,8,3,2,9,13,34,-0.6,0.1,-0.5,2023
Al Horford,C,37,65,1740,214,419,0.511,108,258,0.419,106,161,0.658,26,30,0.867,82,331,413,168,38,62,48,93,562,3.5,2.7,6.2,2023
Talen Horton-Tucker,PG,23,51,1009,184,465,0.396,60,182,0.33,124,283,0.438,88,109,0.807,21,100,121,177,45,19,65,94,516,0.3,0.5,0.8,2023
Danuel House Jr.,SF,30,34,509,47,105,0.448,15,50,0.3,32,55,0.582,35,46,0.761,16,42,58,28,15,5,19,45,144,0.3,0.4,0.7,2023
Caleb Houstan,SF,21,59,815,80,206,0.388,72,193,0.373,8,13,0.615,21,26,0.808,28,56,84,29,15,4,16,61,253,0.7,0.8,1.5,2023
Jett Howard,SF,20,18,67,10,30,0.333,7,25,0.28,3,5,0.6,2,4,0.5,1,6,7,6,2,2,3,4,29,-0.1,0.1,0.0,2023
Kevin Huerter,SG,25,64,1562,248,560,0.443,123,341,0.361,125,219,0.571,36,47,0.766,38,186,224,166,45,23,53,135,655,1.5,1.4,2.9,2023
Jay Huff,C,25,20,49,9,15,0.6,3,9,0.333,6,6,1.0,2,2,1.0,2,9,11,2,2,3,1,9,23,0.1,0.1,0.2,2023
De'Andre Hunter,SF,26,57,1681,304,663,0.459,117,304,0.385,187,359,0.521,166,196,0.847,31,191,222,87,40,16,83,146,891,1.6,0.6,2.2,2023
Matthew Hurt,PF,23,8,113,12,34,0.353,5,20,0.25,7,14,0.5,3,3,1.0,9,7,16,4,3,3,2,8,32,0.0,0.1,0.1,2023
Bones Hyland,PG,23,37,540,97,251,0.386,44,135,0.326,53,116,0.457,18,23,0.783,5,50,55,93,26,4,44,51,256,-0.5,0.5,0.0,2023
Joe Ingles,SF,36,68,1169,99,227,0.436,70,161,0.435,29,66,0.439,28,34,0.824,18,124,142,203,43,5,67,88,296,1.1,1.5,2.6,2023
Brandon Ingram,SF,26,64,2103,500,1017,0.492,86,242,0.355,414,775,0.534,246,307,0.801,43,281,324,363,50,40,163,145,1332,2.7,2.4,5.1,2023
Kyrie Irving,SG,31,58,2030,562,1131,0.497,173,421,0.411,389,710,0.548,190,210,0.905,44,246,290,299,74,28,106,112,1487,4.9,2.0,6.9,2023
Jonathan Isaac,PF,26,58,914,146,286,0.51,42,112,0.375,104,174,0.598,59,82,0.72,73,187,260,30,43,70,27,64,393,1.5,2.1,3.6,2023
Jaden Ivey,SG,21,77,2217,417,973,0.429,124,369,0.336,293,604,0.485,227,303,0.749,86,178,264,296,57,41,190,204,1185,-0.5,1.0,0.5,2023
Andre Jackson Jr.,SG,22,57,572,50,100,0.5,17,46,0.37,33,54,0.611,8,11,0.727,43,70,113,50,16,6,28,92,125,0.5,0.5,1.0,2023
GG Jackson II,PF,19,48,1233,241,563,0.428,102,286,0.357,139,277,0.502,115,153,0.752,53,143,196,59,28,24,65,64,699,0.2,1.1,1.2,2023
Isaiah Jackson,C,22,59,771,155,233,0.665,0,4,0.0,155,229,0.677,73,102,0.716,94,144,238,50,34,61,39,137,383,2.2,1.1,3.3,2023
Jaren Jackson Jr.,C,24,66,2124,516,1162,0.444,117,366,0.32,399,796,0.501,337,417,0.808,85,280,365,154,80,106,160,235,1486,0.2,2.8,3.0,2023
Justin Jackson,SF,28,2,1,0,0,0.0,0,0,0.0,0,0,0.0,0,0,0.0,0,0,0,0,0,0,0,0,0,0.0,0.0,0.0,2023
Quenton Jackson,PG,25,3,11,0,1,0.0,0,0,0.0,0,1,0.0,2,2,1.0,0,4,4,2,1,0,0,1,2,0.0,0.0,0.0,2023
Reggie Jackson,PG,33,82,1817,326,756,0.431,102,284,0.359,224,472,0.475,79,98,0.806,33,122,155,308,44,13,106,149,833,0.6,1.5,2.1,2023
Trayce Jackson-Davis,PF,23,68,1130,233,332,0.702,0,1,0.0,233,331,0.704,74,132,0.561,135,206,341,82,29,76,49,108,540,3.2,1.6,4.8,2023
LeBron James,PF,39,71,2504,685,1269,0.54,149,363,0.41,536,906,0.592,303,404,0.75,61,457,518,589,89,38,245,78,1822,5.7,2.8,8.5,2023
Jaime Jaquez Jr.,SF,22,75,2113,341,697,0.489,65,202,0.322,276,495,0.558,142,175,0.811,82,203,285,195,77,20,110,167,889,1.4,2.7,4.0,2023
DeJon Jarreau,SG,26,9,150,17,50,0.34,4,13,0.308,13,37,0.351,5,11,0.455,8,36,44,26,6,2,9,14,43,-0.2,0.2,0.0,2023
DaQuan Jeffries,SG,26,17,46,6,17,0.353,2,10,0.2,4,7,0.571,0,2,0.0,0,5,5,5,0,1,3,2,14,-0.1,0.0,-0.1,2023
Trey Jemison,C,24,25,573,75,136,0.551,0,0,0.0,75,136,0.551,21,25,0.84,64,70,134,27,12,28,34,69,171,0.3,0.6,0.9,2023
Ty Jerome,SG,26,2,15,2,4,0.5,0,1,0.0,2,3,0.667,0,0,0.0,1,0,1,3,0,0,1,2,4,0.0,0.0,0.0,2023
Isaiah Joe,SG,24,78,1445,222,485,0.458,147,353,0.416,75,132,0.568,45,52,0.865,32,148,180,99,46,22,47,87,636,1.9,1.6,3.5,2023
Cameron Johnson,PF,27,58,1599,276,619,0.446,138,353,0.391,138,266,0.519,86,109,0.789,55,196,251,138,49,15,57,105,776,2.0,1.3,3.3,2023
Jalen Johnson,SF,22,56,1889,359,702,0.511,71,200,0.355,288,502,0.574,107,147,0.728,74,414,488,203,67,47,101,133,896,2.1,1.7,3.8,2023
James Johnson,PF,36,9,47,3,10,0.3,0,2,0.0,3,8,0.375,2,2,1.0,1,3,4,8,5,1,5,9,8,-0.1,0.1,0.0,2023
Keldon Johnson,SF,24,69,2038,391,862,0.454,127,367,0.346,264,495,0.533,175,221,0.792,95,282,377,195,51,20,100,149,1084,1.5,1.5,3.0,2023
Keon Johnson,SG,21,5,61,8,21,0.381,4,10,0.4,4,11,0.364,11,12,0.917,3,4,7,3,3,1,5,5,31,0.0,0.1,0.1,2023
Keyontae Johnson,SF,23,9,66,5,16,0.313,1,3,0.333,4,13,0.308,0,0,0.0,4,6,10,4,1,0,4,5,11,-0.1,0.1,-0.1,2023
Nikola Jokić,C,28,79,2737,822,1411,0.583,83,231,0.359,739,1180,0.626,358,438,0.817,223,753,976,708,108,68,237,194,2085,12.0,5.1,17.0,2023
Colby Jones,SG,21,30,192,28,71,0.394,2,22,0.091,26,49,0.531,6,11,0.545,17,23,40,20,7,5,10,29,64,-0.2,0.2,0.0,2023
Damian Jones,C,28,39,270,43,72,0.597,3,14,0.214,40,58,0.69,18,21,0.857,20,42,62,15,7,13,13,27,107,0.4,0.4,0.8,2023
Derrick Jones Jr.,SF,26,76,1783,239,495,0.483,82,239,0.343,157,256,0.613,97,136,0.713,82,168,250,75,53,51,65,121,657,1.5,1.6,3.1,2023
Herbert Jones,SF,25,76,2321,293,588,0.498,114,273,0.418,179,315,0.568,137,158,0.867,74,198,272,199,105,62,93,224,837,3.3,3.0,6.3,2023
Mason Jones,SG,25,5,28,2,8,0.25,2,7,0.286,0,1,0.0,1,2,0.5,1,4,5,5,1,0,2,3,7,0.0,0.0,0.0,2023
Tre Jones,PG,24,77,2138,303,600,0.505,64,191,0.335,239,409,0.584,101,118,0.856,58,231,289,478,78,9,116,92,771,3.4,1.6,4.9,2023
Tyus Jones,PG,27,66,1933,326,666,0.489,106,256,0.414,220,410,0.537,32,40,0.8,20,159,179,485,71,18,66,48,790,3.9,0.7,4.5,2023
DeAndre Jordan,C,35,36,396,58,93,0.624,0,0,0.0,58,93,0.624,26,53,0.491,54,103,157,26,6,16,23,56,142,0.6,0.6,1.2,2023
Cory Joseph,PG,32,26,296,23,64,0.359,13,42,0.31,10,22,0.455,4,7,0.571,6,24,30,42,4,3,12,25,63,0.0,0.2,0.2,2023
Nikola Jović,PF,20,46,896,127,281,0.452,65,163,0.399,62,118,0.525,33,47,0.702,25,167,192,90,25,14,42,82,352,0.6,1.3,1.9,2023
Johnny Juzang,SG,22,20,372,51,110,0.464,32,77,0.416,19,33,0.576,10,14,0.714,7,29,36,23,4,2,13,29,144,0.4,0.0,0.4,2023
Luke Kennard,SG,27,39,999,141,315,0.448,107,238,0.45,34,77,0.442,40,45,0.889,11,102,113,136,20,2,54,39,429,1.4,0.7,2.1,2023
Walker Kessler,C,22,64,1493,229,350,0.654,4,19,0.211,225,331,0.68,56,93,0.602,165,316,481,60,30,154,66,132,518,2.4,1.7,4.1,2023
Braxton Key,SF,26,20,60,7,17,0.412,2,5,0.4,5,12,0.417,6,8,0.75,3,15,18,9,2,1,1,5,22,0.1,0.1,0.2,2023
Corey Kispert,SF,24,80,2067,386,794,0.486,184,480,0.383,202,314,0.643,114,157,0.726,30,195,225,156,41,16,98,141,1070,1.7,0.4,2.1,2023
Maxi Kleber,C,32,43,871,63,146,0.432,32,92,0.348,31,54,0.574,33,47,0.702,30,113,143,68,17,30,28,79,191,0.6,0.8,1.4,2023
Kevin Knox,SF,24,31,560,86,186,0.462,31,94,0.33,55,92,0.598,20,22,0.909,18,57,75,23,13,7,22,50,223,0.1,0.2,0.4,2023
John Konchar,SF,27,55,1173,88,208,0.423,38,120,0.317,50,88,0.568,21,25,0.84,72,185,257,110,51,51,46,76,235,0.5,1.7,2.2,2023
Furkan Korkmaz,SG,26,35,300,30,76,0.395,14,40,0.35,16,36,0.444,14,20,0.7,4,26,30,25,14,3,10,17,88,0.0,0.3,0.4,2023
Luke Kornet,C,28,63,983,142,203,0.7,1,1,1.0,141,202,0.698,49,54,0.907,118,143,261,67,23,61,21,77,334,3.5,1.6,5.1,2023
Vit Krejci,PG,23,22,541,51,104,0.49,28,68,0.412,23,36,0.639,5,6,0.833,11,41,52,50,13,6,20,48,135,0.5,0.1,0.6,2023
Jonathan Kuminga,PF,21,74,1949,456,862,0.529,53,165,0.321,403,697,0.578,223,299,0.746,92,263,355,163,55,36,122,169,1188,2.7,1.9,4.6,2023
Kyle Kuzma,PF,28,70,2281,608,1313,0.463,151,450,0.336,457,863,0.53,186,240,0.775,62,402,464,296,37,49,192,153,1553,-1.0,1.1,0.2,2023
Jock Landale,C,28,56,763,106,206,0.515,10,40,0.25,96,166,0.578,52,65,0.8,88,84,172,65,20,33,31,74,274,1.4,0.9,2.3,2023
Jake LaRavia,PF,22,35,806,118,303,0.389,53,156,0.34,65,147,0.442,90,109,0.826,51,77,128,58,29,12,45,69,379,0.3,0.8,1.0,2023
Zach LaVine,SG,28,25,872,170,376,0.452,59,169,0.349,111,207,0.536,88,103,0.854,8,121,129,98,21,8,52,57,487,0.8,0.6,1.5,2023
A.J. Lawson,SG,23,42,311,54,121,0.446,13,50,0.26,41,71,0.577,15,23,0.652,14,36,50,20,10,3,14,22,136,0.0,0.3,0.2,2023
Saben Lee,PG,24,24,185,20,55,0.364,2,16,0.125,18,39,0.462,29,39,0.744,9,22,31,30,7,3,8,13,71,0.2,0.2,0.4,2023
Alex Len,C,30,48,444,50,81,0.617,0,3,0.0,50,78,0.641,20,34,0.588,46,82,128,50,11,33,27,66,120,0.6,0.7,1.3,2023
Kawhi Leonard,SF,32,68,2330,610,1162,0.525,140,336,0.417,470,826,0.569,253,286,0.885,84,332,416,244,111,59,119,97,1613,6.0,2.9,8.9,2023
Caris LeVert,SG,29,68,1958,345,820,0.421,108,332,0.325,237,488,0.486,154,201,0.766,39,241,280,346,76,34,117,121,952,1.0,2.6,3.6,2023
Kira Lewis Jr.,PG,22,28,265,34,92,0.37,4,33,0.121,30,59,0.508,17,20,0.85,9,17,26,37,9,2,14,13,89,-0.2,0.2,0.0,2023
Maxwell Lewis,SF,21,34,103,4,21,0.19,1,9,0.111,3,12,0.25,2,3,0.667,2,2,4,6,2,1,10,5,11,-0.5,0.0,-0.4,2023
E.J. Liddell,PF,23,8,23,1,6,0.167,0,5,0.0,1,1,1.0,2,2,1.0,0,5,5,1,2,2,2,2,4,-0.1,0.1,0.0,2023
Damian Lillard,PG,33,73,2579,541,1277,0.424,220,622,0.354,321,655,0.49,473,514,0.92,36,284,320,508,72,18,193,134,1775,5.8,1.9,7.7,2023
Nassir Little,SF,23,45,458,57,124,0.46,21,70,0.3,36,54,0.667,17,20,0.85,14,61,75,21,10,10,14,39,152,0.3,0.4,0.7,2023
Dereck Lively II,C,19,55,1294,221,296,0.747,0,2,0.0,221,294,0.752,41,81,0.506,135,243,378,60,36,77,50,144,483,3.1,1.8,4.9,2023
Isaiah Livers,PF,25,23,469,40,116,0.345,22,77,0.286,18,39,0.462,12,18,0.667,15,33,48,25,13,5,16,43,114,-0.3,0.2,-0.1,2023
Chris Livingston,SF,20,21,90,11,22,0.5,1,5,0.2,10,17,0.588,3,4,0.75,3,18,21,5,2,0,5,15,26,0.0,0.1,0.1,2023
Kenneth Lofton Jr.,PF,21,21,199,36,78,0.462,7,24,0.292,29,54,0.537,17,26,0.654,12,26,38,33,6,5,14,24,96,0.1,0.2,0.3,2023
Kevon Looney,C,27,74,1195,139,233,0.597,0,1,0.0,139,232,0.599,56,83,0.675,143,276,419,133,28,29,50,155,334,2.5,1.6,4.0,2023
Brook Lopez,C,35,79,2411,366,755,0.485,148,404,0.366,218,351,0.621,110,134,0.821,117,292,409,127,43,189,79,191,990,3.1,2.8,5.9,2023
Robin Lopez,C,35,16,65,7,19,0.368,2,8,0.25,5,11,0.455,2,2,1.0,3,2,5,4,1,3,2,7,18,0.0,0.0,0.0,2023
Kevin Love,PF,35,55,924,158,359,0.44,84,244,0.344,74,115,0.643,85,108,0.787,59,279,338,115,18,10,48,97,485,1.7,1.6,3.3,2023
Kyle Lowry,PG,37,60,1690,163,377,0.432,98,250,0.392,65,127,0.512,63,75,0.84,34,160,194,253,59,21,85,146,487,1.6,1.9,3.5,2023
Seth Lundy,SF,23,9,52,4,17,0.235,3,13,0.231,1,4,0.25,3,4,0.75,1,6,7,0,0,0,1,6,14,-0.1,0.0,-0.1,2023
Trey Lyles,PF,28,58,1158,143,321,0.445,84,219,0.384,59,102,0.578,49,70,0.7,61,196,257,72,17,19,38,86,419,1.3,1.0,2.4,2023
Théo Maledon,PG,22,17,213,20,70,0.286,5,30,0.167,15,40,0.375,14,15,0.933,4,20,24,28,7,0,18,21,59,-0.6,0.1,-0.5,2023
Sandro Mamukelashvili,C,24,46,451,73,155,0.471,19,64,0.297,54,91,0.593,25,34,0.735,45,102,147,49,7,12,19,35,190,0.6,0.4,1.0,2023
Terance Mann,SG,27,75,1873,254,493,0.515,71,204,0.348,183,289,0.633,79,95,0.832,87,167,254,119,43,15,48,145,658,3.0,1.2,4.2,2023
Tre Mann,PG,22,41,987,145,316,0.459,47,126,0.373,98,190,0.516,45,59,0.763,20,129,149,165,51,3,65,48,382,0.4,0.8,1.2,2023
Boban Marjanović,C,35,14,71,18,34,0.529,0,2,0.0,18,32,0.563,9,14,0.643,7,25,32,6,1,2,5,5,45,0.1,0.1,0.2,2023
Lauri Markkanen,PF,26,55,1820,427,890,0.48,175,439,0.399,252,451,0.559,249,277,0.899,122,327,449,110,50,26,77,100,1278,5.2,0.9,6.2,2023
Naji Marshall,SF,26,66,1257,170,367,0.463,58,150,0.387,112,217,0.516,68,86,0.791,53,187,240,128,49,12,65,91,466,1.0,1.6,2.6,2023
Caleb Martin,SF,28,64,1756,241,559,0.431,81,232,0.349,160,327,0.489,77,99,0.778,74,207,281,143,47,29,77,126,640,0.2,2.2,2.4,2023
Cody Martin,SF,28,28,753,82,215,0.381,27,86,0.314,55,129,0.426,20,33,0.606,19,90,109,104,32,18,44,48,211,-0.7,0.5,-0.2,2023
KJ Martin,SF,23,60,746,97,181,0.536,8,28,0.286,89,153,0.582,22,41,0.537,41,90,131,51,22,12,32,100,224,0.3,0.8,1.1,2023
Garrison Mathews,SG,27,66,992,103,226,0.456,85,193,0.44,18,33,0.545,34,42,0.81,17,75,92,37,20,8,19,115,325,1.4,0.2,1.6,2023
Bennedict Mathurin,SF,21,59,1538,296,663,0.446,80,214,0.374,216,449,0.481,184,224,0.821,60,174,234,119,35,14,97,117,856,0.8,0.7,1.4,2023
Wesley Matthews,SG,37,36,413,34,97,0.351,24,69,0.348,10,28,0.357,18,24,0.75,9,44,53,23,16,11,8,43,110,0.2,0.3,0.4,2023
Tyrese Maxey,PG,23,70,2626,638,1419,0.45,212,569,0.373,426,850,0.501,328,378,0.868,36,222,258,433,69,33,116,151,1816,5.9,2.1,8.1,2023
Skylar Mays,PG,26,38,433,63,159,0.396,16,54,0.296,47,105,0.448,13,17,0.765,10,33,43,85,21,4,20,26,155,0.1,0.3,0.4,2023
Miles McBride,PG,23,68,1328,205,454,0.452,109,266,0.41,96,188,0.511,43,50,0.86,31,69,100,114,50,7,30,108,562,2.4,1.3,3.6,2023
CJ McCollum,PG,32,66,2159,484,1055,0.459,239,557,0.429,245,498,0.492,115,139,0.827,39,247,286,305,62,41,110,126,1322,3.5,2.4,5.9,2023
T.J. McConnell,PG,31,71,1291,330,593,0.556,18,44,0.409,312,549,0.568,49,62,0.79,36,155,191,390,72,8,108,79,727,2.8,1.1,3.9,2023
Jaden McDaniels,SF,23,72,2105,307,628,0.489,86,255,0.337,221,373,0.592,57,79,0.722,56,168,224,101,63,42,87,219,757,0.3,3.1,3.4,2023
Jalen McDaniels,SF,26,50,538,65,189,0.344,12,71,0.169,53,118,0.449,27,37,0.73,18,61,79,37,19,6,30,52,169,-1.1,0.3,-0.8,2023
Doug McDermott,SF,32,64,904,123,284,0.433,94,229,0.41,29,55,0.527,11,19,0.579,10,49,59,70,16,2,28,64,351,0.6,0.3,0.9,2023
JaVale McGee,C,36,46,339,79,132,0.598,1,7,0.143,78,125,0.624,26,45,0.578,42,84,126,17,14,20,34,46,185,0.1,0.6,0.7,2023
Bryce McGowens,SG,21,59,882,101,230,0.439,34,102,0.333,67,128,0.523,66,85,0.776,17,85,102,51,21,10,30,74,302,0.4,0.3,0.6,2023
Jordan McLaughlin,PG,27,56,626,70,145,0.483,42,89,0.472,28,56,0.5,13,18,0.722,18,54,72,110,35,7,19,31,195,1.4,1.1,2.5,2023
De'Anthony Melton,SG,25,38,1023,139,360,0.386,77,214,0.36,62,146,0.425,66,79,0.835,28,113,141,114,60,16,39,84,421,0.8,1.4,2.1,2023
Nathan Mensah,C,25,25,307,12,28,0.429,0,0,0.0,12,28,0.429,9,12,0.75,29,36,65,9,6,14,14,64,33,0.0,0.2,0.1,2023
Sam Merrill,SG,27,61,1069,158,393,0.402,143,354,0.404,15,39,0.385,26,28,0.929,22,98,120,108,19,4,19,72,485,1.9,0.9,2.8,2023
Chimezie Metu,C,26,51,859,123,244,0.504,28,94,0.298,95,150,0.633,58,64,0.906,41,153,194,46,43,16,52,71,332,0.5,1.1,1.5,2023
Vasilije Micić,PG,30,60,1176,159,370,0.43,43,154,0.279,116,216,0.537,61,75,0.813,14,74,88,262,31,7,99,68,422,-0.1,0.4,0.4,2023
Khris Middleton,SF,32,55,1487,317,643,0.493,94,247,0.381,223,396,0.563,100,120,0.833,40,217,257,292,51,15,127,141,828,1.9,1.4,3.4,2023
Brandon Miller,SF,21,74,2383,476,1083,0.44,184,493,0.373,292,590,0.495,143,173,0.827,60,255,315,175,66,42,132,184,1279,-0.3,1.0,0.8,2023
Jordan Miller,SF,24,8,28,5,9,0.556,1,2,0.5,4,7,0.571,2,2,1.0,3,2,5,0,0,0,1,2,13,0.1,0.0,0.1,2023
Leonard Miller,SF,20,17,52,13,20,0.65,2,5,0.4,11,15,0.733,1,2,0.5,5,15,20,8,2,1,1,5,29,0.2,0.1,0.3,2023
Dariq Whitehead,SF,19,2,24,1,5,0.2,0,3,0.0,1,2,0.5,1,2,0.5,0,4,4,3,0,1,0,0,3,0.0,0.0,0.0,2023
Patty Mills,PG,35,32,415,46,131,0.351,24,87,0.276,22,44,0.5,11,11,1.0,9,26,35,34,20,1,16,32,127,-0.3,0.4,0.1,2023
Shake Milton,SG,27,48,581,79,195,0.405,18,64,0.281,61,131,0.466,40,49,0.816,14,61,75,60,19,6,31,54,216,-0.2,0.8,0.6,2023
Justin Minaya,SF,24,34,381,22,74,0.297,12,49,0.245,10,25,0.4,5,9,0.556,30,26,56,21,9,10,9,35,61,-0.1,0.2,0.1,2023
Josh Minott,SF,21,32,91,17,36,0.472,4,10,0.4,13,26,0.5,12,14,0.857,4,13,17,8,5,5,2,10,50,0.2,0.2,0.4,2023
Davion Mitchell,PG,25,72,1101,146,323,0.452,57,158,0.361,89,165,0.539,30,42,0.714,19,76,95,134,17,3,43,85,379,0.8,0.6,1.3,2023
Donovan Mitchell,SG,27,55,1942,503,1089,0.462,182,494,0.368,321,595,0.539,275,318,0.865,46,234,280,333,101,30,154,118,1463,3.6,2.9,6.4,2023
Evan Mobley,PF,22,50,1532,320,552,0.58,22,59,0.373,298,493,0.604,123,171,0.719,111,357,468,160,45,72,90,134,785,2.8,2.7,5.5,2023
Isaiah Mobley,PF,24,10,72,10,24,0.417,3,10,0.3,7,14,0.5,0,1,0.0,3,7,10,6,2,0,2,6,23,0.0,0.1,0.0,2023
Malik Monk,SG,25,72,1872,396,893,0.443,148,423,0.35,248,470,0.528,170,205,0.829,28,184,212,370,45,39,150,156,1110,1.9,1.6,3.5,2023
Moses Moody,SG,21,66,1156,194,420,0.462,72,200,0.36,122,220,0.555,73,93,0.785,65,131,196,57,42,24,44,90,533,1.2,1.2,2.4,2023
Xavier Moon,SG,29,14,119,15,46,0.326,2,17,0.118,13,29,0.448,1,2,0.5,8,10,18,21,3,3,5,8,33,-0.2,0.1,-0.1,2023
Taze Moore,SG,25,4,40,8,19,0.421,1,7,0.143,7,12,0.583,1,2,0.5,4,4,8,5,2,0,3,4,18,0.0,0.0,0.0,2023
Wendell Moore Jr.,SG,22,25,75,9,18,0.5,0,6,0.0,9,12,0.75,0,0,0.0,0,12,12,6,5,1,4,5,18,-0.1,0.2,0.1,2023
Ja Morant,PG,24,9,318,80,170,0.471,14,51,0.275,66,119,0.555,52,64,0.813,6,44,50,73,7,5,27,19,226,0.5,0.3,0.8,2023
Marcus Morris,PF,34,49,817,116,264,0.439,48,119,0.403,68,145,0.469,36,44,0.818,23,111,134,36,15,13,30,74,316,0.2,0.8,1.0,2023
Markieff Morris,PF,34,26,216,23,68,0.338,15,42,0.357,8,26,0.308,5,6,0.833,4,35,39,16,5,3,12,12,66,-0.3,0.2,-0.1,2023
Monte Morris,PG,28,33,476,62,153,0.405,27,70,0.386,35,83,0.422,13,19,0.684,7,50,57,69,19,9,7,14,164,0.5,0.7,1.2,2023
Trey Murphy III,SF,23,57,1690,275,621,0.443,169,445,0.38,106,176,0.602,123,151,0.815,42,238,280,124,51,28,34,70,842,3.4,2.0,5.4,2023
Dejounte Murray,SG,27,78,2783,672,1463,0.459,201,554,0.363,471,909,0.518,208,262,0.794,62,354,416,502,111,24,201,138,1753,3.3,1.6,4.9,2023
Jamal Murray,PG,26,59,1861,474,986,0.481,145,341,0.425,329,645,0.51,157,184,0.853,42,200,242,384,57,39,125,104,1250,3.8,2.1,5.9,2023
Keegan Murray,SF,23,77,2588,443,975,0.454,183,511,0.358,260,464,0.56,103,124,0.831,106,314,420,129,79,59,64,205,1172,2.6,2.6,5.2,2023
Kris Murray,SF,23,62,1348,145,366,0.396,49,183,0.268,96,183,0.525,37,56,0.661,85,139,224,80,53,21,55,92,376,-0.4,1.0,0.7,2023
Mike Muscala,C,32,53,600,56,156,0.359,28,96,0.292,28,60,0.467,17,25,0.68,39,86,125,36,9,13,22,52,157,-0.2,0.3,0.1,2023
Svi Mykhailiuk,SF,26,41,413,57,137,0.416,42,108,0.389,15,29,0.517,6,9,0.667,11,40,51,35,11,1,12,19,162,0.5,0.4,0.9,2023
Larry Nance Jr.,C,31,61,1216,138,241,0.573,27,65,0.415,111,176,0.631,47,61,0.77,94,213,307,113,61,19,49,98,350,2.1,1.9,4.1,2023
Pete Nance,PF,23,8,27,1,6,0.167,1,1,1.0,0,5,0.0,0,2,0.0,0,3,3,0,1,0,1,2,3,-0.1,0.0,-0.1,2023
Andrew Nembhard,PG,24,68,1697,260,522,0.498,61,171,0.357,199,351,0.567,45,56,0.804,36,105,141,280,63,6,101,143,626,1.3,0.7,2.0,2023
Aaron Nesmith,SF,24,72,1995,315,635,0.496,140,334,0.419,175,301,0.581,107,137,0.781,63,212,275,108,65,49,64,241,877,2.8,1.3,4.1,2023
Georges Niang,PF,30,82,1831,284,632,0.449,149,396,0.376,135,236,0.572,51,60,0.85,22,256,278,98,30,18,72,192,768,0.5,2.0,2.4,2023
Daishen Nix,PG,21,15,50,9,24,0.375,6,17,0.353,3,7,0.429,3,6,0.5,1,2,3,6,5,0,5,2,27,-0.1,0.1,0.0,2023
Zeke Nnaji,PF,23,58,576,69,149,0.463,6,23,0.261,63,126,0.5,42,62,0.677,61,65,126,32,15,38,27,81,186,0.4,0.8,1.2,2023
Jaylen Nowell,SG,24,13,214,34,78,0.436,6,29,0.207,28,49,0.571,7,9,0.778,6,18,24,19,4,2,7,15,81,0.0,0.1,0.1,2023
Markquis Nowell,SG,24,1,4,0,1,0.0,0,0,0.0,0,1,0.0,2,2,1.0,2,0,2,2,1,0,0,0,2,0.0,0.0,0.1,2023
Frank Ntilikina,PG,25,5,43,1,9,0.111,1,8,0.125,0,1,0.0,2,2,1.0,1,5,6,4,0,0,1,4,5,-0.1,0.0,-0.1,2023
Jusuf Nurkić,C,29,76,2078,320,627,0.51,22,90,0.244,298,537,0.555,167,261,0.64,224,613,837,301,81,80,175,254,829,2.0,3.8,5.8,2023
Jordan Nwora,SF,25,52,712,138,299,0.462,44,131,0.336,94,168,0.56,44,53,0.83,28,121,149,62,26,13,53,48,364,-0.1,0.6,0.5,2023
Royce O'Neale,SF,30,79,1954,214,539,0.397,156,422,0.37,58,117,0.496,24,35,0.686,60,317,377,219,59,44,73,174,608,1.3,2.1,3.4,2023
Chuma Okeke,SF,25,47,432,40,112,0.357,23,82,0.28,17,30,0.567,4,7,0.571,18,62,80,20,9,7,16,19,107,-0.3,0.6,0.3,2023
Josh Okogie,SG,25,60,960,86,206,0.417,29,94,0.309,57,112,0.509,76,102,0.745,74,80,154,64,48,24,36,68,277,1.0,1.1,2.1,2023
Onyeka Okongwu,C,23,55,1405,223,365,0.611,23,69,0.333,200,296,0.676,92,116,0.793,145,231,376,74,26,60,45,162,561,3.5,1.0,4.5,2023
Isaac Okoro,SF,23,69,1887,235,480,0.49,84,215,0.391,151,265,0.57,93,137,0.679,67,139,206,132,57,34,54,140,647,2.1,2.0,4.2,2023
Kelly Olynyk,C,32,78,1759,276,497,0.555,60,155,0.387,216,342,0.632,150,180,0.833,108,303,411,347,74,30,152,230,762,3.5,1.4,4.9,2023
Eugene Omoruyi,SF,26,43,393,81,167,0.485,13,46,0.283,68,121,0.562,32,49,0.653,35,50,85,35,27,5,21,62,207,0.2,0.4,0.6,2023
Cedi Osman,SF,28,72,1269,184,384,0.479,86,221,0.389,98,163,0.601,35,52,0.673,25,155,180,119,36,11,47,107,489,1.0,0.9,1.9,2023
Kelly Oubre Jr.,SF,28,68,2055,387,878,0.441,101,325,0.311,286,553,0.517,174,232,0.75,94,247,341,101,77,47,87,194,1049,0.6,2.4,3.0,2023
Chris Paul,PG,38,58,1531,206,467,0.441,78,210,0.371,128,257,0.498,43,52,0.827,18,207,225,393,70,6,76,108,533,2.6,1.7,4.3,2023
Cameron Payne,PG,29,78,1304,208,481,0.432,104,267,0.39,104,214,0.486,58,67,0.866,21,96,117,205,42,11,66,126,578,1.4,1.0,2.4,2023
Gary Payton II,SG,31,44,680,103,183,0.563,20,55,0.364,83,128,0.648,14,23,0.609,46,67,113,48,39,18,27,77,240,0.9,0.9,1.8,2023
Mãozinha Pereira,SF,23,7,122,18,35,0.514,5,13,0.385,13,22,0.591,7,10,0.7,11,26,37,2,6,4,5,10,48,0.1,0.2,0.3,2023
Drew Peterson,PF,24,3,23,4,6,0.667,3,5,0.6,1,1,1.0,0,0,0.0,0,1,1,1,2,0,1,1,11,0.1,0.0,0.1,2023
Filip Petrušev,C,23,3,10,1,2,0.5,0,0,0.0,1,2,0.5,1,2,0.5,0,1,1,0,0,0,0,1,3,0.0,0.0,0.0,2023
Julian Phillips,SF,20,40,323,32,77,0.416,12,38,0.316,20,39,0.513,13,19,0.684,12,24,36,13,7,7,10,40,89,0.0,0.2,0.2,2023
Jalen Pickett,SG,24,27,122,15,35,0.429,9,25,0.36,6,10,0.6,3,4,0.75,1,13,14,21,4,0,9,13,42,0.0,0.1,0.2,2023
Scotty Pippen Jr.,PG,23,21,527,100,203,0.493,30,72,0.417,70,131,0.534,41,55,0.745,22,45,67,98,36,10,56,60,271,0.3,0.7,1.0,2023
Mason Plumlee,C,33,46,674,87,153,0.569,0,6,0.0,87,147,0.592,70,99,0.707,60,174,234,55,14,17,36,68,244,1.2,0.9,2.0,2023
Brandin Podziemski,SG,20,74,1968,271,597,0.454,90,234,0.385,181,363,0.499,50,79,0.633,118,309,427,273,61,14,88,122,682,2.1,2.0,4.1,2023
Jakob Poeltl,C,28,50,1319,248,378,0.656,0,0,0.0,248,378,0.656,59,107,0.551,146,283,429,127,35,76,77,149,555,2.4,1.4,3.8,2023
Aleksej Pokusevski,PF,22,28,405,49,121,0.405,18,55,0.327,31,66,0.47,30,41,0.732,17,72,89,35,15,13,19,22,146,0.0,0.4,0.4,2023
Jordan Poole,SG,24,78,2346,490,1186,0.413,184,564,0.326,306,622,0.492,192,219,0.877,32,180,212,343,86,25,188,244,1356,-1.5,0.8,-0.6,2023
Craig Porter Jr.,PG,23,51,649,116,228,0.509,12,34,0.353,104,194,0.536,41,56,0.732,21,88,109,118,21,15,45,40,285,0.6,0.9,1.5,2023
Jontay Porter,PF,24,26,360,40,104,0.385,20,60,0.333,20,44,0.455,15,18,0.833,26,56,82,60,20,20,21,35,115,0.2,0.4,0.7,2023
Michael Porter Jr.,SF,25,81,2565,522,1079,0.484,220,554,0.397,302,525,0.575,92,110,0.836,106,459,565,122,42,53,92,148,1356,3.1,3.1,6.2,2023
Otto Porter Jr.,SF,30,15,174,14,33,0.424,8,23,0.348,6,10,0.6,3,3,1.0,6,23,29,8,5,5,2,19,39,0.1,0.1,0.3,2023
Bobby Portis,PF,28,82,2008,466,918,0.508,100,246,0.407,366,672,0.545,98,124,0.79,142,465,607,104,68,34,91,189,1130,2.1,2.6,4.7,2023
Kristaps Porziņģis,C,28,57,1690,388,752,0.516,110,293,0.375,278,459,0.606,259,302,0.858,97,312,409,115,42,111,89,156,1145,4.9,3.0,7.9,2023
Micah Potter,PF,25,16,186,19,40,0.475,9,21,0.429,10,19,0.526,6,8,0.75,10,33,43,6,4,6,5,14,53,0.2,0.1,0.3,2023
Dwight Powell,C,32,63,836,72,106,0.679,1,3,0.333,71,103,0.689,63,89,0.708,97,117,214,84,26,20,32,113,208,2.2,0.9,3.1,2023
Norman Powell,SG,30,76,1990,373,768,0.486,167,384,0.435,206,384,0.536,143,172,0.831,16,179,195,82,43,22,66,137,1056,2.8,1.3,4.1,2023
Jason Preston,PG,24,7,71,6,19,0.316,0,3,0.0,6,16,0.375,0,0,0.0,6,11,17,16,2,1,2,3,12,0.0,0.0,0.0,2023
Joshua Primo,SG,21,2,10,1,3,0.333,0,1,0.0,1,2,0.5,0,0,0.0,1,0,1,0,0,1,4,0,2,-0.1,0.0,-0.1,2023
Taurean Prince,PF,29,78,2108,253,572,0.442,141,356,0.396,112,216,0.519,50,68,0.735,21,209,230,119,58,35,73,146,697,0.3,1.7,1.9,2023
Payton Pritchard,PG,26,82,1825,297,635,0.468,147,382,0.385,150,253,0.593,46,56,0.821,70,195,265,281,39,6,61,106,787,4.2,1.9,6.1,2023
Olivier-Maxence Prosper,PF,21,40,336,40,104,0.385,13,45,0.289,27,59,0.458,28,41,0.683,25,54,79,22,7,4,8,20,121,0.2,0.3,0.5,2023
Trevelin Queen,SG,26,14,165,14,38,0.368,3,17,0.176,11,21,0.524,9,12,0.75,3,17,20,18,7,5,7,15,40,-0.1,0.3,0.2,2023
Neemias Queta,C,24,28,333,67,104,0.644,0,0,0.0,67,104,0.644,20,28,0.714,53,69,122,20,13,21,13,50,154,1.1,0.7,1.8,2023
Immanuel Quickley,PG,24,68,1985,388,894,0.434,171,433,0.395,217,461,0.471,209,245,0.853,17,242,259,331,50,10,101,119,1156,3.5,1.2,4.7,2023
Lester Quinones,SG,23,37,394,56,141,0.397,32,88,0.364,24,53,0.453,20,29,0.69,21,51,72,36,6,2,17,44,164,0.3,0.3,0.6,2023
Jahmi'us Ramsey,SG,22,7,121,18,41,0.439,6,22,0.273,12,19,0.632,5,6,0.833,4,18,22,8,7,0,7,10,47,-0.1,0.1,0.1,2023
Julius Randle,PF,29,46,1630,395,836,0.472,76,244,0.311,319,592,0.539,236,302,0.781,99,324,423,229,25,12,159,125,1102,1.9,1.9,3.8,2023
Duop Reath,C,27,68,1214,230,499,0.461,88,245,0.359,142,254,0.559,69,93,0.742,93,157,250,67,33,38,52,161,617,1.4,1.0,2.4,2023
Austin Reaves,SG,25,82,2629,457,940,0.486,154,420,0.367,303,520,0.583,232,272,0.853,57,295,352,450,66,25,174,153,1300,3.9,2.0,5.9,2023
Cam Reddish,SF,24,48,984,91,234,0.389,37,110,0.336,54,124,0.435,41,54,0.759,27,72,99,48,47,14,31,64,260,-0.3,0.9,0.6,2023
Paul Reed,C,24,82,1590,259,480,0.54,21,57,0.368,238,423,0.563,61,85,0.718,193,295,488,109,67,84,67,198,600,2.5,2.6,5.1,2023
Naz Reid,C,24,81,1964,406,851,0.477,169,408,0.414,237,443,0.535,109,148,0.736,73,350,423,106,63,73,111,172,1090,1.1,3.8,4.9,2023
Jared Rhoden,SG,24,17,245,33,66,0.5,12,31,0.387,21,35,0.6,5,8,0.625,3,30,33,14,3,13,7,28,83,0.1,0.2,0.3,2023
Nick Richards,C,26,67,1759,260,376,0.691,0,1,0.0,260,375,0.693,132,179,0.737,172,367,539,54,26,74,73,176,652,3.8,1.3,5.1,2023
Josh Richardson,SG,30,43,1103,154,347,0.444,66,190,0.347,88,157,0.561,51,54,0.944,18,103,121,105,24,14,36,76,425,0.9,1.2,2.1,2023
Duncan Robinson,SF,29,68,1905,304,675,0.45,187,473,0.395,117,202,0.579,80,90,0.889,15,158,173,192,46,16,95,163,875,1.6,2.0,3.6,2023
Jerome Robinson,SG,26,22,81,11,33,0.333,2,17,0.118,9,16,0.563,7,11,0.636,1,5,6,5,1,3,2,5,31,-0.1,0.1,-0.1,2023
Mitchell Robinson,C,25,31,768,73,127,0.575,0,0,0.0,73,127,0.575,27,66,0.409,142,121,263,18,37,35,25,55,173,1.2,1.3,2.5,2023
Orlando Robinson,C,23,36,304,36,72,0.5,8,15,0.533,28,57,0.491,19,25,0.76,28,56,84,34,7,8,18,35,99,0.4,0.5,0.9,2023
Jeremiah Robinson-Earl,PF,23,39,334,45,95,0.474,13,39,0.333,32,56,0.571,12,16,0.75,23,53,76,21,10,4,16,24,115,0.2,0.4,0.6,2023
David Roddy,PF,22,65,1177,165,409,0.403,48,164,0.293,117,245,0.478,47,68,0.691,53,158,211,80,27,11,57,72,425,-0.9,1.0,0.1,2023
Ryan Rollins,PG,21,13,78,14,27,0.519,3,4,0.75,11,23,0.478,13,17,0.765,2,11,13,14,10,3,8,8,44,0.1,0.1,0.3,2023
Derrick Rose,PG,35,24,399,76,165,0.461,15,41,0.366,61,124,0.492,24,27,0.889,7,38,45,78,8,2,31,21,191,0.1,0.3,0.4,2023
Terry Rozier,PG,29,61,2040,442,998,0.443,149,410,0.363,293,588,0.498,172,198,0.869,35,212,247,342,63,21,106,101,1205,2.3,1.6,3.9,2023
Rayan Rupert,SG,19,39,633,54,161,0.335,28,78,0.359,26,83,0.313,19,25,0.76,24,68,92,62,12,3,31,56,155,-0.4,0.3,-0.1,2023
D'Angelo Russell,PG,27,76,2484,492,1080,0.456,226,545,0.415,266,535,0.497,159,192,0.828,28,208,236,482,69,36,156,156,1369,3.3,1.8,5.1,2023
Matt Ryan,SF,26,28,390,49,113,0.434,41,91,0.451,8,22,0.364,13,14,0.929,6,34,40,18,6,1,19,32,152,0.2,0.3,0.5,2023
Domantas Sabonis,C,27,82,2928,634,1068,0.594,33,87,0.379,601,981,0.613,292,415,0.704,294,826,1120,673,74,48,272,250,1593,8.6,4.0,12.6,2023
Luka Šamanić,PF,24,43,404,60,158,0.38,13,64,0.203,47,94,0.5,44,56,0.786,22,80,102,19,5,7,28,32,177,-0.4,0.2,-0.2,2023
Jermaine Samuels,SF,25,14,60,9,14,0.643,0,2,0.0,9,12,0.75,2,2,1.0,3,10,13,3,1,2,0,5,20,0.1,0.1,0.2,2023
Adama Sanogo,PF,21,9,66,14,27,0.519,0,0,0.0,14,27,0.519,8,12,0.667,19,17,36,0,1,0,5,5,36,0.1,0.1,0.2,2023
Gui Santos,PF,21,23,192,28,55,0.509,10,27,0.37,18,28,0.643,16,17,0.941,17,32,49,14,4,2,7,23,82,0.5,0.2,0.7,2023
Dario Šarić,C,29,64,1098,181,388,0.466,74,197,0.376,107,191,0.56,79,93,0.849,73,210,283,144,31,10,78,112,515,1.6,1.2,2.8,2023
Olivier Sarr,C,24,15,98,11,19,0.579,2,6,0.333,9,13,0.692,10,15,0.667,10,26,36,2,0,7,3,18,34,0.2,0.2,0.4,2023
Marcus Sasser,PG,23,71,1351,219,512,0.428,90,240,0.375,129,272,0.474,58,66,0.879,11,114,125,236,44,12,90,103,586,0.3,0.6,0.9,2023
Admiral Schofield,PF,26,23,84,10,26,0.385,6,16,0.375,4,10,0.4,0,2,0.0,3,14,17,7,1,0,5,9,26,-0.1,0.1,0.0,2023
Dennis Schröder,PG,30,80,2486,403,927,0.435,138,368,0.375,265,559,0.474,178,213,0.836,39,203,242,488,63,17,153,164,1122,2.3,1.0,3.3,2023
Dereon Seabron,SG,23,6,55,4,13,0.308,1,2,0.5,3,11,0.273,5,6,0.833,1,6,7,5,2,1,0,4,14,0.0,0.1,0.1,2023
Alperen Sengun,C,21,63,2046,527,982,0.537,33,111,0.297,494,871,0.567,244,352,0.693,183,406,589,312,76,46,162,211,1331,3.8,3.1,6.9,2023
Brice Sensabaugh,SF,20,32,584,85,218,0.39,34,115,0.296,51,103,0.495,37,41,0.902,16,86,102,55,13,6,47,43,241,-0.5,0.2,-0.3,2023
Collin Sexton,SG,25,78,2075,506,1038,0.487,128,325,0.394,378,713,0.53,318,370,0.859,71,134,205,383,62,18,165,154,1458,5.2,0.3,5.5,2023
Landry Shamet,SG,26,46,726,118,274,0.431,53,157,0.338,65,117,0.556,38,46,0.826,16,46,62,54,25,10,30,76,327,0.1,0.2,0.3,2023
Day'Ron Sharpe,C,22,61,921,168,294,0.571,4,15,0.267,164,279,0.588,75,123,0.61,161,228,389,85,24,44,70,131,415,1.6,1.3,2.9,2023
Shaedon Sharpe,SG,20,32,1059,176,434,0.406,60,180,0.333,116,254,0.457,98,119,0.824,42,118,160,94,28,12,72,88,510,-0.2,0.6,0.5,2023
Ben Sheppard,SG,22,57,814,90,229,0.393,49,156,0.314,41,73,0.562,23,26,0.885,15,74,89,53,33,2,15,88,252,0.3,0.4,0.8,2023
Pascal Siakam,PF,29,80,2657,681,1271,0.536,85,246,0.346,596,1025,0.581,290,396,0.732,139,426,565,342,63,25,141,193,1737,5.4,1.5,6.9,2023
Ben Simmons,PG,27,15,359,43,74,0.581,0,0,0.0,43,74,0.581,6,15,0.4,31,88,119,86,12,9,27,36,92,0.5,0.5,1.0,2023
Kobi Simmons,PG,26,4,67,9,21,0.429,2,8,0.25,7,13,0.538,0,0,0.0,1,6,7,12,6,2,1,5,20,0.1,0.1,0.1,2023
Anfernee Simons,SG,24,46,1582,360,837,0.43,156,405,0.385,204,432,0.472,163,178,0.916,22,145,167,255,23,5,126,98,1039,1.7,0.5,2.2,2023
Zavier Simpson,PG,26,7,161,17,54,0.315,5,17,0.294,12,37,0.324,3,4,0.75,4,16,20,25,7,3,10,11,42,-0.3,0.2,-0.2,2023
Jericho Sims,C,25,45,585,38,55,0.691,0,0,0.0,38,55,0.691,16,24,0.667,56,91,147,25,8,19,16,45,92,0.9,0.7,1.5,2023
Dmytro Skapintsev,C,25,2,2,0,1,0.0,0,0,0.0,0,1,0.0,0,0,0.0,0,0,0,0,0,0,0,0,0,0.0,0.0,0.0,2023
Jalen Slawson,SF,24,12,37,4,6,0.667,0,2,0.0,4,4,1.0,0,0,0.0,1,6,7,2,1,1,2,8,8,0.0,0.0,0.0,2023
Javonte Smart,PG,24,1,1,0,0,0.0,0,0,0.0,0,0,0.0,0,0,0.0,0,0,0,0,0,0,0,0,0,0.0,0.0,0.0,2023
Marcus Smart,PG,29,20,605,102,237,0.43,42,134,0.313,60,103,0.583,43,56,0.768,6,47,53,86,41,5,62,53,289,-0.5,0.7,0.2,2023
Dennis Smith Jr.,PG,26,56,1059,147,338,0.435,32,109,0.294,115,229,0.502,43,58,0.741,50,114,164,203,68,12,68,121,369,0.5,1.3,1.8,2023
Dru Smith,SG,26,9,131,15,33,0.455,7,17,0.412,8,16,0.5,2,2,1.0,6,8,14,14,9,3,5,12,39,0.1,0.2,0.3,2023
Ish Smith,PG,35,43,741,66,158,0.418,4,8,0.5,62,150,0.413,3,4,0.75,11,65,76,145,17,4,47,49,139,-0.5,0.2,-0.4,2023
Jabari Smith Jr.,PF,20,76,2424,378,833,0.454,138,380,0.363,240,453,0.53,150,185,0.811,139,477,616,121,52,61,89,200,1044,2.4,3.2,5.6,2023
Jalen Smith,C,23,61,1047,234,395,0.592,61,144,0.424,173,251,0.689,72,104,0.692,112,225,337,63,17,38,44,124,601,3.1,0.9,4.0,2023
Nick Smith Jr.,SG,19,51,729,113,289,0.391,63,146,0.432,50,143,0.35,13,15,0.867,18,54,72,59,10,7,39,55,302,-0.6,0.1,-0.5,2023
Terquavion Smith,PG,21,16,84,18,46,0.391,13,35,0.371,5,11,0.455,3,5,0.6,0,4,4,12,8,0,7,8,52,0.0,0.1,0.1,2023
Jeremy Sochan,PF,20,74,2193,340,776,0.438,70,227,0.308,270,549,0.492,111,144,0.771,137,339,476,249,62,40,140,168,861,-0.5,1.9,1.4,2023
Pat Spencer,PG,27,6,26,2,4,0.5,0,2,0.0,2,2,1.0,0,0,0.0,2,2,4,5,0,0,1,1,4,0.0,0.0,0.0,2023
Jaden Springer,SG,21,49,507,59,148,0.399,10,48,0.208,49,100,0.49,35,42,0.833,33,45,78,44,36,15,34,66,163,-0.3,0.8,0.6,2023
Lamar Stevens,PF,26,38,559,108,240,0.45,14,46,0.304,94,194,0.485,42,54,0.778,36,91,127,28,23,22,24,45,272,0.0,0.8,0.8,2023
Isaiah Stewart,PF,22,46,1423,186,382,0.487,67,175,0.383,119,207,0.575,64,85,0.753,74,231,305,73,17,38,66,99,503,0.9,0.8,1.7,2023
Julian Strawther,SF,21,50,545,82,222,0.369,41,138,0.297,41,84,0.488,22,31,0.71,5,56,61,47,17,7,23,54,227,-0.4,0.6,0.2,2023
Max Strus,SF,27,70,2239,304,728,0.418,168,479,0.351,136,249,0.546,77,97,0.794,66,272,338,283,64,29,112,170,853,1.2,2.6,3.9,2023
Jalen Suggs,SG,22,75,2025,336,714,0.471,153,385,0.397,183,329,0.556,118,156,0.756,48,181,229,205,106,47,132,205,943,1.5,3.2,4.7,2023
Cole Swider,SF,24,18,87,15,38,0.395,10,30,0.333,5,8,0.625,2,2,1.0,1,6,7,5,1,1,8,4,42,-0.2,0.1,-0.1,2023
Jae'Sean Tate,SF,28,65,1031,108,229,0.472,23,77,0.299,85,152,0.559,26,39,0.667,61,136,197,64,42,15,37,137,265,0.4,1.3,1.8,2023
Jayson Tatum,PF,25,74,2645,672,1426,0.471,229,609,0.376,443,817,0.542,414,497,0.833,67,534,601,364,75,43,188,145,1987,6.4,4.1,10.4,2023
Terry Taylor,PF,24,31,188,20,39,0.513,2,9,0.222,18,30,0.6,4,5,0.8,17,20,37,10,5,2,7,17,46,0.1,0.1,0.3,2023
Garrett Temple,SG,37,27,289,29,78,0.372,12,40,0.3,17,38,0.447,18,22,0.818,18,27,45,28,12,3,14,28,88,0.0,0.2,0.2,2023
Dalen Terry,SG,21,59,681,69,157,0.439,17,74,0.23,52,83,0.627,25,43,0.581,29,84,113,81,27,18,32,81,180,0.1,0.7,0.8,2023
Daniel Theis,C,31,60,1015,156,293,0.532,26,71,0.366,130,222,0.586,38,50,0.76,85,159,244,61,21,51,42,127,376,1.4,1.2,2.5,2023
Cam Thomas,SG,22,66,2075,526,1190,0.442,144,396,0.364,382,794,0.481,286,334,0.856,28,186,214,192,45,16,124,138,1482,1.3,1.2,2.5,2023
Isaiah Thomas,PG,34,6,19,3,10,0.3,2,4,0.5,1,6,0.167,0,0,0.0,0,0,0,3,0,0,0,0,8,0.0,0.0,0.0,2023
Amen Thompson,SF,21,62,1388,239,446,0.536,8,58,0.138,231,388,0.595,106,155,0.684,148,261,409,163,78,38,90,141,592,1.9,2.4,4.3,2023
Ausar Thompson,SF,21,63,1583,232,480,0.483,21,113,0.186,211,367,0.575,71,119,0.597,129,273,402,120,68,59,84,175,556,0.1,1.7,1.8,2023
Klay Thompson,SF,33,77,2284,490,1133,0.432,268,692,0.387,222,441,0.503,127,137,0.927,35,219,254,176,50,35,117,127,1375,1.8,1.7,3.6,2023
Tristan Thompson,C,32,49,549,73,120,0.608,0,1,0.0,73,119,0.613,15,52,0.288,73,101,174,51,12,14,29,59,161,0.6,0.8,1.4,2023
JT Thor,PF,21,63,781,80,183,0.437,28,81,0.346,52,102,0.51,11,20,0.55,43,103,146,29,11,27,15,60,199,0.2,0.3,0.6,2023
Matisse Thybulle,SF,26,65,1487,126,317,0.397,80,231,0.346,46,86,0.535,22,29,0.759,30,106,136,90,113,49,40,93,354,0.4,1.8,2.2,2023
Xavier Tillman Sr.,C,25,54,974,121,279,0.434,20,81,0.247,101,198,0.51,22,50,0.44,70,141,211,77,51,44,34,75,284,-0.1,1.6,1.4,2023
Jacob Toppin,SF,23,9,38,5,9,0.556,1,4,0.25,4,5,0.8,2,2,1.0,3,4,7,3,0,1,1,3,13,0.1,0.0,0.1,2023
Obi Toppin,PF,25,82,1730,332,579,0.573,102,253,0.403,230,326,0.706,77,100,0.77,85,235,320,128,47,43,69,143,843,3.6,1.1,4.8,2023
Juan Toscano-Anderson,SF,30,11,53,3,12,0.25,1,4,0.25,2,8,0.25,0,0,0.0,4,10,14,4,1,1,2,11,7,-0.1,0.1,0.0,2023
Karl-Anthony Towns,PF,28,62,2026,479,951,0.504,136,327,0.416,343,624,0.55,255,292,0.873,94,421,515,189,43,41,177,204,1349,2.6,3.6,6.3,2023
Gary Trent Jr.,SG,25,71,1994,361,847,0.426,178,453,0.393,183,394,0.464,74,96,0.771,25,163,188,119,77,10,47,96,974,0.8,0.9,1.7,2023
Oscar Tshiebwe,PF,24,8,42,10,20,0.5,0,0,0.0,10,20,0.5,6,8,0.75,8,8,16,2,2,1,0,3,26,0.1,0.0,0.2,2023
P.J. Tucker,PF,38,31,486,18,50,0.36,13,35,0.371,5,15,0.333,3,3,1.0,28,57,85,16,16,7,8,54,52,0.2,0.5,0.7,2023
Myles Turner,C,27,77,2076,476,909,0.524,116,324,0.358,360,585,0.615,245,317,0.773,113,420,533,100,39,144,109,232,1313,3.6,2.2,5.8,2023
Hunter Tyson,PF,23,18,48,8,20,0.4,4,14,0.286,4,6,0.667,0,0,0.0,1,8,9,2,1,0,2,10,20,0.0,0.1,0.0,2023
Stanley Umude,SG,24,24,307,37,84,0.44,24,53,0.453,13,31,0.419,29,32,0.906,8,43,51,11,8,7,14,40,127,0.3,0.2,0.5,2023
Jonas Valančiūnas,C,31,82,1925,402,719,0.559,37,120,0.308,365,599,0.609,161,205,0.785,186,535,721,173,32,68,111,218,1002,3.9,3.1,7.1,2023
Jarred Vanderbilt,PF,24,29,581,59,114,0.518,8,27,0.296,51,87,0.586,24,36,0.667,41,97,138,36,36,5,28,43,150,0.3,0.8,1.1,2023
Fred VanVleet,PG,29,73,2684,423,1018,0.416,227,586,0.387,196,432,0.454,197,229,0.86,33,245,278,589,101,59,126,183,1270,5.3,3.1,8.4,2023
Devin Vassell,SG,23,68,2248,498,1056,0.472,166,446,0.372,332,610,0.544,161,201,0.801,27,234,261,277,73,23,108,74,1323,2.0,1.6,3.6,2023
Sasha Vezenkov,PF,28,42,511,84,191,0.44,45,120,0.375,39,71,0.549,12,15,0.8,30,66,96,19,20,7,12,42,225,0.5,0.5,1.0,2023
Gabe Vincent,PG,27,11,218,15,49,0.306,3,28,0.107,12,21,0.571,1,2,0.5,4,5,9,21,9,0,5,19,34,-0.3,0.1,-0.1,2023
Nikola Vučević,C,33,76,2610,586,1211,0.484,92,313,0.294,494,898,0.55,106,129,0.822,210,591,801,254,50,60,120,190,1370,2.7,2.8,5.4,2023
Tristan Vukcevic,C,20,10,153,29,67,0.433,10,36,0.278,19,31,0.613,17,22,0.773,6,30,36,13,5,7,10,28,85,0.0,0.1,0.1,2023
Dean Wade,PF,27,54,1108,96,232,0.414,79,202,0.391,17,30,0.567,20,26,0.769,37,181,218,43,40,25,20,93,291,0.9,1.6,2.5,2023
Franz Wagner,SF,22,72,2337,528,1096,0.482,94,334,0.281,434,762,0.57,271,319,0.85,72,309,381,269,76,28,137,168,1421,3.1,3.2,6.4,2023
Moritz Wagner,C,26,80,1415,332,552,0.601,38,115,0.33,294,437,0.673,166,204,0.814,117,230,347,96,39,21,97,160,868,3.5,2.0,5.6,2023
Ish Wainright,SF,29,11,62,7,24,0.292,7,20,0.35,0,4,0.0,2,2,1.0,3,11,14,1,4,1,2,8,23,0.0,0.1,0.0,2023
Jabari Walker,SF,21,72,1700,234,509,0.46,41,139,0.295,193,370,0.522,129,171,0.754,151,357,508,71,42,22,66,173,638,1.4,1.6,2.9,2023
Jarace Walker,PF,20,33,340,45,110,0.409,22,55,0.4,23,55,0.418,8,9,0.889,12,51,63,40,15,11,17,29,120,0.1,0.3,0.4,2023
Lonnie Walker IV,SG,25,58,1011,208,492,0.423,104,271,0.384,104,221,0.471,45,59,0.763,13,114,127,74,32,20,51,71,565,-0.1,0.9,0.8,2023
Cason Wallace,SG,20,82,1692,217,442,0.491,98,234,0.419,119,208,0.572,29,37,0.784,52,135,187,120,76,37,45,129,561,1.9,2.1,4.0,2023
Jordan Walsh,SF,19,9,83,6,15,0.4,2,9,0.222,4,6,0.667,1,2,0.5,5,15,20,5,5,1,3,11,15,0.0,0.2,0.2,2023
T.J. Warren,SF,30,11,125,18,41,0.439,2,13,0.154,16,28,0.571,3,4,0.75,5,17,22,9,4,1,4,11,41,0.0,0.2,0.2,2023
P.J. Washington,PF,25,73,2221,354,811,0.436,132,413,0.32,222,398,0.558,99,145,0.683,85,326,411,141,72,59,96,169,939,0.0,1.9,1.9,2023
TyTy Washington Jr.,PG,22,11,56,6,20,0.3,2,6,0.333,4,14,0.286,0,0,0.0,1,4,5,5,3,0,2,1,14,-0.1,0.1,-0.1,2023
Yuta Watanabe,SF,29,34,464,41,116,0.353,25,85,0.294,16,31,0.516,10,17,0.588,11,43,54,15,12,7,19,39,117,-0.5,0.4,-0.1,2023
Lindy Waters III,SG,26,38,280,49,104,0.471,37,85,0.435,12,19,0.632,2,2,1.0,7,33,40,24,5,7,7,23,137,0.6,0.3,0.9,2023
Trendon Watford,PF,23,63,856,164,311,0.527,27,68,0.397,137,243,0.564,77,97,0.794,52,142,194,81,23,19,63,106,432,0.9,0.9,1.8,2023
Peyton Watson,SF,21,80,1488,208,447,0.465,45,152,0.296,163,295,0.553,71,106,0.67,56,202,258,86,42,88,58,143,532,0.3,2.2,2.5,2023
Victor Wembanyama,C,20,71,2106,551,1186,0.465,128,394,0.325,423,792,0.534,292,367,0.796,161,594,755,274,88,254,260,153,1522,-0.7,4.4,3.7,2023
Blake Wesley,SG,20,61,876,102,215,0.474,12,55,0.218,90,160,0.563,52,78,0.667,18,76,94,166,29,9,55,89,268,0.3,0.6,0.9,2023
Russell Westbrook,PG,35,68,1529,301,663,0.454,42,154,0.273,259,509,0.509,110,160,0.688,93,250,343,306,74,23,144,121,754,0.2,1.9,2.1,2023
Coby White,PG,23,79,2881,541,1209,0.447,209,556,0.376,332,653,0.508,218,260,0.838,44,314,358,405,53,18,166,186,1509,3.1,1.6,4.7,2023
Derrick White,SG,29,73,2381,387,839,0.461,196,495,0.396,191,344,0.555,137,152,0.901,51,259,310,377,74,87,112,152,1107,5.2,3.3,8.5,2023
Jack White,SF,26,4,64,2,16,0.125,2,10,0.2,0,6,0.0,0,0,0.0,4,8,12,1,4,1,2,3,6,-0.2,0.1,-0.1,2023
Cam Whitmore,SF,19,47,880,212,467,0.454,79,220,0.359,133,247,0.538,76,112,0.679,44,136,180,33,30,17,46,64,579,0.4,1.1,1.5,2023
Aaron Wiggins,SG,25,78,1228,212,377,0.562,62,126,0.492,150,251,0.598,56,71,0.789,60,126,186,86,56,19,56,91,542,2.1,1.6,3.7,2023
Andrew Wiggins,SF,28,71,1920,353,780,0.453,91,254,0.358,262,526,0.498,142,189,0.751,108,213,321,119,42,41,87,147,939,1.2,1.6,2.8,2023
Lindell Wigginton,PG,25,3,8,2,5,0.4,0,2,0.0,2,3,0.667,2,2,1.0,0,0,0,0,0,0,1,1,6,0.0,0.0,0.0,2023
Alondes Williams,SG,24,7,16,2,8,0.25,0,4,0.0,2,4,0.5,1,1,1.0,0,1,1,0,0,1,2,2,5,-0.1,0.0,-0.1,2023
Brandon Williams,PG,24,17,113,20,54,0.37,3,15,0.2,17,39,0.436,11,17,0.647,4,9,13,17,1,1,7,4,54,-0.2,0.1,-0.1,2023
Grant Williams,PF,25,76,2130,276,605,0.456,126,336,0.375,150,269,0.558,106,140,0.757,86,232,318,174,44,39,109,226,784,1.3,1.3,2.6,2023
Jalen Williams,PF,22,71,2223,536,993,0.54,103,241,0.427,433,752,0.576,180,221,0.814,37,245,282,322,80,45,123,175,1355,4.5,2.7,7.3,2023
Jaylin Williams,C,21,69,897,95,228,0.417,53,144,0.368,42,84,0.5,33,41,0.805,36,198,234,110,28,27,34,98,276,1.0,1.5,2.4,2023
Jeenathan Williams,SG,24,22,129,27,50,0.54,2,5,0.4,25,45,0.556,7,13,0.538,12,11,23,7,4,1,4,10,63,0.2,0.1,0.3,2023
Kenrich Williams,PF,29,69,1029,131,280,0.468,56,141,0.397,75,139,0.54,7,14,0.5,61,148,209,93,38,9,32,101,325,1.1,1.3,2.5,2023
Malik Williams,C,25,7,107,9,34,0.265,1,5,0.2,8,29,0.276,0,2,0.0,15,23,38,2,3,4,3,15,19,-0.3,0.1,-0.2,2023
Mark Williams,C,22,19,508,98,151,0.649,0,0,0.0,98,151,0.649,46,64,0.719,76,108,184,22,16,20,17,50,242,1.6,0.5,2.1,2023
Patrick Williams,PF,22,43,1174,159,359,0.443,59,148,0.399,100,211,0.474,52,66,0.788,46,120,166,66,40,33,57,87,429,0.1,1.0,1.2,2023
Robert Williams,C,26,6,119,17,26,0.654,0,0,0.0,17,26,0.654,7,9,0.778,11,27,38,5,7,7,7,17,41,0.2,0.2,0.4,2023
Vince Williams Jr.,SG,23,52,1436,169,379,0.446,79,209,0.378,90,170,0.529,104,130,0.8,59,231,290,175,47,34,92,135,521,1.1,1.7,2.8,2023
Ziaire Williams,SF,22,51,1038,150,378,0.397,58,189,0.307,92,189,0.487,62,75,0.827,35,145,180,75,36,9,66,85,420,-0.9,1.1,0.2,2023
Zion Williamson,PF,23,70,2207,624,1094,0.57,6,18,0.333,618,1076,0.574,347,494,0.702,122,284,406,352,77,47,193,159,1601,4.7,2.8,7.5,2023
D.J. Wilson,PF,27,2,15,4,6,0.667,2,2,1.0,2,4,0.5,0,0,0.0,1,1,2,2,0,2,0,1,10,0.1,0.0,0.1,2023
Jalen Wilson,PF,23,43,664,76,179,0.425,24,74,0.324,52,105,0.495,38,46,0.826,47,84,131,45,11,4,19,48,214,0.6,0.4,1.1,2023
Dylan Windler,SF,27,17,108,15,30,0.5,13,27,0.481,2,3,0.667,0,0,0.0,3,13,16,10,2,0,2,6,43,0.3,0.0,0.3,2023
James Wiseman,C,22,63,1091,187,305,0.613,0,2,0.0,187,303,0.617,72,102,0.706,110,226,336,54,12,39,66,141,446,1.3,0.8,2.1,2023
Isaiah Wong,SG,23,1,4,1,3,0.333,0,1,0.0,1,2,0.5,0,0,0.0,0,0,0,0,0,0,0,0,2,0.0,0.0,0.0,2023
Christian Wood,PF,28,50,872,123,264,0.466,35,114,0.307,88,150,0.587,66,94,0.702,39,215,254,49,16,33,50,72,347,0.0,1.1,1.2,2023
Delon Wright,PG,31,47,742,74,188,0.394,25,68,0.368,49,120,0.408,37,45,0.822,19,67,86,119,54,11,14,32,210,0.8,0.9,1.7,2023
Thaddeus Young,PF,35,33,439,65,108,0.602,1,7,0.143,64,101,0.634,6,15,0.4,46,57,103,57,23,5,15,49,137,0.9,0.4,1.3,2023
Trae Young,PG,25,54,1942,433,1008,0.43,175,469,0.373,258,539,0.479,348,407,0.855,23,126,149,583,72,11,235,109,1389,4.0,0.6,4.6,2023
Omer Yurtseven,C,25,48,545,99,184,0.538,5,24,0.208,94,160,0.588,19,28,0.679,72,136,208,29,8,18,37,52,222,0.3,0.4,0.7,2023
Cody Zeller,C,31,43,320,26,62,0.419,1,3,0.333,25,59,0.424,23,38,0.605,48,64,112,39,9,5,16,45,76,0.4,0.4,0.8,2023
Ivica Zubac,C,26,68,1794,337,519,0.649,0,0,0.0,337,519,0.649,120,166,0.723,196,430,626,93,22,83,79,180,794,4.5,2.3,6.8,2023
